Team,Date,Pen,Day,G#,Week,,Opp,Result,Pen,Yds,OppPen,OppYds,CombPen,CombPenYds,game_id
CLE,2019-09-08,18,Sun,1,1,,TEN,L 13-43,18,182,6,54,24,236,CLE_TEN_2019-09-08
MIA,2017-11-19,17,Sun,10,11,,TAM,L 20-30,17,123,9,82,26,205,MIA_TAM_2017-11-19
JAX,2019-12-01,16,Sun,12,13,,TAM,L 11-28,16,121,8,44,24,165,JAX_TAM_2019-12-01
ATL,2019-09-22,16,Sun,3,3,@,IND,L 24-27,16,128,4,39,20,167,ATL_IND_2019-09-22
NYJ,2018-12-23,16,Sun,15,16,,GNB,L 38-44 (OT),16,172,10,86,26,258,NYJ_GNB_2018-12-23
SEA,2017-11-05,16,Sun,8,9,,WAS,L 14-17,16,138,7,62,23,200,SEA_WAS_2017-11-05
WAS,2018-12-09,15,Sun,13,14,,NYG,L 16-40,15,135,2,18,17,153,WAS_NYG_2018-12-09
ATL,2018-09-06,15,Thu,1,1,@,PHI,L 12-18,15,135,11,101,26,236,ATL_PHI_2018-09-06
SEA,2017-10-22,15,Sun,6,7,@,NYG,W 24-7,15,110,7,28,22,138,SEA_NYG_2017-10-22
KAN,2017-09-07,15,Thu,1,1,@,NWE,W 42-27,15,139,6,55,21,194,KAN_NWE_2017-09-07
DAL,2021-11-25,14,Thu,11,12,,LVR,L 33-36 (OT),14,166,14,110,28,276,DAL_LVR_2021-11-25
LVR,2021-11-25,14,Thu,11,12,@,DAL,W 36-33 (OT),14,110,14,166,28,276,LVR_DAL_2021-11-25
PHI,2021-09-12,14,Sun,1,1,@,ATL,W 32-6,14,89,12,99,26,188,PHI_ATL_2021-09-12
LVR,2021-01-03,14,Sun,16,17,@,DEN,W 32-31,14,111,4,28,18,139,LVR_DEN_2021-01-03
NWE,2018-12-16,14,Sun,14,15,@,PIT,L 10-17,14,106,4,40,18,146,NWE_PIT_2018-12-16
SEA,2018-12-16,14,Sun,14,15,@,SFO,L 23-26 (OT),14,148,8,66,22,214,SEA_SFO_2018-12-16
LAC,2018-11-18,14,Sun,10,11,,DEN,L 22-23,14,120,7,43,21,163,LAC_DEN_2018-11-18
CHI,2018-11-04,14,Sun,8,9,@,BUF,W 41-9,14,129,10,163,24,292,CHI_BUF_2018-11-04
CLE,2018-10-21,14,Sun,7,7,@,TAM,L 23-26 (OT),14,114,8,65,22,179,CLE_TAM_2018-10-21
SFO,2018-09-23,14,Sun,3,3,@,KAN,L 27-38,14,147,6,48,20,195,SFO_KAN_2018-09-23
MIA,2017-12-31,14,Sun,16,17,,BUF,L 16-22,14,145,6,45,20,190,MIA_BUF_2017-12-31
OAK,2017-12-17,14,Sun,14,15,,DAL,L 17-20,14,105,7,100,21,205,OAK_DAL_2017-12-17
HOU,2017-12-17,14,Sun,14,15,@,JAX,L 7-45,14,127,8,54,22,181,HOU_JAX_2017-12-17
DEN,2017-11-05,14,Sun,8,9,@,PHI,L 23-51,14,105,5,35,19,140,DEN_PHI_2017-11-05
LVR,2022-12-18,13,Sun,14,15,,NWE,W 30-24,13,90,6,30,19,120,LVR_NWE_2022-12-18
DAL,2022-11-24,13,Thu,11,12,,NYG,W 28-20,13,86,7,66,20,152,DAL_NYG_2022-11-24
JAX,2022-10-23,13,Sun,7,7,,NYG,L 17-23,13,81,8,67,21,148,JAX_NYG_2022-10-23
DEN,2022-09-18,13,Sun,2,2,,HOU,W 16-9,13,100,8,94,21,194,DEN_HOU_2022-09-18
JAX,2022-09-11,13,Sun,1,1,@,WAS,L 22-28,13,90,6,63,19,153,JAX_WAS_2022-09-11
PHI,2021-09-27,13,Mon,3,3,@,DAL,L 21-41,13,86,4,37,17,123,PHI_DAL_2021-09-27
CLE,2020-12-06,13,Sun,12,13,@,TEN,W 41-35,13,92,5,52,18,144,CLE_TEN_2020-12-06
PIT,2019-11-10,13,Sun,9,10,,LAR,W 17-12,13,107,10,95,23,202,PIT_LAR_2019-11-10
CLE,2019-10-27,13,Sun,7,8,@,NWE,L 13-27,13,85,4,32,17,117,CLE_NWE_2019-10-27
LAR,2019-09-29,13,Sun,4,4,,TAM,L 40-55,13,106,12,99,25,205,LAR_TAM_2019-09-29
ATL,2018-12-09,13,Sun,13,14,@,GNB,L 20-34,13,101,6,37,19,138,ATL_GNB_2018-12-09
OAK,2018-12-09,13,Sun,13,14,,PIT,W 24-21,13,130,2,14,15,144,OAK_PIT_2018-12-09
BUF,2018-12-02,13,Sun,12,13,@,MIA,L 17-21,13,120,8,89,21,209,BUF_MIA_2018-12-02
SFO,2018-12-02,13,Sun,12,13,@,SEA,L 16-43,13,128,10,100,23,228,SFO_SEA_2018-12-02
CIN,2018-11-25,13,Sun,11,12,,CLE,L 20-35,13,96,7,61,20,157,CIN_CLE_2018-11-25
BUF,2018-11-25,13,Sun,11,12,,JAX,W 24-21,13,80,10,90,23,170,BUF_JAX_2018-11-25
KAN,2018-11-19,13,Mon,11,11,@,LAR,L 51-54,13,135,8,60,21,195,KAN_LAR_2018-11-19
PIT,2018-09-24,13,Mon,3,3,@,TAM,W 30-27,13,155,9,80,22,235,PIT_TAM_2018-09-24
DEN,2018-09-23,13,Sun,3,3,@,BAL,L 14-27,13,120,7,52,20,172,DEN_BAL_2018-09-23
CHI,2017-12-16,13,Sat,14,15,@,DET,L 10-20,13,97,8,58,21,155,CHI_DET_2017-12-16
CIN,2017-12-04,13,Mon,12,13,,PIT,L 20-23,13,173,7,66,20,239,CIN_PIT_2017-12-04
NOR,2017-10-15,13,Sun,5,6,,DET,W 52-38,13,118,7,46,20,164,NOR_DET_2017-10-15
SFO,2017-10-01,13,Sun,4,4,@,ARI,L 15-18 (OT),13,113,10,80,23,193,SFO_ARI_2017-10-01
KAN,2017-09-24,13,Sun,3,3,@,LAC,W 24-10,13,122,8,61,21,183,KAN_LAC_2017-09-24
PIT,2017-09-10,13,Sun,1,1,@,CLE,W 21-18,13,144,4,61,17,205,PIT_CLE_2017-09-10
PHI,2022-12-04,12,Sun,12,13,,TEN,W 35-10,12,80,7,82,19,162,PHI_TEN_2022-12-04
ARI,2022-11-06,12,Sun,9,9,,SEA,L 21-31,12,77,6,34,18,111,ARI_SEA_2022-11-06
DEN,2022-10-30,12,Sun,8,8,@,JAX,W 21-17,12,80,5,54,17,134,DEN_JAX_2022-10-30
NWE,2022-10-16,12,Sun,6,6,@,CLE,W 38-15,12,92,7,63,19,155,NWE_CLE_2022-10-16
SEA,2022-10-09,12,Sun,5,5,@,NOR,L 32-39,12,85,6,57,18,142,SEA_NOR_2022-10-09
ARI,2022-09-18,12,Sun,2,2,@,LVR,W 29-23 (OT),12,120,10,68,22,188,ARI_LVR_2022-09-18
DEN,2022-09-12,12,Mon,1,1,@,SEA,L 16-17,12,106,5,77,17,183,DEN_SEA_2022-09-12
SFO,2022-09-11,12,Sun,1,1,@,CHI,L 10-19,12,99,3,24,15,123,SFO_CHI_2022-09-11
LAC,2021-11-21,12,Sun,10,11,,PIT,W 41-37,12,75,8,38,20,113,LAC_PIT_2021-11-21
CHI,2021-11-08,12,Mon,9,9,@,PIT,L 27-29,12,115,5,30,17,145,CHI_PIT_2021-11-08
LAR,2021-11-07,12,Sun,9,9,,TEN,L 16-28,12,115,4,19,16,134,LAR_TEN_2021-11-07
BUF,2021-11-07,12,Sun,8,9,@,JAX,L 6-9,12,118,8,54,20,172,BUF_JAX_2021-11-07
KAN,2021-11-01,12,Mon,8,8,,NYG,W 20-17,12,103,10,88,22,191,KAN_NYG_2021-11-01
JAX,2021-10-31,12,Sun,7,8,@,SEA,L 7-31,12,93,5,40,17,133,JAX_SEA_2021-10-31
DAL,2021-10-17,12,Sun,6,6,@,NWE,W 35-29 (OT),12,115,5,47,17,162,DAL_NWE_2021-10-17
LAC,2021-09-19,12,Sun,2,2,,DAL,L 17-20,12,99,8,76,20,175,LAC_DAL_2021-09-19
ATL,2021-09-12,12,Sun,1,1,,PHI,L 6-32,12,99,14,89,26,188,ATL_PHI_2021-09-12
MIN,2021-09-12,12,Sun,1,1,@,CIN,L 24-27 (OT),12,116,3,15,15,131,MIN_CIN_2021-09-12
PHI,2020-12-27,12,Sun,15,16,@,DAL,L 17-37,12,115,5,73,17,188,PHI_DAL_2020-12-27
GNB,2020-12-13,12,Sun,13,14,@,DET,W 31-24,12,68,4,30,16,98,GNB_DET_2020-12-13
CAR,2020-11-08,12,Sun,9,9,@,KAN,L 31-33,12,82,8,75,20,157,CAR_KAN_2020-11-08
BAL,2020-10-18,12,Sun,6,6,@,PHI,W 30-28,12,132,3,20,15,152,BAL_PHI_2020-10-18
TAM,2019-12-29,12,Sun,16,17,,ATL,L 22-28 (OT),12,97,5,53,17,150,TAM_ATL_2019-12-29
OAK,2019-12-01,12,Sun,12,13,@,KAN,L 9-40,12,99,0,0,12,99,OAK_KAN_2019-12-01
SEA,2019-11-24,12,Sun,11,12,@,PHI,W 17-9,12,90,2,15,14,105,SEA_PHI_2019-11-24
BUF,2019-11-24,12,Sun,11,12,,DEN,W 20-3,12,90,7,70,19,160,BUF_DEN_2019-11-24
NOR,2019-11-24,12,Sun,11,12,,CAR,W 34-31,12,123,3,25,15,148,NOR_CAR_2019-11-24
NOR,2019-11-10,12,Sun,9,10,,ATL,L 9-26,12,90,7,48,19,138,NOR_ATL_2019-11-10
OAK,2019-11-07,12,Thu,9,10,,LAC,W 26-24,12,97,8,70,20,167,OAK_LAC_2019-11-07
MIN,2019-10-06,12,Sun,5,5,@,NYG,W 28-10,12,112,5,45,17,157,MIN_NYG_2019-10-06
DEN,2019-10-06,12,Sun,5,5,@,LAC,W 20-13,12,122,4,43,16,165,DEN_LAC_2019-10-06
ARI,2019-10-06,12,Sun,5,5,@,CIN,W 26-23,12,96,7,60,19,156,ARI_CIN_2019-10-06
TAM,2019-09-29,12,Sun,4,4,@,LAR,W 55-40,12,99,13,106,25,205,TAM_LAR_2019-09-29
WAS,2019-09-29,12,Sun,4,4,@,NYG,L 3-24,12,58,5,45,17,103,WAS_NYG_2019-09-29
JAX,2019-09-29,12,Sun,4,4,@,DEN,W 26-24,12,104,5,48,17,152,JAX_DEN_2019-09-29
NYJ,2019-09-16,12,Mon,2,2,,CLE,L 3-23,12,89,9,85,21,174,NYJ_CLE_2019-09-16
TAM,2019-09-12,12,Thu,2,2,@,CAR,W 20-14,12,66,5,50,17,116,TAM_CAR_2019-09-12
WAS,2019-09-08,12,Sun,1,1,@,PHI,L 27-32,12,96,6,55,18,151,WAS_PHI_2019-09-08
IND,2018-12-30,12,Sun,16,17,@,TEN,W 33-17,12,96,9,75,21,171,IND_TEN_2018-12-30
CIN,2018-12-02,12,Sun,12,13,,DEN,L 10-24,12,100,7,60,19,160,CIN_DEN_2018-12-02
NYG,2018-12-02,12,Sun,12,13,,CHI,W 30-27 (OT),12,107,8,58,20,165,NYG_CHI_2018-12-02
LAC,2018-11-04,12,Sun,8,9,@,SEA,W 25-17,12,105,10,83,22,188,LAC_SEA_2018-11-04
BUF,2018-10-14,12,Sun,6,6,@,HOU,L 13-20,12,104,6,50,18,154,BUF_HOU_2018-10-14
GNB,2018-10-07,12,Sun,5,5,@,DET,L 23-31,12,112,8,71,20,183,GNB_DET_2018-10-07
BUF,2018-09-23,12,Sun,3,3,@,MIN,W 27-6,12,84,6,59,18,143,BUF_MIN_2018-09-23
KAN,2018-09-16,12,Sun,2,2,@,PIT,W 42-37,12,76,12,90,24,166,KAN_PIT_2018-09-16
PIT,2018-09-16,12,Sun,2,2,,KAN,L 37-42,12,90,12,76,24,166,PIT_KAN_2018-09-16
PIT,2018-09-09,12,Sun,1,1,@,CLE,T 21-21 (OT),12,116,11,87,23,203,PIT_CLE_2018-09-09
MIN,2017-12-31,12,Sun,16,17,,CHI,W 23-10,12,103,10,116,22,219,MIN_CHI_2017-12-31
TAM,2017-12-24,12,Sun,15,16,@,CAR,L 19-22,12,72,6,50,18,122,TAM_CAR_2017-12-24
JAX,2017-12-24,12,Sun,15,16,@,SFO,L 33-44,12,99,8,68,20,167,JAX_SFO_2017-12-24
DEN,2017-12-14,12,Thu,14,15,@,IND,W 25-13,12,80,4,39,16,119,DEN_IND_2017-12-14
CIN,2017-11-12,12,Sun,9,10,@,TEN,L 20-24,12,84,5,55,17,139,CIN_TEN_2017-11-12
SEA,2017-11-09,12,Thu,9,10,@,ARI,W 22-16,12,108,9,58,21,166,SEA_ARI_2017-11-09
NYJ,2017-10-22,12,Sun,7,7,@,MIA,L 28-31,12,124,9,76,21,200,NYJ_MIA_2017-10-22
CLE,2017-10-22,12,Sun,7,7,,TEN,L 9-12 (OT),12,81,5,35,17,116,CLE_TEN_2017-10-22
NWE,2017-10-05,12,Thu,5,5,@,TAM,W 19-14,12,108,9,70,21,178,NWE_TAM_2017-10-05
IND,2022-12-17,11,Sat,14,15,@,MIN,L 36-39 (OT),11,103,9,74,20,177,IND_MIN_2022-12-17
NYJ,2022-10-23,11,Sun,7,7,@,DEN,W 16-9,11,85,4,34,15,119,NYJ_DEN_2022-10-23
LVR,2022-10-10,11,Mon,5,5,@,KAN,L 29-30,11,99,5,72,16,171,LVR_KAN_2022-10-10
MIA,2022-10-09,11,Sun,5,5,@,NYJ,L 17-40,11,102,5,105,16,207,MIA_NYJ_2022-10-09
SEA,2022-10-02,11,Sun,4,4,@,DET,W 48-45,11,76,8,59,19,135,SEA_DET_2022-10-02
WAS,2022-10-02,11,Sun,4,4,@,DAL,L 10-25,11,136,4,20,15,156,WAS_DAL_2022-10-02
PHI,2021-12-26,11,Sun,15,16,,NYG,W 34-10,11,79,6,40,17,119,PHI_NYG_2021-12-26
ARI,2021-12-25,11,Sat,15,16,,IND,L 16-22,11,85,5,40,16,125,ARI_IND_2021-12-25
MIN,2021-12-09,11,Thu,13,14,,PIT,W 36-28,11,102,10,85,21,187,MIN_PIT_2021-12-09
MIA,2021-11-11,11,Thu,10,10,,BAL,W 22-10,11,97,4,20,15,117,MIA_BAL_2021-11-11
TAM,2021-10-31,11,Sun,8,8,@,NOR,L 27-36,11,99,2,10,13,109,TAM_NOR_2021-10-31
DAL,2021-10-31,11,Sun,7,8,@,MIN,W 20-16,11,96,7,57,18,153,DAL_MIN_2021-10-31
TEN,2021-10-31,11,Sun,8,8,@,IND,W 34-31 (OT),11,161,9,75,20,236,TEN_IND_2021-10-31
MIN,2021-10-17,11,Sun,6,6,@,CAR,W 34-28 (OT),11,98,6,28,17,126,MIN_CAR_2021-10-17
NOR,2021-09-19,11,Sun,2,2,@,CAR,L 7-26,11,115,5,49,16,164,NOR_CAR_2021-09-19
NYG,2021-09-16,11,Thu,2,2,@,WAS,L 29-30,11,81,9,80,20,161,NYG_WAS_2021-09-16
TAM,2021-09-09,11,Thu,1,1,,DAL,W 31-29,11,106,8,55,19,161,TAM_DAL_2021-09-09
DET,2020-12-26,11,Sat,15,16,,TAM,L 7-47,11,117,8,65,19,182,DET_TAM_2020-12-26
LVR,2020-11-29,11,Sun,11,12,@,ATL,L 6-43,11,141,6,49,17,190,LVR_ATL_2020-11-29
PHI,2020-11-15,11,Sun,9,10,@,NYG,L 17-27,11,74,7,64,18,138,PHI_NYG_2020-11-15
BUF,2020-10-25,11,Sun,7,7,@,NYJ,W 18-10,11,106,6,49,17,155,BUF_NYJ_2020-10-25
TAM,2020-10-08,11,Thu,5,5,@,CHI,L 19-20,11,109,6,66,17,175,TAM_CHI_2020-10-08
NYJ,2020-10-01,11,Thu,4,4,,DEN,L 28-37,11,118,8,94,19,212,NYJ_DEN_2020-10-01
PHI,2020-09-27,11,Sun,3,3,,CIN,T 23-23 (OT),11,93,9,73,20,166,PHI_CIN_2020-09-27
ARI,2020-09-20,11,Sun,2,2,,WAS,W 30-15,11,97,6,42,17,139,ARI_WAS_2020-09-20
KAN,2020-09-20,11,Sun,2,2,@,LAC,W 23-20 (OT),11,90,6,40,17,130,KAN_LAC_2020-09-20
NOR,2019-12-22,11,Sun,15,16,@,TEN,W 38-28,11,70,6,56,17,126,NOR_TEN_2019-12-22
ATL,2019-12-15,11,Sun,14,15,@,SFO,W 29-22,11,98,7,67,18,165,ATL_SFO_2019-12-15
JAX,2019-11-24,11,Sun,11,12,@,TEN,L 20-42,11,104,6,54,17,158,JAX_TEN_2019-11-24
WAS,2019-11-17,11,Sun,10,11,,NYJ,L 17-34,11,66,6,55,17,121,WAS_NYJ_2019-11-17
DET,2019-11-17,11,Sun,10,11,,DAL,L 27-35,11,89,6,45,17,134,DET_DAL_2019-11-17
ARI,2019-11-10,11,Sun,10,10,@,TAM,L 27-30,11,87,9,94,20,181,ARI_TAM_2019-11-10
TEN,2019-11-03,11,Sun,9,9,@,CAR,L 20-30,11,99,6,77,17,176,TEN_CAR_2019-11-03
OAK,2019-10-27,11,Sun,7,8,@,HOU,L 24-27,11,100,7,50,18,150,OAK_HOU_2019-10-27
JAX,2019-10-20,11,Sun,7,7,@,CIN,W 27-17,11,130,6,50,17,180,JAX_CIN_2019-10-20
KAN,2019-10-13,11,Sun,6,6,,HOU,L 24-31,11,79,10,70,21,149,KAN_HOU_2019-10-13
KAN,2019-10-06,11,Sun,5,5,,IND,L 13-19,11,125,7,50,18,175,KAN_IND_2019-10-06
DAL,2019-10-06,11,Sun,5,5,,GNB,L 24-34,11,124,9,78,20,202,DAL_GNB_2019-10-06
BAL,2019-10-06,11,Sun,5,5,@,PIT,W 26-23 (OT),11,92,11,76,22,168,BAL_PIT_2019-10-06
PIT,2019-10-06,11,Sun,5,5,,BAL,L 23-26 (OT),11,76,11,92,22,168,PIT_BAL_2019-10-06
BUF,2019-10-06,11,Sun,5,5,@,TEN,W 14-7,11,78,8,60,19,138,BUF_TEN_2019-10-06
OAK,2019-09-29,11,Sun,4,4,@,IND,W 31-24,11,80,5,35,16,115,OAK_IND_2019-09-29
NOR,2019-09-22,11,Sun,3,3,@,SEA,W 33-27,11,70,7,53,18,123,NOR_SEA_2019-09-22
NOR,2019-09-15,11,Sun,2,2,@,LAR,L 9-27,11,87,8,65,19,152,NOR_LAR_2019-09-15
SFO,2019-09-08,11,Sun,1,1,@,TAM,W 31-17,11,87,8,87,19,174,SFO_TAM_2019-09-08
MIN,2019-09-08,11,Sun,1,1,,ATL,W 28-12,11,100,9,78,20,178,MIN_ATL_2019-09-08
DEN,2018-12-30,11,Sun,16,17,,LAC,L 9-23,11,99,6,51,17,150,DEN_LAC_2018-12-30
NYG,2018-12-30,11,Sun,16,17,,DAL,L 35-36,11,78,6,46,17,124,NYG_DAL_2018-12-30
CHI,2018-12-30,11,Sun,16,17,@,MIN,W 24-10,11,102,3,30,14,132,CHI_MIN_2018-12-30
DEN,2018-12-24,11,Mon,15,16,@,OAK,L 14-27,11,91,6,50,17,141,DEN_OAK_2018-12-24
PHI,2018-12-23,11,Sun,15,16,,HOU,W 32-30,11,105,10,61,21,166,PHI_HOU_2018-12-23
MIN,2018-12-23,11,Sun,15,16,@,DET,W 27-9,11,78,7,55,18,133,MIN_DET_2018-12-23
DAL,2018-12-09,11,Sun,13,14,,PHI,W 29-23 (OT),11,110,5,49,16,159,DAL_PHI_2018-12-09
BAL,2018-12-09,11,Sun,13,14,@,KAN,L 24-27 (OT),11,112,7,53,18,165,BAL_KAN_2018-12-09
DEN,2018-12-09,11,Sun,13,14,@,SFO,L 14-20,11,62,11,87,22,149,DEN_SFO_2018-12-09
SFO,2018-12-09,11,Sun,13,14,,DEN,W 20-14,11,87,11,62,22,149,SFO_DEN_2018-12-09
NYJ,2018-12-02,11,Sun,12,13,@,TEN,L 22-26,11,96,8,75,19,171,NYJ_TEN_2018-12-02
KAN,2018-12-02,11,Sun,12,13,@,OAK,W 40-33,11,94,8,74,19,168,KAN_OAK_2018-12-02
NYG,2018-11-25,11,Sun,11,12,@,PHI,L 22-25,11,91,7,46,18,137,NYG_PHI_2018-11-25
NWE,2018-11-25,11,Sun,11,12,@,NYJ,W 27-13,11,105,8,47,19,152,NWE_NYJ_2018-11-25
JAX,2018-11-18,11,Sun,10,11,,PIT,L 16-20,11,111,3,15,14,126,JAX_PIT_2018-11-18
KAN,2018-11-04,11,Sun,9,9,@,CLE,W 37-21,11,86,4,20,15,106,KAN_CLE_2018-11-04
TAM,2018-10-28,11,Sun,7,8,@,CIN,L 34-37,11,75,4,46,15,121,TAM_CIN_2018-10-28
NYG,2018-10-28,11,Sun,8,8,,WAS,L 13-20,11,102,8,90,19,192,NYG_WAS_2018-10-28
KAN,2018-10-07,11,Sun,5,5,,JAX,W 30-14,11,105,5,45,16,150,KAN_JAX_2018-10-07
TAM,2018-09-30,11,Sun,4,4,@,CHI,L 10-48,11,99,4,38,15,137,TAM_CHI_2018-09-30
GNB,2018-09-23,11,Sun,3,3,@,WAS,L 17-31,11,115,6,66,17,181,GNB_WAS_2018-09-23
NOR,2018-09-23,11,Sun,3,3,@,ATL,W 43-37 (OT),11,120,5,54,16,174,NOR_ATL_2018-09-23
IND,2018-09-23,11,Sun,3,3,@,PHI,L 16-20,11,77,10,110,21,187,IND_PHI_2018-09-23
HOU,2018-09-16,11,Sun,2,2,@,TEN,L 17-20,11,88,8,70,19,158,HOU_TEN_2018-09-16
OAK,2018-09-10,11,Mon,1,1,,LAR,L 13-33,11,155,8,70,19,225,OAK_LAR_2018-09-10
JAX,2018-09-09,11,Sun,1,1,@,NYG,W 20-15,11,119,6,43,17,162,JAX_NYG_2018-09-09
CLE,2018-09-09,11,Sun,1,1,,PIT,T 21-21 (OT),11,87,12,116,23,203,CLE_PIT_2018-09-09
PHI,2018-09-06,11,Thu,1,1,,ATL,W 18-12,11,101,15,135,26,236,PHI_ATL_2018-09-06
MIA,2017-12-24,11,Sun,15,16,@,KAN,L 13-29,11,75,5,40,16,115,MIA_KAN_2017-12-24
SEA,2017-12-24,11,Sun,15,16,@,DAL,W 21-12,11,142,7,75,18,217,SEA_DAL_2017-12-24
MIN,2017-12-17,11,Sun,14,15,,CIN,W 34-7,11,93,5,44,16,137,MIN_CIN_2017-12-17
SFO,2017-12-10,11,Sun,13,14,@,HOU,W 26-16,11,87,8,81,19,168,SFO_HOU_2017-12-10
NOR,2017-12-07,11,Thu,13,14,@,ATL,L 17-20,11,87,4,35,15,122,NOR_ATL_2017-12-07
HOU,2017-12-03,11,Sun,12,13,@,TEN,L 13-24,11,85,7,63,18,148,HOU_TEN_2017-12-03
PHI,2017-11-26,11,Sun,11,12,,CHI,W 31-3,11,70,9,56,20,126,PHI_CHI_2017-11-26
MIA,2017-11-05,11,Sun,8,9,,OAK,L 24-27,11,107,10,105,21,212,MIA_OAK_2017-11-05
BUF,2017-11-02,11,Thu,8,9,@,NYJ,L 21-34,11,99,10,66,21,165,BUF_NYJ_2017-11-02
BUF,2017-10-29,11,Sun,7,8,,OAK,W 34-14,11,95,6,50,17,145,BUF_OAK_2017-10-29
CLE,2017-10-15,11,Sun,6,6,@,HOU,L 17-33,11,72,4,44,15,116,CLE_HOU_2017-10-15
LAC,2017-10-08,11,Sun,5,5,@,NYG,W 27-22,11,87,10,67,21,154,LAC_NYG_2017-10-08
TEN,2017-10-08,11,Sun,5,5,@,MIA,L 10-16,11,77,5,23,16,100,TEN_MIA_2017-10-08
CAR,2017-10-08,11,Sun,5,5,@,DET,W 27-24,11,100,1,10,12,110,CAR_DET_2017-10-08
MIA,2017-10-01,11,Sun,3,4,,NOR,L 0-20,11,90,8,71,19,161,MIA_NOR_2017-10-01
SEA,2017-09-24,11,Sun,3,3,@,TEN,L 27-33,11,98,5,45,16,143,SEA_TEN_2017-09-24
IND,2017-09-24,11,Sun,3,3,,CLE,W 31-28,11,99,10,113,21,212,IND_CLE_2017-09-24
MIN,2017-09-17,11,Sun,2,2,@,PIT,L 9-26,11,131,10,72,21,203,MIN_PIT_2017-09-17
CLE,2017-09-17,11,Sun,2,2,@,BAL,L 10-24,11,65,7,45,18,110,CLE_BAL_2017-09-17
BAL,2017-09-10,11,Sun,1,1,@,CIN,W 20-0,11,85,9,66,20,151,BAL_CIN_2017-09-10
TEN,2022-12-29,10,Thu,16,17,,DAL,L 13-27,10,124,3,35,13,159,TEN_DAL_2022-12-29
NWE,2022-12-24,10,Sat,15,16,,CIN,L 18-22,10,82,8,62,18,144,NWE_CIN_2022-12-24
CAR,2022-12-24,10,Sat,15,16,,DET,W 37-23,10,74,4,30,14,104,CAR_DET_2022-12-24
KAN,2022-12-18,10,Sun,14,15,@,HOU,W 30-24 (OT),10,102,4,33,14,135,KAN_HOU_2022-12-18
BAL,2022-11-20,10,Sun,10,11,,CAR,W 13-3,10,93,9,66,19,159,BAL_CAR_2022-11-20
ARI,2022-11-13,10,Sun,10,10,@,LAR,W 27-17,10,67,5,29,15,96,ARI_LAR_2022-11-13
NOR,2022-11-13,10,Sun,10,10,@,PIT,L 10-20,10,74,3,40,13,114,NOR_PIT_2022-11-13
LVR,2022-11-13,10,Sun,9,10,,IND,L 20-25,10,74,4,25,14,99,LVR_IND_2022-11-13
CAR,2022-11-10,10,Thu,10,10,,ATL,W 25-15,10,89,4,37,14,126,CAR_ATL_2022-11-10
KAN,2022-11-06,10,Sun,8,9,,TEN,W 20-17 (OT),10,69,8,51,18,120,KAN_TEN_2022-11-06
MIN,2022-10-30,10,Sun,7,8,,ARI,W 34-26,10,86,10,67,20,153,MIN_ARI_2022-10-30
ARI,2022-10-30,10,Sun,8,8,@,MIN,L 26-34,10,67,10,86,20,153,ARI_MIN_2022-10-30
SFO,2022-10-23,10,Sun,7,7,,KAN,L 23-44,10,80,8,84,18,164,SFO_KAN_2022-10-23
DEN,2022-10-17,10,Mon,6,6,@,LAC,L 16-19 (OT),10,151,9,89,19,240,DEN_LAC_2022-10-17
BAL,2022-10-16,10,Sun,6,6,@,NYG,L 20-24,10,74,3,25,13,99,BAL_NYG_2022-10-16
MIA,2022-10-16,10,Sun,6,6,,MIN,L 16-24,10,97,2,20,12,117,MIA_MIN_2022-10-16
DAL,2022-10-16,10,Sun,6,6,@,PHI,L 17-26,10,72,2,10,12,82,DAL_PHI_2022-10-16
NOR,2022-10-02,10,Sun,4,4,,MIN,L 25-28,10,102,5,35,15,137,NOR_MIN_2022-10-02
LVR,2022-09-18,10,Sun,2,2,,ARI,L 23-29 (OT),10,68,12,120,22,188,LVR_ARI_2022-09-18
SEA,2022-09-18,10,Sun,2,2,@,SFO,L 7-27,10,106,1,26,11,132,SEA_SFO_2022-09-18
DAL,2022-09-11,10,Sun,1,1,,TAM,L 3-19,10,73,5,25,15,98,DAL_TAM_2022-09-11
PHI,2022-09-11,10,Sun,1,1,@,DET,W 38-35,10,61,7,65,17,126,PHI_DET_2022-09-11
LAC,2022-01-09,10,Sun,17,18,@,LVR,L 32-35 (OT),10,108,4,38,14,146,LAC_LVR_2022-01-09
CLE,2022-01-03,10,Mon,16,17,@,PIT,L 14-26,10,77,5,51,15,128,CLE_PIT_2022-01-03
KAN,2022-01-02,10,Sun,16,17,@,CIN,L 31-34,10,83,5,62,15,145,KAN_CIN_2022-01-02
DAL,2022-01-02,10,Sun,16,17,,ARI,L 22-25,10,88,7,45,17,133,DAL_ARI_2022-01-02
HOU,2021-12-26,10,Sun,15,16,,LAC,W 41-29,10,70,5,49,15,119,HOU_LAC_2021-12-26
BAL,2021-12-12,10,Sun,13,14,@,CLE,L 22-24,10,129,4,42,14,171,BAL_CLE_2021-12-12
PIT,2021-12-09,10,Thu,13,14,@,MIN,L 28-36,10,85,11,102,21,187,PIT_MIN_2021-12-09
SFO,2021-12-05,10,Sun,12,13,@,SEA,L 23-30,10,86,6,40,16,126,SFO_SEA_2021-12-05
BAL,2021-12-05,10,Sun,12,13,@,PIT,L 19-20,10,55,5,81,15,136,BAL_PIT_2021-12-05
DET,2021-11-25,10,Thu,11,12,,CHI,L 14-16,10,67,5,50,15,117,DET_CHI_2021-11-25
CLE,2021-11-21,10,Sun,11,11,,DET,W 13-10,10,82,7,67,17,149,CLE_DET_2021-11-21
MIN,2021-11-14,10,Sun,9,10,@,LAC,W 27-20,10,118,7,52,17,170,MIN_LAC_2021-11-14
CLE,2021-11-07,10,Sun,9,9,@,CIN,W 41-16,10,84,4,31,14,115,CLE_CIN_2021-11-07
CAR,2021-11-07,10,Sun,9,9,,NWE,L 6-24,10,83,6,35,16,118,CAR_NWE_2021-11-07
NOR,2021-11-07,10,Sun,8,9,,ATL,L 25-27,10,74,6,76,16,150,NOR_ATL_2021-11-07
NYG,2021-11-01,10,Mon,8,8,@,KAN,L 17-20,10,88,12,103,22,191,NYG_KAN_2021-11-01
BUF,2021-10-10,10,Sun,5,5,@,KAN,W 38-20,10,103,7,55,17,158,BUF_KAN_2021-10-10
LVR,2021-10-10,10,Sun,5,5,,CHI,L 9-20,10,82,8,70,18,152,LVR_CHI_2021-10-10
HOU,2021-10-03,10,Sun,4,4,@,BUF,L 0-40,10,100,3,30,13,130,HOU_BUF_2021-10-03
PIT,2021-09-26,10,Sun,3,3,,CIN,L 10-24,10,73,10,89,20,162,PIT_CIN_2021-09-26
CIN,2021-09-26,10,Sun,3,3,@,PIT,W 24-10,10,89,10,73,20,162,CIN_PIT_2021-09-26
DEN,2021-09-19,10,Sun,2,2,@,JAX,W 23-13,10,101,7,70,17,171,DEN_JAX_2021-09-19
SEA,2021-09-19,10,Sun,2,2,,TEN,L 30-33 (OT),10,100,5,45,15,145,SEA_TEN_2021-09-19
LVR,2021-09-13,10,Mon,1,1,,BAL,W 33-27 (OT),10,62,5,71,15,133,LVR_BAL_2021-09-13
JAX,2021-09-12,10,Sun,1,1,@,HOU,L 21-37,10,82,5,50,15,132,JAX_HOU_2021-09-12
JAX,2020-12-27,10,Sun,15,16,,CHI,L 17-41,10,115,4,40,14,155,JAX_CHI_2020-12-27
BAL,2020-12-27,10,Sun,15,16,,NYG,W 27-13,10,65,5,35,15,100,BAL_NYG_2020-12-27
NOR,2020-12-20,10,Sun,14,15,,KAN,L 29-32,10,93,5,54,15,147,NOR_KAN_2020-12-20
JAX,2020-12-13,10,Sun,13,14,,TEN,L 10-31,10,80,7,78,17,158,JAX_TEN_2020-12-13
JAX,2020-12-06,10,Sun,12,13,@,MIN,L 24-27 (OT),10,83,6,41,16,124,JAX_MIN_2020-12-06
NOR,2020-12-06,10,Sun,12,13,@,ATL,W 21-16,10,79,1,15,11,94,NOR_ATL_2020-12-06
KAN,2020-11-29,10,Sun,11,12,@,TAM,W 27-24,10,82,8,57,18,139,KAN_TAM_2020-11-29
HOU,2020-11-26,10,Thu,11,12,@,DET,W 41-25,10,74,4,44,14,118,HOU_DET_2020-11-26
KAN,2020-11-22,10,Sun,10,11,@,LVR,W 35-31,10,89,8,72,18,161,KAN_LVR_2020-11-22
ARI,2020-11-19,10,Thu,10,11,@,SEA,L 21-28,10,115,8,79,18,194,ARI_SEA_2020-11-19
CHI,2020-10-18,10,Sun,6,6,@,CAR,W 23-16,10,92,8,69,18,161,CHI_CAR_2020-10-18
BUF,2020-10-13,10,Tue,5,5,@,TEN,L 16-42,10,56,6,46,16,102,BUF_TEN_2020-10-13
ARI,2020-10-11,10,Sun,5,5,@,NYJ,W 30-10,10,59,6,30,16,89,ARI_NYJ_2020-10-11
KAN,2020-10-11,10,Sun,5,5,,LVR,L 32-40,10,94,8,59,18,153,KAN_LVR_2020-10-11
CAR,2020-10-04,10,Sun,4,4,,ARI,W 31-21,10,72,5,29,15,101,CAR_ARI_2020-10-04
CHI,2020-09-27,10,Sun,3,3,@,ATL,W 30-26,10,80,7,75,17,155,CHI_ATL_2020-09-27
DAL,2020-09-27,10,Sun,3,3,@,SEA,L 31-38,10,59,5,30,15,89,DAL_SEA_2020-09-27
NOR,2020-09-21,10,Mon,2,2,@,LVR,L 24-34,10,129,3,13,13,142,NOR_LVR_2020-09-21
PIT,2020-09-20,10,Sun,2,2,,DEN,W 26-21,10,89,4,30,14,119,PIT_DEN_2020-09-20
DAL,2019-12-29,10,Sun,16,17,,WAS,W 47-16,10,81,2,10,12,91,DAL_WAS_2019-12-29
LAR,2019-12-29,10,Sun,16,17,,ARI,W 31-24,10,91,8,63,18,154,LAR_ARI_2019-12-29
OAK,2019-12-29,10,Sun,16,17,@,DEN,L 15-16,10,107,9,61,19,168,OAK_DEN_2019-12-29
CIN,2019-12-22,10,Sun,15,16,@,MIA,L 35-38 (OT),10,77,6,47,16,124,CIN_MIA_2019-12-22
KAN,2019-12-08,10,Sun,13,14,@,NWE,W 23-16,10,136,5,25,15,161,KAN_NWE_2019-12-08
SFO,2019-12-08,10,Sun,13,14,@,NOR,W 48-46,10,67,5,50,15,117,SFO_NOR_2019-12-08
JAX,2019-12-08,10,Sun,13,14,,LAC,L 10-45,10,101,6,65,16,166,JAX_LAC_2019-12-08
PIT,2019-12-01,10,Sun,12,13,,CLE,W 20-13,10,65,5,34,15,99,PIT_CLE_2019-12-01
NYJ,2019-12-01,10,Sun,12,13,@,CIN,L 6-22,10,106,2,15,12,121,NYJ_CIN_2019-12-01
PHI,2019-12-01,10,Sun,12,13,@,MIA,L 31-37,10,91,7,59,17,150,PHI_MIA_2019-12-01
CHI,2019-11-28,10,Thu,12,13,@,DET,W 24-20,10,89,9,85,19,174,CHI_DET_2019-11-28
PIT,2019-11-24,10,Sun,11,12,@,CIN,W 16-10,10,77,7,79,17,156,PIT_CIN_2019-11-24
ARI,2019-11-17,10,Sun,11,11,@,SFO,L 26-36,10,104,10,127,20,231,ARI_SFO_2019-11-17
SFO,2019-11-17,10,Sun,10,11,,ARI,W 36-26,10,127,10,104,20,231,SFO_ARI_2019-11-17
LAR,2019-11-10,10,Sun,9,10,@,PIT,L 12-17,10,95,13,107,23,202,LAR_PIT_2019-11-10
GNB,2019-11-10,10,Sun,10,10,,CAR,W 24-16,10,64,5,46,15,110,GNB_CAR_2019-11-10
DAL,2019-11-04,10,Mon,8,9,@,NYG,W 37-18,10,104,8,71,18,175,DAL_NYG_2019-11-04
TAM,2019-11-03,10,Sun,8,9,@,SEA,L 34-40 (OT),10,82,4,45,14,127,TAM_SEA_2019-11-03
OAK,2019-11-03,10,Sun,8,9,,DET,W 31-24,10,96,5,35,15,131,OAK_DET_2019-11-03
NYJ,2019-11-03,10,Sun,8,9,@,MIA,L 18-26,10,105,6,51,16,156,NYJ_MIA_2019-11-03
IND,2019-10-27,10,Sun,7,8,,DEN,W 15-13,10,103,10,88,20,191,IND_DEN_2019-10-27
NYJ,2019-10-27,10,Sun,7,8,@,JAX,L 15-29,10,83,9,70,19,153,NYJ_JAX_2019-10-27
DEN,2019-10-27,10,Sun,8,8,@,IND,L 13-15,10,88,10,103,20,191,DEN_IND_2019-10-27
HOU,2019-10-20,10,Sun,7,7,@,IND,L 23-30,10,54,6,45,16,99,HOU_IND_2019-10-20
ARI,2019-10-20,10,Sun,7,7,@,NYG,W 27-21,10,85,6,75,16,160,ARI_NYG_2019-10-20
SEA,2019-10-13,10,Sun,6,6,@,CLE,W 32-28,10,65,9,83,19,148,SEA_CLE_2019-10-13
HOU,2019-10-13,10,Sun,6,6,@,KAN,W 31-24,10,70,11,79,21,149,HOU_KAN_2019-10-13
BAL,2019-10-13,10,Sun,6,6,,CIN,W 23-17,10,81,4,20,14,101,BAL_CIN_2019-10-13
CHI,2019-10-06,10,Sun,5,5,@,OAK,L 21-24,10,75,6,69,16,144,CHI_OAK_2019-10-06
LAC,2019-09-29,10,Sun,4,4,@,MIA,W 30-10,10,89,5,53,15,142,LAC_MIA_2019-09-29
DEN,2019-09-15,10,Sun,2,2,,CHI,L 14-16,10,81,7,65,17,146,DEN_CHI_2019-09-15
BAL,2019-09-15,10,Sun,2,2,,ARI,W 23-17,10,62,8,70,18,132,BAL_ARI_2019-09-15
ATL,2019-09-15,10,Sun,2,2,,PHI,W 24-20,10,58,7,60,17,118,ATL_PHI_2019-09-15
SEA,2019-09-15,10,Sun,2,2,@,PIT,W 28-26,10,93,5,78,15,171,SEA_PIT_2019-09-15
KAN,2019-09-15,10,Sun,2,2,@,OAK,W 28-10,10,114,7,52,17,166,KAN_OAK_2019-09-15
JAX,2019-09-08,10,Sun,1,1,,KAN,L 26-40,10,71,5,55,15,126,JAX_KAN_2019-09-08
GNB,2019-09-05,10,Thu,1,1,@,CHI,W 10-3,10,71,10,107,20,178,GNB_CHI_2019-09-05
CHI,2019-09-05,10,Thu,1,1,,GNB,L 3-10,10,107,10,71,20,178,CHI_GNB_2019-09-05
BAL,2018-12-30,10,Sun,16,17,,CLE,W 26-24,10,65,4,35,14,100,BAL_CLE_2018-12-30
MIA,2018-12-23,10,Sun,15,16,,JAX,L 7-17,10,95,10,97,20,192,MIA_JAX_2018-12-23
CAR,2018-12-23,10,Sun,15,16,,ATL,L 10-24,10,86,4,41,14,127,CAR_ATL_2018-12-23
JAX,2018-12-23,10,Sun,15,16,@,MIA,W 17-7,10,97,10,95,20,192,JAX_MIA_2018-12-23
DAL,2018-12-23,10,Sun,15,16,,TAM,W 27-20,10,67,9,72,19,139,DAL_TAM_2018-12-23
HOU,2018-12-23,10,Sun,15,16,@,PHI,L 30-32,10,61,11,105,21,166,HOU_PHI_2018-12-23
GNB,2018-12-23,10,Sun,15,16,@,NYJ,W 44-38 (OT),10,86,16,172,26,258,GNB_NYJ_2018-12-23
NYG,2018-12-16,10,Sun,14,15,,TEN,L 0-17,10,58,4,35,14,93,NYG_TEN_2018-12-16
KAN,2018-12-13,10,Thu,14,15,,LAC,L 28-29,10,66,7,50,17,116,KAN_LAC_2018-12-13
CAR,2018-12-09,10,Sun,13,14,@,CLE,L 20-26,10,68,7,52,17,120,CAR_CLE_2018-12-09
TAM,2018-12-09,10,Sun,13,14,,NOR,L 14-28,10,84,6,51,16,135,TAM_NOR_2018-12-09
WAS,2018-12-03,10,Mon,12,13,@,PHI,L 13-28,10,69,5,38,15,107,WAS_PHI_2018-12-03
SEA,2018-12-02,10,Sun,12,13,,SFO,W 43-16,10,100,13,128,23,228,SEA_SFO_2018-12-02
JAX,2018-11-25,10,Sun,11,12,@,BUF,L 21-24,10,90,13,80,23,170,JAX_BUF_2018-11-25
MIA,2018-11-25,10,Sun,11,12,@,IND,L 24-27,10,75,7,52,17,127,MIA_IND_2018-11-25
SFO,2018-11-12,10,Mon,10,10,,NYG,L 23-27,10,97,8,78,18,175,SFO_NYG_2018-11-12
LAR,2018-11-11,10,Sun,10,10,,SEA,W 36-31,10,102,7,56,17,158,LAR_SEA_2018-11-11
WAS,2018-11-04,10,Sun,8,9,,ATL,L 14-38,10,147,7,50,17,197,WAS_ATL_2018-11-04
BUF,2018-11-04,10,Sun,9,9,,CHI,L 9-41,10,163,14,129,24,292,BUF_CHI_2018-11-04
SEA,2018-11-04,10,Sun,8,9,,LAC,L 17-25,10,83,12,105,22,188,SEA_LAC_2018-11-04
DEN,2018-10-28,10,Sun,8,8,@,KAN,L 23-30,10,83,7,50,17,133,DEN_KAN_2018-10-28
IND,2018-10-28,10,Sun,8,8,@,OAK,W 42-28,10,77,10,79,20,156,IND_OAK_2018-10-28
OAK,2018-10-28,10,Sun,7,8,,IND,L 28-42,10,79,10,77,20,156,OAK_IND_2018-10-28
LAC,2018-10-14,10,Sun,6,6,@,CLE,W 38-14,10,72,6,53,16,125,LAC_CLE_2018-10-14
BAL,2018-10-14,10,Sun,6,6,@,TEN,W 21-0,10,70,4,35,14,105,BAL_TEN_2018-10-14
LAR,2018-10-14,10,Sun,6,6,@,DEN,W 23-20,10,81,6,61,16,142,LAR_DEN_2018-10-14
CLE,2018-10-07,10,Sun,5,5,,BAL,W 12-9 (OT),10,66,4,41,14,107,CLE_BAL_2018-10-07
KAN,2018-10-01,10,Mon,4,4,@,DEN,W 27-23,10,93,3,25,13,118,KAN_DEN_2018-10-01
IND,2018-09-30,10,Sun,4,4,,HOU,L 34-37 (OT),10,85,10,54,20,139,IND_HOU_2018-09-30
MIA,2018-09-30,10,Sun,4,4,@,NWE,L 7-38,10,89,6,57,16,146,MIA_NWE_2018-09-30
ATL,2018-09-30,10,Sun,4,4,,CIN,L 36-37,10,95,6,55,16,150,ATL_CIN_2018-09-30
HOU,2018-09-30,10,Sun,4,4,@,IND,W 37-34 (OT),10,54,10,85,20,139,HOU_IND_2018-09-30
SEA,2018-09-23,10,Sun,3,3,,DAL,W 24-13,10,67,7,55,17,122,SEA_DAL_2018-09-23
PHI,2018-09-23,10,Sun,3,3,,IND,W 20-16,10,110,11,77,21,187,PHI_IND_2018-09-23
DET,2018-09-16,10,Sun,2,2,@,SFO,L 27-30,10,105,9,86,19,191,DET_SFO_2018-09-16
DAL,2018-09-09,10,Sun,1,1,@,CAR,L 8-16,10,85,9,80,19,165,DAL_CAR_2018-09-09
BUF,2018-09-09,10,Sun,1,1,@,BAL,L 3-47,10,100,9,78,19,178,BUF_BAL_2018-09-09
CHI,2017-12-31,10,Sun,16,17,@,MIN,L 10-23,10,116,12,103,22,219,CHI_MIN_2017-12-31
ATL,2017-12-24,10,Sun,15,16,@,NOR,L 13-23,10,91,3,30,13,121,ATL_NOR_2017-12-24
NYG,2017-12-24,10,Sun,15,16,@,ARI,L 0-23,10,101,6,45,16,146,NYG_ARI_2017-12-24
CHI,2017-12-10,10,Sun,13,14,@,CIN,W 33-7,10,74,7,56,17,130,CHI_CIN_2017-12-10
PHI,2017-12-10,10,Sun,13,14,@,LAR,W 43-35,10,67,7,102,17,169,PHI_LAR_2017-12-10
ARI,2017-11-26,10,Sun,11,12,,JAX,W 27-24,10,98,5,45,15,143,ARI_JAX_2017-11-26
CAR,2017-11-26,10,Sun,11,12,@,NYJ,W 35-27,10,84,7,68,17,152,CAR_NYJ_2017-11-26
ARI,2017-11-19,10,Sun,10,11,@,HOU,L 21-31,10,90,6,42,16,132,ARI_HOU_2017-11-19
LAR,2017-11-12,10,Sun,9,10,,HOU,W 33-7,10,86,8,60,18,146,LAR_HOU_2017-11-12
OAK,2017-11-05,10,Sun,9,9,@,MIA,W 27-24,10,105,11,107,21,212,OAK_MIA_2017-11-05
NYJ,2017-11-02,10,Thu,9,9,,BUF,W 34-21,10,66,11,99,21,165,NYJ_BUF_2017-11-02
LAC,2017-10-29,10,Sun,8,8,@,NWE,L 13-21,10,77,6,80,16,157,LAC_NWE_2017-10-29
SEA,2017-10-29,10,Sun,7,8,,HOU,W 41-38,10,120,8,93,18,213,SEA_HOU_2017-10-29
ARI,2017-10-22,10,Sun,7,7,@,LAR,L 0-33,10,65,6,45,16,110,ARI_LAR_2017-10-22
DEN,2017-10-22,10,Sun,6,7,@,LAC,L 0-21,10,68,9,81,19,149,DEN_LAC_2017-10-22
OAK,2017-10-19,10,Thu,7,7,,KAN,W 31-30,10,97,8,108,18,205,OAK_KAN_2017-10-19
PHI,2017-10-12,10,Thu,6,6,@,CAR,W 28-23,10,126,1,1,11,127,PHI_CAR_2017-10-12
SFO,2017-10-08,10,Sun,5,5,@,IND,L 23-26 (OT),10,77,7,62,17,139,SFO_IND_2017-10-08
NYG,2017-10-08,10,Sun,5,5,,LAC,L 22-27,10,67,11,87,21,154,NYG_LAC_2017-10-08
NYJ,2017-10-01,10,Sun,4,4,,JAX,W 23-20 (OT),10,70,6,47,16,117,NYJ_JAX_2017-10-01
ARI,2017-10-01,10,Sun,4,4,,SFO,W 18-15 (OT),10,80,13,113,23,193,ARI_SFO_2017-10-01
HOU,2017-09-24,10,Sun,3,3,@,NWE,L 33-36,10,60,5,69,15,129,HOU_NWE_2017-09-24
CHI,2017-09-24,10,Sun,3,3,,PIT,W 23-17 (OT),10,73,6,40,16,113,CHI_PIT_2017-09-24
BAL,2017-09-24,10,Sun,3,3,@,JAX,L 7-44,10,88,9,70,19,158,BAL_JAX_2017-09-24
CLE,2017-09-24,10,Sun,3,3,@,IND,L 28-31,10,113,11,99,21,212,CLE_IND_2017-09-24
WAS,2017-09-24,10,Sun,3,3,,OAK,W 27-10,10,77,4,35,14,112,WAS_OAK_2017-09-24
NYG,2017-09-24,10,Sun,3,3,@,PHI,L 24-27,10,137,9,103,19,240,NYG_PHI_2017-09-24
NYJ,2017-09-24,10,Sun,3,3,,MIA,W 20-6,10,94,8,51,18,145,NYJ_MIA_2017-09-24
DEN,2017-09-24,10,Sun,3,3,@,BUF,L 16-26,10,79,8,69,18,148,DEN_BUF_2017-09-24
SFO,2017-09-21,10,Thu,3,3,,LAR,L 39-41,10,55,7,52,17,107,SFO_LAR_2017-09-21
GNB,2017-09-17,10,Sun,2,2,@,ATL,L 23-34,10,70,6,34,16,104,GNB_ATL_2017-09-17
PIT,2017-09-17,10,Sun,2,2,,MIN,W 26-9,10,72,11,131,21,203,PIT_MIN_2017-09-17
JAX,2017-09-17,10,Sun,2,2,,TEN,L 16-37,10,99,7,70,17,169,JAX_TEN_2017-09-17
SFO,2017-09-10,10,Sun,1,1,,CAR,L 3-23,10,74,5,40,15,114,SFO_CAR_2017-09-10
JAX,2017-09-10,10,Sun,1,1,@,HOU,W 29-7,10,89,9,94,19,183,JAX_HOU_2017-09-10
DET,2017-09-10,10,Sun,1,1,,ARI,W 35-23,10,100,6,55,16,155,DET_ARI_2017-09-10
CLE,2023-01-08,9,Sun,17,18,@,PIT,L 14-28,9,65,4,20,13,85,CLE_PIT_2023-01-08
MIA,2023-01-01,9,Sun,16,17,@,NWE,L 21-23,9,71,6,39,15,110,MIA_NWE_2023-01-01
SFO,2023-01-01,9,Sun,16,17,@,LVR,W 37-34 (OT),9,71,6,49,15,120,SFO_LVR_2023-01-01
BUF,2022-12-24,9,Sat,15,16,@,CHI,W 35-13,9,72,2,15,11,87,BUF_CHI_2022-12-24
NYJ,2022-12-22,9,Thu,15,16,,JAX,L 3-19,9,64,3,25,12,89,NYJ_JAX_2022-12-22
MIN,2022-12-17,9,Sat,14,15,,IND,W 39-36 (OT),9,74,11,103,20,177,MIN_IND_2022-12-17
JAX,2022-12-11,9,Sun,13,14,@,TEN,W 36-22,9,70,5,50,14,120,JAX_TEN_2022-12-11
CLE,2022-12-11,9,Sun,13,14,@,CIN,L 10-23,9,98,4,36,13,134,CLE_CIN_2022-12-11
CIN,2022-11-27,9,Sun,11,12,@,TEN,W 20-16,9,80,8,57,17,137,CIN_TEN_2022-11-27
TAM,2022-11-27,9,Sun,11,12,@,CLE,L 17-23 (OT),9,70,5,42,14,112,TAM_CLE_2022-11-27
LVR,2022-11-20,9,Sun,10,11,@,DEN,W 22-16 (OT),9,98,5,45,14,143,LVR_DEN_2022-11-20
CAR,2022-11-20,9,Sun,11,11,@,BAL,L 3-13,9,66,10,93,19,159,CAR_BAL_2022-11-20
TEN,2022-11-13,9,Sun,9,10,,DEN,W 17-10,9,60,8,50,17,110,TEN_DEN_2022-11-13
DAL,2022-11-13,9,Sun,9,10,@,GNB,L 28-31 (OT),9,83,6,40,15,123,DAL_GNB_2022-11-13
CHI,2022-11-13,9,Sun,10,10,,DET,L 30-31,9,86,2,15,11,101,CHI_DET_2022-11-13
CAR,2022-10-30,9,Sun,8,8,@,ATL,L 34-37 (OT),9,74,7,64,16,138,CAR_ATL_2022-10-30
PIT,2022-10-30,9,Sun,8,8,@,PHI,L 13-35,9,60,8,60,17,120,PIT_PHI_2022-10-30
GNB,2022-10-23,9,Sun,7,7,@,WAS,L 21-23,9,69,7,54,16,123,GNB_WAS_2022-10-23
LAC,2022-10-17,9,Mon,6,6,,DEN,W 19-16 (OT),9,89,10,151,19,240,LAC_DEN_2022-10-17
WAS,2022-10-09,9,Sun,5,5,,TEN,L 17-21,9,71,8,69,17,140,WAS_TEN_2022-10-09
SFO,2022-10-09,9,Sun,5,5,@,CAR,W 37-15,9,50,5,33,14,83,SFO_CAR_2022-10-09
BAL,2022-10-02,9,Sun,4,4,,BUF,L 20-23,9,70,4,31,13,101,BAL_BUF_2022-10-02
HOU,2022-10-02,9,Sun,4,4,,LAC,L 24-34,9,67,6,61,15,128,HOU_LAC_2022-10-02
TEN,2022-09-19,9,Mon,2,2,@,BUF,L 7-41,9,87,8,49,17,136,TEN_BUF_2022-09-19
NOR,2022-09-18,9,Sun,2,2,,TAM,L 10-20,9,60,8,101,17,161,NOR_TAM_2022-09-18
CLE,2022-09-11,9,Sun,1,1,@,CAR,W 26-24,9,71,8,96,17,167,CLE_CAR_2022-09-11
CHI,2021-12-20,9,Mon,14,15,,MIN,L 9-17,9,91,7,54,16,145,CHI_MIN_2021-12-20
HOU,2021-12-19,9,Sun,14,15,@,JAX,W 30-16,9,65,4,40,13,105,HOU_JAX_2021-12-19
LVR,2021-12-12,9,Sun,13,14,@,KAN,L 9-48,9,85,8,63,17,148,LVR_KAN_2021-12-12
JAX,2021-12-12,9,Sun,13,14,@,TEN,L 0-20,9,79,2,15,11,94,JAX_TEN_2021-12-12
LAC,2021-11-28,9,Sun,11,12,@,DEN,L 13-28,9,75,5,35,14,110,LAC_DEN_2021-11-28
ATL,2021-11-18,9,Thu,10,11,,NWE,L 0-25,9,72,5,59,14,131,ATL_NWE_2021-11-18
SFO,2021-11-15,9,Mon,9,10,,LAR,W 31-10,9,53,5,35,14,88,SFO_LAR_2021-11-15
NOR,2021-11-14,9,Sun,9,10,@,TEN,L 21-23,9,65,8,49,17,114,NOR_TEN_2021-11-14
NYJ,2021-11-14,9,Sun,9,10,,BUF,L 17-45,9,69,7,50,16,119,NYJ_BUF_2021-11-14
CAR,2021-11-14,9,Sun,10,10,@,ARI,W 34-10,9,115,4,58,13,173,CAR_ARI_2021-11-14
LVR,2021-11-14,9,Sun,9,10,,KAN,L 14-41,9,68,4,34,13,102,LVR_KAN_2021-11-14
ARI,2021-11-07,9,Sun,9,9,@,SFO,W 31-17,9,84,3,35,12,119,ARI_SFO_2021-11-07
IND,2021-10-31,9,Sun,8,8,,TEN,L 31-34 (OT),9,75,11,161,20,236,IND_TEN_2021-10-31
MIA,2021-10-31,9,Sun,8,8,@,BUF,L 11-26,9,58,9,80,18,138,MIA_BUF_2021-10-31
BUF,2021-10-31,9,Sun,7,8,,MIA,W 26-11,9,80,9,58,18,138,BUF_MIA_2021-10-31
KAN,2021-10-24,9,Sun,7,7,@,TEN,L 3-27,9,77,6,31,15,108,KAN_TEN_2021-10-24
CLE,2021-10-21,9,Thu,7,7,,DEN,W 17-14,9,60,2,15,11,75,CLE_DEN_2021-10-21
DET,2021-10-17,9,Sun,6,6,,CIN,L 11-34,9,77,4,31,13,108,DET_CIN_2021-10-17
CLE,2021-10-17,9,Sun,6,6,,ARI,L 14-37,9,88,5,45,14,133,CLE_ARI_2021-10-17
CAR,2021-10-10,9,Sun,5,5,,PHI,L 18-21,9,69,6,60,15,129,CAR_PHI_2021-10-10
PHI,2021-10-03,9,Sun,4,4,,KAN,L 30-42,9,49,7,46,16,95,PHI_KAN_2021-10-03
NYJ,2021-09-26,9,Sun,3,3,@,DEN,L 0-26,9,90,6,50,15,140,NYJ_DEN_2021-09-26
DET,2021-09-20,9,Mon,2,2,@,GNB,L 17-35,9,78,5,50,14,128,DET_GNB_2021-09-20
TAM,2021-09-19,9,Sun,2,2,,ATL,W 48-25,9,83,6,49,15,132,TAM_ATL_2021-09-19
MIA,2021-09-19,9,Sun,2,2,,BUF,L 0-35,9,83,6,53,15,136,MIA_BUF_2021-09-19
HOU,2021-09-19,9,Sun,2,2,@,CLE,L 21-31,9,78,5,62,14,140,HOU_CLE_2021-09-19
WAS,2021-09-16,9,Thu,2,2,,NYG,W 30-29,9,80,11,81,20,161,WAS_NYG_2021-09-16
IND,2020-12-27,9,Sun,15,16,@,PIT,L 24-28,9,83,6,49,15,132,IND_PIT_2020-12-27
PHI,2020-12-20,9,Sun,14,15,@,ARI,L 26-33,9,69,9,83,18,152,PHI_ARI_2020-12-20
ARI,2020-12-20,9,Sun,14,15,,PHI,W 33-26,9,83,9,69,18,152,ARI_PHI_2020-12-20
WAS,2020-12-07,9,Mon,12,13,@,PIT,W 23-17,9,62,6,45,15,107,WAS_PIT_2020-12-07
PHI,2020-11-30,9,Mon,11,12,,SEA,L 17-23,9,79,8,83,17,162,PHI_SEA_2020-11-30
TEN,2020-11-29,9,Sun,11,12,@,IND,W 45-26,9,63,6,50,15,113,TEN_IND_2020-11-29
BUF,2020-11-29,9,Sun,11,12,,LAC,W 27-17,9,85,5,91,14,176,BUF_LAC_2020-11-29
LAC,2020-11-22,9,Sun,10,11,,NYJ,W 34-28,9,78,8,88,17,166,LAC_NYJ_2020-11-22
BUF,2020-11-15,9,Sun,10,10,@,ARI,L 30-32,9,69,7,40,16,109,BUF_ARI_2020-11-15
DET,2020-11-15,9,Sun,9,10,,WAS,W 30-27,9,55,6,58,15,113,DET_WAS_2020-11-15
IND,2020-11-12,9,Thu,9,10,@,TEN,W 34-17,9,73,3,30,12,103,IND_TEN_2020-11-12
MIN,2020-11-08,9,Sun,8,9,,DET,W 34-20,9,69,3,37,12,106,MIN_DET_2020-11-08
GNB,2020-11-01,9,Sun,7,8,,MIN,L 22-28,9,85,7,36,16,121,GNB_MIN_2020-11-01
BAL,2020-11-01,9,Sun,7,8,,PIT,L 24-28,9,110,3,30,12,140,BAL_PIT_2020-11-01
NYG,2020-10-22,9,Thu,7,7,@,PHI,L 21-22,9,62,7,75,16,137,NYG_PHI_2020-10-22
PHI,2020-10-11,9,Sun,5,5,@,PIT,L 29-38,9,84,8,86,17,170,PHI_PIT_2020-10-11
TAM,2020-09-27,9,Sun,3,3,@,DEN,W 28-10,9,71,4,30,13,101,TAM_DEN_2020-09-27
CIN,2020-09-27,9,Sun,3,3,@,PHI,T 23-23 (OT),9,73,11,93,20,166,CIN_PHI_2020-09-27
IND,2020-09-20,9,Sun,2,2,,MIN,W 28-11,9,93,6,45,15,138,IND_MIN_2020-09-20
SEA,2020-09-20,9,Sun,2,2,,NWE,W 35-30,9,68,2,12,11,80,SEA_NWE_2020-09-20
CAR,2020-09-20,9,Sun,2,2,@,TAM,L 17-31,9,77,5,37,14,114,CAR_TAM_2020-09-20
NYJ,2020-09-13,9,Sun,1,1,@,BUF,L 17-27,9,95,7,79,16,174,NYJ_BUF_2020-09-13
TAM,2020-09-13,9,Sun,1,1,@,NOR,L 23-34,9,103,6,119,15,222,TAM_NOR_2020-09-13
ARI,2020-09-13,9,Sun,1,1,@,SFO,W 24-20,9,102,5,53,14,155,ARI_SFO_2020-09-13
DEN,2019-12-29,9,Sun,16,17,,OAK,W 16-15,9,61,10,107,19,168,DEN_OAK_2019-12-29
GNB,2019-12-29,9,Sun,16,17,@,DET,W 23-20,9,97,4,50,13,147,GNB_DET_2019-12-29
KAN,2019-12-22,9,Sun,15,16,@,CHI,W 26-3,9,71,7,50,16,121,KAN_CHI_2019-12-22
ATL,2019-12-22,9,Sun,15,16,,JAX,W 24-12,9,64,6,36,15,100,ATL_JAX_2019-12-22
TAM,2019-12-15,9,Sun,14,15,@,DET,W 38-17,9,70,2,10,11,80,TAM_DET_2019-12-15
HOU,2019-12-08,9,Sun,13,14,,DEN,L 24-38,9,44,7,50,16,94,HOU_DEN_2019-12-08
BAL,2019-12-08,9,Sun,13,14,@,BUF,W 24-17,9,99,5,49,14,148,BAL_BUF_2019-12-08
DET,2019-11-28,9,Thu,12,13,,CHI,L 20-24,9,85,10,89,19,174,DET_CHI_2019-11-28
NOR,2019-11-28,9,Thu,12,13,@,ATL,W 26-18,9,121,4,18,13,139,NOR_ATL_2019-11-28
SFO,2019-11-24,9,Sun,11,12,,GNB,W 37-8,9,78,5,50,14,128,SFO_GNB_2019-11-24
LAC,2019-11-18,9,Mon,11,11,,KAN,L 17-24,9,60,8,102,17,162,LAC_KAN_2019-11-18
NOR,2019-11-17,9,Sun,10,11,@,TAM,W 34-17,9,76,7,55,16,131,NOR_TAM_2019-11-17
SEA,2019-11-11,9,Mon,10,10,@,SFO,W 27-24 (OT),9,75,5,40,14,115,SEA_SFO_2019-11-11
KAN,2019-11-10,9,Sun,10,10,@,TEN,L 32-35,9,80,8,64,17,144,KAN_TEN_2019-11-10
TAM,2019-11-10,9,Sun,9,10,,ARI,W 30-27,9,94,11,87,20,181,TAM_ARI_2019-11-10
CHI,2019-11-03,9,Sun,8,9,@,PHI,L 14-22,9,70,8,75,17,145,CHI_PHI_2019-11-03
ARI,2019-10-31,9,Thu,9,9,,SFO,L 25-28,9,65,8,75,17,140,ARI_SFO_2019-10-31
PIT,2019-10-28,9,Mon,7,8,,MIA,W 27-14,9,70,5,45,14,115,PIT_MIA_2019-10-28
JAX,2019-10-27,9,Sun,8,8,,NYJ,W 29-15,9,70,10,83,19,153,JAX_NYJ_2019-10-27
TAM,2019-10-27,9,Sun,7,8,@,TEN,L 23-27,9,87,6,77,15,164,TAM_TEN_2019-10-27
CAR,2019-10-27,9,Sun,7,8,@,SFO,L 13-51,9,70,4,31,13,101,CAR_SFO_2019-10-27
LAR,2019-10-27,9,Sun,8,8,,CIN,W 24-10,9,59,6,40,15,99,LAR_CIN_2019-10-27
SEA,2019-10-27,9,Sun,8,8,@,ATL,W 27-20,9,60,5,40,14,100,SEA_ATL_2019-10-27
BUF,2019-10-20,9,Sun,6,7,,MIA,W 31-21,9,83,6,55,15,138,BUF_MIA_2019-10-20
DAL,2019-10-13,9,Sun,6,6,@,NYJ,L 22-24,9,68,8,105,17,173,DAL_NYJ_2019-10-13
CLE,2019-10-13,9,Sun,6,6,,SEA,L 28-32,9,83,10,65,19,148,CLE_SEA_2019-10-13
TAM,2019-10-13,9,Sun,6,6,,CAR,L 26-37,9,70,3,30,12,100,TAM_CAR_2019-10-13
GNB,2019-10-06,9,Sun,5,5,@,DAL,W 34-24,9,78,11,124,20,202,GNB_DAL_2019-10-06
JAX,2019-10-06,9,Sun,5,5,@,CAR,L 27-34,9,84,8,70,17,154,JAX_CAR_2019-10-06
HOU,2019-10-06,9,Sun,5,5,,ATL,W 53-32,9,89,7,63,16,152,HOU_ATL_2019-10-06
PHI,2019-10-06,9,Sun,5,5,,NYJ,W 31-6,9,76,9,52,18,128,PHI_NYJ_2019-10-06
NYJ,2019-10-06,9,Sun,4,5,@,PHI,L 6-31,9,52,9,76,18,128,NYJ_PHI_2019-10-06
NOR,2019-09-29,9,Sun,4,4,,DAL,W 12-10,9,80,6,64,15,144,NOR_DAL_2019-09-29
PHI,2019-09-26,9,Thu,4,4,@,GNB,W 34-27,9,93,5,50,14,143,PHI_GNB_2019-09-26
WAS,2019-09-23,9,Mon,3,3,,CHI,L 15-31,9,61,9,59,18,120,WAS_CHI_2019-09-23
CHI,2019-09-23,9,Mon,3,3,@,WAS,W 31-15,9,59,9,61,18,120,CHI_WAS_2019-09-23
DET,2019-09-22,9,Sun,3,3,@,PHI,W 27-24,9,61,4,30,13,91,DET_PHI_2019-09-22
TEN,2019-09-19,9,Thu,3,3,@,JAX,L 7-20,9,101,4,30,13,131,TEN_JAX_2019-09-19
CLE,2019-09-16,9,Mon,2,2,@,NYJ,W 23-3,9,85,12,89,21,174,CLE_NYJ_2019-09-16
JAX,2019-09-15,9,Sun,2,2,@,HOU,L 12-13,9,70,7,47,16,117,JAX_HOU_2019-09-15
BUF,2019-09-15,9,Sun,2,2,@,NYG,W 28-14,9,65,7,40,16,105,BUF_NYG_2019-09-15
LAC,2019-09-15,9,Sun,2,2,@,DET,L 10-13,9,70,8,71,17,141,LAC_DET_2019-09-15
SFO,2019-09-15,9,Sun,2,2,@,CIN,W 41-17,9,75,7,60,16,135,SFO_CIN_2019-09-15
OAK,2019-09-09,9,Mon,1,1,,DEN,W 24-16,9,62,6,44,15,106,OAK_DEN_2019-09-09
DET,2019-09-08,9,Sun,1,1,@,ARI,T 27-27 (OT),9,59,7,35,16,94,DET_ARI_2019-09-08
ATL,2019-09-08,9,Sun,1,1,@,MIN,L 12-28,9,78,11,100,20,178,ATL_MIN_2019-09-08
MIA,2019-09-08,9,Sun,1,1,,BAL,L 10-59,9,64,4,40,13,104,MIA_BAL_2019-09-08
ATL,2018-12-30,9,Sun,16,17,@,TAM,W 34-32,9,85,3,30,12,115,ATL_TAM_2018-12-30
CIN,2018-12-30,9,Sun,16,17,@,PIT,L 13-16,9,85,9,70,18,155,CIN_PIT_2018-12-30
TEN,2018-12-30,9,Sun,16,17,,IND,L 17-33,9,75,12,96,21,171,TEN_IND_2018-12-30
PIT,2018-12-30,9,Sun,16,17,,CIN,W 16-13,9,70,9,85,18,155,PIT_CIN_2018-12-30
NOR,2018-12-23,9,Sun,15,16,,PIT,W 31-28,9,91,6,79,15,170,NOR_PIT_2018-12-23
TAM,2018-12-23,9,Sun,15,16,@,DAL,L 20-27,9,72,10,67,19,139,TAM_DAL_2018-12-23
NOR,2018-12-17,9,Mon,14,15,@,CAR,W 12-9,9,80,4,48,13,128,NOR_CAR_2018-12-17
CIN,2018-12-16,9,Sun,14,15,,OAK,W 30-16,9,85,8,90,17,175,CIN_OAK_2018-12-16
DAL,2018-12-16,9,Sun,14,15,@,IND,L 0-23,9,74,6,55,15,129,DAL_IND_2018-12-16
NYJ,2018-12-15,9,Sat,14,15,,HOU,L 22-29,9,60,5,43,14,103,NYJ_HOU_2018-12-15
IND,2018-12-09,9,Sun,13,14,@,HOU,W 24-21,9,59,7,35,16,94,IND_HOU_2018-12-09
LAR,2018-12-09,9,Sun,13,14,@,CHI,L 6-15,9,57,6,45,15,102,LAR_CHI_2018-12-09
TAM,2018-12-02,9,Sun,12,13,,CAR,W 24-17,9,69,7,104,16,173,TAM_CAR_2018-12-02
BAL,2018-12-02,9,Sun,12,13,@,ATL,W 26-16,9,88,8,82,17,170,BAL_ATL_2018-12-02
TAM,2018-11-25,9,Sun,11,12,,SFO,W 27-9,9,70,8,68,17,138,TAM_SFO_2018-11-25
CAR,2018-11-04,9,Sun,8,9,,TAM,W 42-28,9,84,8,49,17,133,CAR_TAM_2018-11-04
ARI,2018-10-28,9,Sun,8,8,,SFO,W 18-15,9,62,5,59,14,121,ARI_SFO_2018-10-28
BAL,2018-10-28,9,Sun,8,8,@,CAR,L 21-36,9,68,4,30,13,98,BAL_CAR_2018-10-28
MIN,2018-10-14,9,Sun,6,6,,ARI,W 27-17,9,52,5,30,14,82,MIN_ARI_2018-10-14
PIT,2018-10-14,9,Sun,6,6,@,CIN,W 28-21,9,69,6,30,15,99,PIT_CIN_2018-10-14
LAC,2018-10-07,9,Sun,5,5,,OAK,W 26-10,9,82,7,55,16,137,LAC_OAK_2018-10-07
SFO,2018-10-07,9,Sun,5,5,,ARI,L 18-28,9,65,5,46,14,111,SFO_ARI_2018-10-07
MIA,2018-10-07,9,Sun,5,5,@,CIN,L 17-27,9,85,6,47,15,132,MIA_CIN_2018-10-07
JAX,2018-09-30,9,Sun,4,4,,NYJ,W 31-12,9,89,6,43,15,132,JAX_NYJ_2018-09-30
TAM,2018-09-24,9,Mon,3,3,,PIT,L 27-30,9,80,13,155,22,235,TAM_PIT_2018-09-24
MIA,2018-09-23,9,Sun,3,3,,OAK,W 28-20,9,74,8,38,17,112,MIA_OAK_2018-09-23
ARI,2018-09-16,9,Sun,2,2,@,LAR,L 0-34,9,47,5,49,14,96,ARI_LAR_2018-09-16
SFO,2018-09-16,9,Sun,2,2,,DET,W 30-27,9,86,10,105,19,191,SFO_DET_2018-09-16
CIN,2018-09-13,9,Thu,2,2,,BAL,W 34-23,9,92,7,51,16,143,CIN_BAL_2018-09-13
ARI,2018-09-09,9,Sun,1,1,,WAS,L 6-24,9,67,9,63,18,130,ARI_WAS_2018-09-09
CAR,2018-09-09,9,Sun,1,1,,DAL,W 16-8,9,80,10,85,19,165,CAR_DAL_2018-09-09
WAS,2018-09-09,9,Sun,1,1,@,ARI,W 24-6,9,63,9,67,18,130,WAS_ARI_2018-09-09
BAL,2018-09-09,9,Sun,1,1,,BUF,W 47-3,9,78,10,100,19,178,BAL_BUF_2018-09-09
NYJ,2017-12-31,9,Sun,16,17,@,NWE,L 6-26,9,84,4,49,13,133,NYJ_NWE_2017-12-31
CLE,2017-12-31,9,Sun,16,17,@,PIT,L 24-28,9,77,3,15,12,92,CLE_PIT_2017-12-31
DET,2017-12-24,9,Sun,15,16,@,CIN,L 17-26,9,74,5,60,14,134,DET_CIN_2017-12-24
SEA,2017-12-17,9,Sun,14,15,,LAR,L 7-42,9,60,3,25,12,85,SEA_LAR_2017-12-17
LAC,2017-12-16,9,Sat,14,15,@,KAN,L 13-30,9,61,7,71,16,132,LAC_KAN_2017-12-16
NWE,2017-12-11,9,Mon,13,14,@,MIA,L 20-27,9,78,8,102,17,180,NWE_MIA_2017-12-11
NWE,2017-12-03,9,Sun,12,13,@,BUF,W 23-3,9,66,3,34,12,100,NWE_BUF_2017-12-03
DEN,2017-12-03,9,Sun,12,13,@,MIA,L 9-35,9,57,7,85,16,142,DEN_MIA_2017-12-03
LAR,2017-11-26,9,Sun,11,12,,NOR,W 26-20,9,90,7,112,16,202,LAR_NOR_2017-11-26
IND,2017-11-26,9,Sun,11,12,,TEN,L 16-20,9,67,2,15,11,82,IND_TEN_2017-11-26
CHI,2017-11-26,9,Sun,11,12,@,PHI,L 3-31,9,56,11,70,20,126,CHI_PHI_2017-11-26
DEN,2017-11-26,9,Sun,11,12,@,OAK,L 14-21,9,75,7,68,16,143,DEN_OAK_2017-11-26
MIN,2017-11-23,9,Thu,11,12,@,DET,W 30-23,9,74,8,54,17,128,MIN_DET_2017-11-23
SEA,2017-11-20,9,Mon,10,11,,ATL,L 31-34,9,106,7,69,16,175,SEA_ATL_2017-11-20
TAM,2017-11-19,9,Sun,10,11,@,MIA,W 30-20,9,82,17,123,26,205,TAM_MIA_2017-11-19
WAS,2017-11-19,9,Sun,10,11,@,NOR,L 31-34 (OT),9,67,7,54,16,121,WAS_NOR_2017-11-19
KAN,2017-11-19,9,Sun,10,11,@,NYG,L 9-12 (OT),9,87,5,48,14,135,KAN_NYG_2017-11-19
TEN,2017-11-16,9,Thu,10,11,@,PIT,L 17-40,9,65,7,61,16,126,TEN_PIT_2017-11-16
PIT,2017-11-12,9,Sun,9,10,@,IND,W 20-17,9,70,9,82,18,152,PIT_IND_2017-11-12
JAX,2017-11-12,9,Sun,9,10,,LAC,W 20-17 (OT),9,106,7,77,16,183,JAX_LAC_2017-11-12
IND,2017-11-12,9,Sun,10,10,,PIT,L 17-20,9,82,9,70,18,152,IND_PIT_2017-11-12
ARI,2017-11-09,9,Thu,9,10,,SEA,L 16-22,9,58,12,108,21,166,ARI_SEA_2017-11-09
PHI,2017-10-23,9,Mon,7,7,,WAS,W 34-24,9,55,5,55,14,110,PHI_WAS_2017-10-23
LAC,2017-10-22,9,Sun,7,7,,DEN,W 21-0,9,81,10,68,19,149,LAC_DEN_2017-10-22
MIA,2017-10-22,9,Sun,6,7,,NYJ,W 31-28,9,76,12,124,21,200,MIA_NYJ_2017-10-22
TAM,2017-10-15,9,Sun,5,6,@,ARI,L 33-38,9,49,7,61,16,110,TAM_ARI_2017-10-15
MIN,2017-10-09,9,Mon,5,5,@,CHI,W 20-17,9,69,8,55,17,124,MIN_CHI_2017-10-09
NYJ,2017-10-08,9,Sun,5,5,@,CLE,W 17-14,9,80,6,60,15,140,NYJ_CLE_2017-10-08
TAM,2017-10-05,9,Thu,4,5,,NWE,L 14-19,9,70,12,108,21,178,TAM_NWE_2017-10-05
BUF,2017-10-01,9,Sun,4,4,@,ATL,W 23-17,9,55,4,45,13,100,BUF_ATL_2017-10-01
LAC,2017-10-01,9,Sun,4,4,,PHI,L 24-26,9,39,9,58,18,97,LAC_PHI_2017-10-01
PHI,2017-10-01,9,Sun,4,4,@,LAC,W 26-24,9,58,9,39,18,97,PHI_LAC_2017-10-01
DAL,2017-09-25,9,Mon,3,3,@,ARI,W 28-17,9,76,6,50,15,126,DAL_ARI_2017-09-25
DET,2017-09-24,9,Sun,3,3,,ATL,L 26-30,9,98,8,68,17,166,DET_ATL_2017-09-24
PHI,2017-09-24,9,Sun,3,3,,NYG,W 27-24,9,103,10,137,19,240,PHI_NYG_2017-09-24
JAX,2017-09-24,9,Sun,3,3,,BAL,W 44-7,9,70,10,88,19,158,JAX_BAL_2017-09-24
NWE,2017-09-17,9,Sun,2,2,@,NOR,W 36-20,9,66,5,35,14,101,NWE_NOR_2017-09-17
OAK,2017-09-17,9,Sun,2,2,,NYJ,W 45-20,9,79,5,47,14,126,OAK_NYJ_2017-09-17
SEA,2017-09-17,9,Sun,2,2,,SFO,W 12-9,9,71,6,66,15,137,SEA_SFO_2017-09-17
HOU,2017-09-14,9,Thu,2,2,@,CIN,W 13-9,9,61,7,45,16,106,HOU_CIN_2017-09-14
HOU,2017-09-10,9,Sun,1,1,,JAX,L 7-29,9,94,10,89,19,183,HOU_JAX_2017-09-10
CIN,2017-09-10,9,Sun,1,1,,BAL,L 0-20,9,66,11,85,20,151,CIN_BAL_2017-09-10
MIN,2023-01-08,8,Sun,17,18,@,CHI,W 29-13,8,36,2,20,10,56,MIN_CHI_2023-01-08
NYG,2023-01-08,8,Sun,17,18,@,PHI,L 16-22,8,66,4,30,12,96,NYG_PHI_2023-01-08
ARI,2023-01-01,8,Sun,16,17,@,ATL,L 19-20,8,50,5,70,13,120,ARI_ATL_2023-01-01
TAM,2023-01-01,8,Sun,16,17,,CAR,W 30-24,8,51,8,58,16,109,TAM_CAR_2023-01-01
PHI,2023-01-01,8,Sun,16,17,,NOR,L 10-20,8,49,3,20,11,69,PHI_NOR_2023-01-01
CAR,2023-01-01,8,Sun,16,17,@,TAM,L 24-30,8,58,8,51,16,109,CAR_TAM_2023-01-01
MIA,2022-12-25,8,Sun,15,16,,GNB,L 20-26,8,62,5,40,13,102,MIA_GNB_2022-12-25
CIN,2022-12-24,8,Sat,15,16,@,NWE,W 22-18,8,62,10,82,18,144,CIN_NWE_2022-12-24
LAR,2022-12-19,8,Mon,14,15,@,GNB,L 12-24,8,76,4,80,12,156,LAR_GNB_2022-12-19
MIA,2022-12-17,8,Sat,14,15,@,BUF,L 29-32,8,51,7,51,15,102,MIA_BUF_2022-12-17
SEA,2022-12-15,8,Thu,14,15,,SFO,L 13-21,8,79,7,60,15,139,SEA_SFO_2022-12-15
NWE,2022-12-12,8,Mon,13,14,@,ARI,W 27-13,8,80,8,48,16,128,NWE_ARI_2022-12-12
ARI,2022-12-12,8,Mon,13,14,,NWE,L 13-27,8,48,8,80,16,128,ARI_NWE_2022-12-12
TAM,2022-12-11,8,Sun,13,14,@,SFO,L 7-35,8,62,2,15,10,77,TAM_SFO_2022-12-11
MIA,2022-12-04,8,Sun,12,13,@,SFO,L 17-33,8,68,4,45,12,113,MIA_SFO_2022-12-04
TEN,2022-11-27,8,Sun,11,12,,CIN,L 16-20,8,57,9,80,17,137,TEN_CIN_2022-11-27
PIT,2022-11-20,8,Sun,10,11,,CIN,L 30-37,8,70,6,44,14,114,PIT_CIN_2022-11-20
BUF,2022-11-20,8,Sun,10,11,,CLE,W 31-23,8,89,6,42,14,131,BUF_CLE_2022-11-20
NYG,2022-11-20,8,Sun,10,11,,DET,L 18-31,8,63,5,45,13,108,NYG_DET_2022-11-20
NWE,2022-11-20,8,Sun,10,11,,NYJ,W 10-3,8,55,3,15,11,70,NWE_NYJ_2022-11-20
IND,2022-11-20,8,Sun,11,11,,PHI,L 16-17,8,90,7,55,15,145,IND_PHI_2022-11-20
DEN,2022-11-13,8,Sun,9,10,@,TEN,L 10-17,8,50,9,60,17,110,DEN_TEN_2022-11-13
GNB,2022-11-06,8,Sun,9,9,@,DET,L 9-15,8,81,7,62,15,143,GNB_DET_2022-11-06
TEN,2022-11-06,8,Sun,8,9,@,KAN,L 17-20 (OT),8,51,10,69,18,120,TEN_KAN_2022-11-06
GNB,2022-10-30,8,Sun,8,8,@,BUF,L 17-27,8,58,4,35,12,93,GNB_BUF_2022-10-30
PHI,2022-10-30,8,Sun,7,8,,PIT,W 35-13,8,60,9,60,17,120,PHI_PIT_2022-10-30
KAN,2022-10-23,8,Sun,7,7,@,SFO,W 44-23,8,84,10,80,18,164,KAN_SFO_2022-10-23
NYG,2022-10-23,8,Sun,7,7,@,JAX,W 23-17,8,67,13,81,21,148,NYG_JAX_2022-10-23
DET,2022-10-23,8,Sun,6,7,@,DAL,L 6-24,8,59,7,55,15,114,DET_DAL_2022-10-23
NOR,2022-10-20,8,Thu,7,7,@,ARI,L 34-42,8,49,4,20,12,69,NOR_ARI_2022-10-20
TEN,2022-10-09,8,Sun,5,5,@,WAS,W 21-17,8,69,9,71,17,140,TEN_WAS_2022-10-09
IND,2022-10-06,8,Thu,5,5,@,DEN,W 12-9 (OT),8,64,7,49,15,113,IND_DEN_2022-10-06
DET,2022-10-02,8,Sun,4,4,,SEA,L 45-48,8,59,11,76,19,135,DET_SEA_2022-10-02
PIT,2022-10-02,8,Sun,4,4,,NYJ,L 20-24,8,55,7,64,15,119,PIT_NYJ_2022-10-02
NYG,2022-09-26,8,Mon,3,3,,DAL,L 16-23,8,57,8,70,16,127,NYG_DAL_2022-09-26
DAL,2022-09-26,8,Mon,3,3,@,NYG,W 23-16,8,70,8,57,16,127,DAL_NYG_2022-09-26
GNB,2022-09-25,8,Sun,3,3,@,TAM,W 14-12,8,65,6,40,14,105,GNB_TAM_2022-09-25
BUF,2022-09-19,8,Mon,2,2,,TEN,W 41-7,8,49,9,87,17,136,BUF_TEN_2022-09-19
PHI,2022-09-19,8,Mon,2,2,,MIN,W 24-7,8,60,5,25,13,85,PHI_MIN_2022-09-19
HOU,2022-09-18,8,Sun,2,2,@,DEN,L 9-16,8,94,13,100,21,194,HOU_DEN_2022-09-18
TAM,2022-09-18,8,Sun,2,2,@,NOR,W 20-10,8,101,9,60,17,161,TAM_NOR_2022-09-18
NYG,2022-09-18,8,Sun,2,2,,CAR,W 19-16,8,62,5,38,13,100,NYG_CAR_2022-09-18
NYJ,2022-09-18,8,Sun,2,2,@,CLE,W 31-30,8,57,5,38,13,95,NYJ_CLE_2022-09-18
MIA,2022-09-18,8,Sun,2,2,@,BAL,W 42-38,8,51,1,5,9,56,MIA_BAL_2022-09-18
NYG,2022-09-11,8,Sun,1,1,@,TEN,W 21-20,8,45,7,50,15,95,NYG_TEN_2022-09-11
PIT,2022-09-11,8,Sun,1,1,@,CIN,W 23-20 (OT),8,59,4,27,12,86,PIT_CIN_2022-09-11
ATL,2022-09-11,8,Sun,1,1,,NOR,L 26-27,8,55,8,99,16,154,ATL_NOR_2022-09-11
NOR,2022-09-11,8,Sun,1,1,@,ATL,W 27-26,8,99,8,55,16,154,NOR_ATL_2022-09-11
CAR,2022-09-11,8,Sun,1,1,,CLE,L 24-26,8,96,9,71,17,167,CAR_CLE_2022-09-11
NWE,2022-01-09,8,Sun,17,18,@,MIA,L 24-33,8,78,5,33,13,111,NWE_MIA_2022-01-09
CHI,2021-12-26,8,Sun,15,16,@,SEA,W 25-24,8,73,7,88,15,161,CHI_SEA_2021-12-26
SEA,2021-12-21,8,Tue,14,15,@,LAR,L 10-20,8,65,4,34,12,99,SEA_LAR_2021-12-21
GNB,2021-12-19,8,Sun,14,15,@,BAL,W 31-30,8,76,8,56,16,132,GNB_BAL_2021-12-19
BAL,2021-12-19,8,Sun,14,15,,GNB,L 30-31,8,56,8,76,16,132,BAL_GNB_2021-12-19
BUF,2021-12-19,8,Sun,14,15,,CAR,W 31-14,8,67,5,55,13,122,BUF_CAR_2021-12-19
NWE,2021-12-18,8,Sat,14,15,@,IND,L 17-27,8,50,2,13,10,63,NWE_IND_2021-12-18
KAN,2021-12-12,8,Sun,13,14,,LVR,W 48-9,8,63,9,85,17,148,KAN_LVR_2021-12-12
SEA,2021-12-12,8,Sun,13,14,@,HOU,W 33-13,8,69,6,52,14,121,SEA_HOU_2021-12-12
ARI,2021-12-05,8,Sun,12,13,@,CHI,W 33-22,8,63,6,45,14,108,ARI_CHI_2021-12-05
GNB,2021-11-21,8,Sun,11,11,@,MIN,L 31-34,8,92,3,25,11,117,GNB_MIN_2021-11-21
PIT,2021-11-21,8,Sun,10,11,@,LAC,L 37-41,8,38,12,75,20,113,PIT_LAC_2021-11-21
MIA,2021-11-21,8,Sun,11,11,@,NYJ,W 24-17,8,62,7,48,15,110,MIA_NYJ_2021-11-21
JAX,2021-11-21,8,Sun,10,11,,SFO,L 10-30,8,56,1,12,9,68,JAX_SFO_2021-11-21
WAS,2021-11-21,8,Sun,10,11,@,CAR,W 27-21,8,69,7,65,15,134,WAS_CAR_2021-11-21
TEN,2021-11-14,8,Sun,10,10,,NOR,W 23-21,8,49,9,65,17,114,TEN_NOR_2021-11-14
DET,2021-11-14,8,Sun,9,10,@,PIT,T 16-16 (OT),8,84,7,59,15,143,DET_PIT_2021-11-14
DAL,2021-11-14,8,Sun,9,10,,ATL,W 43-3,8,80,6,41,14,121,DAL_ATL_2021-11-14
JAX,2021-11-14,8,Sun,9,10,@,IND,L 17-23,8,79,7,47,15,126,JAX_IND_2021-11-14
MIN,2021-11-07,8,Sun,8,9,@,BAL,L 31-34 (OT),8,107,8,61,16,168,MIN_BAL_2021-11-07
BAL,2021-11-07,8,Sun,8,9,,MIN,W 34-31 (OT),8,61,8,107,16,168,BAL_MIN_2021-11-07
JAX,2021-11-07,8,Sun,8,9,,BUF,W 9-6,8,54,12,118,20,172,JAX_BUF_2021-11-07
HOU,2021-11-07,8,Sun,9,9,@,MIA,L 9-17,8,60,2,13,10,73,HOU_MIA_2021-11-07
DET,2021-10-31,8,Sun,8,8,,PHI,L 6-44,8,50,2,15,10,65,DET_PHI_2021-10-31
NYJ,2021-10-31,8,Sun,7,8,,CIN,W 34-31,8,46,5,51,13,97,NYJ_CIN_2021-10-31
CAR,2021-10-31,8,Sun,8,8,@,ATL,W 19-13,8,76,3,15,11,91,CAR_ATL_2021-10-31
PIT,2021-10-31,8,Sun,7,8,@,CLE,W 15-10,8,65,5,30,13,95,PIT_CLE_2021-10-31
NYG,2021-10-24,8,Sun,7,7,,CAR,W 25-3,8,60,7,37,15,97,NYG_CAR_2021-10-24
HOU,2021-10-24,8,Sun,7,7,@,ARI,L 5-31,8,80,7,54,15,134,HOU_ARI_2021-10-24
DET,2021-10-24,8,Sun,7,7,@,LAR,L 19-28,8,77,4,35,12,112,DET_LAR_2021-10-24
BUF,2021-10-18,8,Mon,6,6,@,TEN,L 31-34,8,60,7,91,15,151,BUF_TEN_2021-10-18
JAX,2021-10-17,8,Sun,6,6,,MIA,W 23-20,8,54,7,55,15,109,JAX_MIA_2021-10-17
BAL,2021-10-11,8,Mon,5,5,,IND,W 31-25 (OT),8,74,5,45,13,119,BAL_IND_2021-10-11
CHI,2021-10-10,8,Sun,5,5,@,LVR,W 20-9,8,70,10,82,18,152,CHI_LVR_2021-10-10
PIT,2021-10-10,8,Sun,5,5,,DEN,W 27-19,8,59,7,67,15,126,PIT_DEN_2021-10-10
HOU,2021-10-10,8,Sun,5,5,,NWE,L 22-25,8,70,5,27,13,97,HOU_NWE_2021-10-10
DAL,2021-10-10,8,Sun,5,5,,NYG,W 44-20,8,58,5,48,13,106,DAL_NYG_2021-10-10
SFO,2021-10-03,8,Sun,4,4,,SEA,L 21-28,8,78,5,27,13,105,SFO_SEA_2021-10-03
TEN,2021-10-03,8,Sun,4,4,@,NYJ,L 24-27 (OT),8,98,6,65,14,163,TEN_NYJ_2021-10-03
NWE,2021-10-03,8,Sun,4,4,,TAM,L 17-19,8,77,7,74,15,151,NWE_TAM_2021-10-03
IND,2021-10-03,8,Sun,4,4,@,MIA,W 27-17,8,86,5,32,13,118,IND_MIA_2021-10-03
MIA,2021-09-26,8,Sun,3,3,@,LVR,L 28-31 (OT),8,68,8,104,16,172,MIA_LVR_2021-09-26
LVR,2021-09-26,8,Sun,3,3,,MIA,W 31-28 (OT),8,104,8,68,16,172,LVR_MIA_2021-09-26
NYG,2021-09-26,8,Sun,3,3,,ATL,L 14-17,8,53,4,28,12,81,NYG_ATL_2021-09-26
LAC,2021-09-26,8,Sun,3,3,@,KAN,W 30-24,8,50,6,56,14,106,LAC_KAN_2021-09-26
CAR,2021-09-23,8,Thu,3,3,@,HOU,W 24-9,8,64,7,51,15,115,CAR_HOU_2021-09-23
NYJ,2021-09-19,8,Sun,2,2,,NWE,L 6-25,8,77,6,54,14,131,NYJ_NWE_2021-09-19
BAL,2021-09-19,8,Sun,2,2,,KAN,W 36-35,8,55,5,46,13,101,BAL_KAN_2021-09-19
DAL,2021-09-19,8,Sun,2,2,@,LAC,W 20-17,8,76,12,99,20,175,DAL_LAC_2021-09-19
PHI,2021-09-19,8,Sun,2,2,,SFO,L 11-17,8,57,5,60,13,117,PHI_SFO_2021-09-19
CHI,2021-09-19,8,Sun,2,2,,CIN,W 20-17,8,70,4,57,12,127,CHI_CIN_2021-09-19
WAS,2021-09-12,8,Sun,1,1,,LAC,L 16-20,8,57,6,94,14,151,WAS_LAC_2021-09-12
NWE,2021-09-12,8,Sun,1,1,,MIA,L 16-17,8,84,5,28,13,112,NWE_MIA_2021-09-12
ARI,2021-09-12,8,Sun,1,1,@,TEN,W 38-13,8,59,7,57,15,116,ARI_TEN_2021-09-12
BUF,2021-09-12,8,Sun,1,1,,PIT,L 16-23,8,81,5,32,13,113,BUF_PIT_2021-09-12
DAL,2021-09-09,8,Thu,1,1,@,TAM,L 29-31,8,55,11,106,19,161,DAL_TAM_2021-09-09
TAM,2020-12-26,8,Sat,15,16,@,DET,W 47-7,8,65,11,117,19,182,TAM_DET_2020-12-26
BUF,2020-12-19,8,Sat,14,15,@,DEN,W 48-19,8,75,7,33,15,108,BUF_DEN_2020-12-19
BAL,2020-12-14,8,Mon,13,14,@,CLE,W 47-42,8,69,8,75,16,144,BAL_CLE_2020-12-14
CLE,2020-12-14,8,Mon,13,14,,BAL,L 42-47,8,75,8,69,16,144,CLE_BAL_2020-12-14
NOR,2020-12-13,8,Sun,13,14,@,PHI,L 21-24,8,52,6,27,14,79,NOR_PHI_2020-12-13
KAN,2020-12-13,8,Sun,13,14,@,MIA,W 33-27,8,56,3,35,11,91,KAN_MIA_2020-12-13
MIA,2020-12-06,8,Sun,12,13,,CIN,W 19-7,8,54,6,62,14,116,MIA_CIN_2020-12-06
SEA,2020-11-30,8,Mon,11,12,@,PHI,W 23-17,8,83,9,79,17,162,SEA_PHI_2020-11-30
MIN,2020-11-29,8,Sun,11,12,,CAR,W 28-27,8,52,7,58,15,110,MIN_CAR_2020-11-29
TAM,2020-11-29,8,Sun,12,12,,KAN,L 24-27,8,57,10,82,18,139,TAM_KAN_2020-11-29
JAX,2020-11-22,8,Sun,10,11,,PIT,L 3-27,8,105,6,42,14,147,JAX_PIT_2020-11-22
MIN,2020-11-22,8,Sun,10,11,,DAL,L 28-31,8,80,4,30,12,110,MIN_DAL_2020-11-22
LVR,2020-11-22,8,Sun,10,11,,KAN,L 31-35,8,72,10,89,18,161,LVR_KAN_2020-11-22
NYJ,2020-11-22,8,Sun,10,11,@,LAC,L 28-34,8,88,9,78,17,166,NYJ_LAC_2020-11-22
DEN,2020-11-22,8,Sun,10,11,,MIA,W 20-13,8,70,5,50,13,120,DEN_MIA_2020-11-22
IND,2020-11-22,8,Sun,10,11,,GNB,W 34-31 (OT),8,116,7,45,15,161,IND_GNB_2020-11-22
SEA,2020-11-19,8,Thu,10,11,,ARI,W 28-21,8,79,10,115,18,194,SEA_ARI_2020-11-19
BAL,2020-11-15,8,Sun,9,10,@,NWE,L 17-23,8,64,3,18,11,82,BAL_NWE_2020-11-15
LVR,2020-11-15,8,Sun,9,10,,DEN,W 37-12,8,82,7,37,15,119,LVR_DEN_2020-11-15
KAN,2020-11-08,8,Sun,9,9,,CAR,W 33-31,8,75,12,82,20,157,KAN_CAR_2020-11-08
DEN,2020-11-01,8,Sun,7,8,,LAC,W 31-30,8,70,6,67,14,137,DEN_LAC_2020-11-01
ATL,2020-10-25,8,Sun,7,7,,DET,L 22-23,8,53,5,50,13,103,ATL_DET_2020-10-25
SEA,2020-10-25,8,Sun,6,7,@,ARI,L 34-37 (OT),8,78,6,40,14,118,SEA_ARI_2020-10-25
PIT,2020-10-25,8,Sun,6,7,@,TEN,W 27-24,8,69,7,73,15,142,PIT_TEN_2020-10-25
KAN,2020-10-19,8,Mon,6,6,@,BUF,W 26-17,8,68,4,39,12,107,KAN_BUF_2020-10-19
WAS,2020-10-18,8,Sun,6,6,@,NYG,L 19-20,8,50,4,30,12,80,WAS_NYG_2020-10-18
CAR,2020-10-18,8,Sun,6,6,,CHI,L 16-23,8,69,10,92,18,161,CAR_CHI_2020-10-18
NYG,2020-10-11,8,Sun,5,5,@,DAL,L 34-37,8,81,3,25,11,106,NYG_DAL_2020-10-11
LVR,2020-10-11,8,Sun,5,5,@,KAN,W 40-32,8,59,10,94,18,153,LVR_KAN_2020-10-11
PIT,2020-10-11,8,Sun,4,5,,PHI,W 38-29,8,86,9,84,17,170,PIT_PHI_2020-10-11
CHI,2020-10-04,8,Sun,4,4,,IND,L 11-19,8,103,8,76,16,179,CHI_IND_2020-10-04
TAM,2020-10-04,8,Sun,4,4,,LAC,W 38-31,8,90,7,60,15,150,TAM_LAC_2020-10-04
IND,2020-10-04,8,Sun,4,4,@,CHI,W 19-11,8,76,8,103,16,179,IND_CHI_2020-10-04
DEN,2020-10-01,8,Thu,4,4,@,NYJ,W 37-28,8,94,11,118,19,212,DEN_NYJ_2020-10-01
LAC,2020-09-27,8,Sun,3,3,,CAR,L 16-21,8,60,3,30,11,90,LAC_CAR_2020-09-27
NOR,2020-09-27,8,Sun,3,3,,GNB,L 30-37,8,83,2,10,10,93,NOR_GNB_2020-09-27
JAX,2020-09-24,8,Thu,3,3,,MIA,L 13-31,8,63,6,51,14,114,JAX_MIA_2020-09-24
ATL,2020-09-20,8,Sun,2,2,@,DAL,L 39-40,8,51,7,75,15,126,ATL_DAL_2020-09-20
GNB,2020-09-20,8,Sun,2,2,,DET,W 42-21,8,60,7,70,15,130,GNB_DET_2020-09-20
JAX,2020-09-20,8,Sun,2,2,@,TEN,L 30-33,8,60,4,30,12,90,JAX_TEN_2020-09-20
CLE,2020-09-17,8,Thu,2,2,,CIN,W 35-30,8,76,4,45,12,121,CLE_CIN_2020-09-17
CLE,2020-09-13,8,Sun,1,1,@,BAL,L 6-38,8,80,7,66,15,146,CLE_BAL_2020-09-13
DET,2020-09-13,8,Sun,1,1,,CHI,L 23-27,8,77,6,48,14,125,DET_CHI_2020-09-13
ARI,2019-12-29,8,Sun,16,17,@,LAR,L 24-31,8,63,10,91,18,154,ARI_LAR_2019-12-29
SFO,2019-12-29,8,Sun,16,17,@,SEA,W 26-21,8,57,5,29,13,86,SFO_SEA_2019-12-29
LAC,2019-12-29,8,Sun,16,17,@,KAN,L 21-31,8,40,5,39,13,79,LAC_KAN_2019-12-29
BUF,2019-12-15,8,Sun,14,15,@,PIT,W 17-10,8,70,6,30,14,100,BUF_PIT_2019-12-15
JAX,2019-12-15,8,Sun,14,15,@,OAK,W 20-16,8,87,6,51,14,138,JAX_OAK_2019-12-15
NYJ,2019-12-12,8,Thu,14,15,@,BAL,L 21-42,8,94,6,35,14,129,NYJ_BAL_2019-12-12
SEA,2019-12-08,8,Sun,13,14,@,LAR,L 12-28,8,64,3,20,11,84,SEA_LAR_2019-12-08
CIN,2019-12-08,8,Sun,13,14,@,CLE,L 19-27,8,99,6,30,14,129,CIN_CLE_2019-12-08
MIN,2019-12-08,8,Sun,13,14,,DET,W 20-7,8,55,4,28,12,83,MIN_DET_2019-12-08
HOU,2019-12-01,8,Sun,12,13,,NWE,W 28-22,8,79,8,60,16,139,HOU_NWE_2019-12-01
NWE,2019-12-01,8,Sun,12,13,@,HOU,L 22-28,8,60,8,79,16,139,NWE_HOU_2019-12-01
TAM,2019-12-01,8,Sun,12,13,@,JAX,W 28-11,8,44,16,121,24,165,TAM_JAX_2019-12-01
LAR,2019-12-01,8,Sun,12,13,@,ARI,W 34-7,8,81,2,7,10,88,LAR_ARI_2019-12-01
BAL,2019-11-25,8,Mon,11,12,@,LAR,W 45-6,8,66,8,56,16,122,BAL_LAR_2019-11-25
LAR,2019-11-25,8,Mon,11,12,,BAL,L 6-45,8,56,8,66,16,122,LAR_BAL_2019-11-25
TAM,2019-11-24,8,Sun,11,12,@,ATL,W 35-22,8,51,7,60,15,111,TAM_ATL_2019-11-24
MIA,2019-11-24,8,Sun,11,12,@,CLE,L 24-41,8,94,7,70,15,164,MIA_CLE_2019-11-24
WAS,2019-11-24,8,Sun,11,12,,DET,W 19-16,8,63,6,65,14,128,WAS_DET_2019-11-24
KAN,2019-11-18,8,Mon,11,11,@,LAC,W 24-17,8,102,9,60,17,162,KAN_LAC_2019-11-18
CAR,2019-11-17,8,Sun,10,11,,ATL,L 3-29,8,68,3,20,11,88,CAR_ATL_2019-11-17
BAL,2019-11-17,8,Sun,10,11,,HOU,W 41-7,8,65,5,60,13,125,BAL_HOU_2019-11-17
JAX,2019-11-17,8,Sun,10,11,@,IND,L 13-33,8,81,3,20,11,101,JAX_IND_2019-11-17
CLE,2019-11-14,8,Thu,10,11,,PIT,W 21-7,8,121,6,41,14,162,CLE_PIT_2019-11-14
TEN,2019-11-10,8,Sun,10,10,,KAN,W 35-32,8,64,9,80,17,144,TEN_KAN_2019-11-10
DET,2019-11-10,8,Sun,9,10,@,CHI,L 13-20,8,76,7,57,15,133,DET_CHI_2019-11-10
LAC,2019-11-07,8,Thu,10,10,@,OAK,L 24-26,8,70,12,97,20,167,LAC_OAK_2019-11-07
NYG,2019-11-04,8,Mon,9,9,,DAL,L 18-37,8,71,10,104,18,175,NYG_DAL_2019-11-04
GNB,2019-11-03,8,Sun,9,9,@,LAC,L 11-26,8,45,5,45,13,90,GNB_LAC_2019-11-03
PHI,2019-11-03,8,Sun,9,9,,CHI,W 22-14,8,75,9,70,17,145,PHI_CHI_2019-11-03
SFO,2019-10-31,8,Thu,8,9,@,ARI,W 28-25,8,75,9,65,17,140,SFO_ARI_2019-10-31
BUF,2019-10-27,8,Sun,7,8,,PHI,L 13-31,8,57,4,44,12,101,BUF_PHI_2019-10-27
LAC,2019-10-27,8,Sun,8,8,@,CHI,W 17-16,8,53,5,42,13,95,LAC_CHI_2019-10-27
NYJ,2019-10-21,8,Mon,6,7,,NWE,L 0-33,8,60,7,92,15,152,NYJ_NWE_2019-10-21
BAL,2019-10-20,8,Sun,7,7,@,SEA,W 30-16,8,75,2,18,10,93,BAL_SEA_2019-10-20
DET,2019-10-20,8,Sun,6,7,,MIN,L 30-42,8,67,6,60,14,127,DET_MIN_2019-10-20
OAK,2019-10-20,8,Sun,6,7,@,GNB,L 24-42,8,97,3,20,11,117,OAK_GNB_2019-10-20
DET,2019-10-14,8,Mon,5,6,@,GNB,L 22-23,8,50,6,48,14,98,DET_GNB_2019-10-14
LAR,2019-10-13,8,Sun,6,6,,SFO,L 7-20,8,59,4,30,12,89,LAR_SFO_2019-10-13
ATL,2019-10-13,8,Sun,6,6,@,ARI,L 33-34,8,72,8,57,16,129,ATL_ARI_2019-10-13
DEN,2019-10-13,8,Sun,6,6,,TEN,W 16-0,8,51,6,40,14,91,DEN_TEN_2019-10-13
LAC,2019-10-13,8,Sun,6,6,,PIT,L 17-24,8,74,6,45,14,119,LAC_PIT_2019-10-13
ARI,2019-10-13,8,Sun,6,6,,ATL,W 34-33,8,57,8,72,16,129,ARI_ATL_2019-10-13
NYJ,2019-10-13,8,Sun,5,6,,DAL,W 24-22,8,105,9,68,17,173,NYJ_DAL_2019-10-13
CAR,2019-10-06,8,Sun,5,5,,JAX,W 34-27,8,70,9,84,17,154,CAR_JAX_2019-10-06
TEN,2019-10-06,8,Sun,5,5,,BUF,L 7-14,8,60,11,78,19,138,TEN_BUF_2019-10-06
CIN,2019-09-30,8,Mon,4,4,@,PIT,L 3-27,8,60,4,37,12,97,CIN_PIT_2019-09-30
BUF,2019-09-29,8,Sun,4,4,,NWE,L 10-16,8,76,8,58,16,134,BUF_NWE_2019-09-29
DET,2019-09-29,8,Sun,4,4,,KAN,L 30-34,8,48,7,51,15,99,DET_KAN_2019-09-29
NWE,2019-09-29,8,Sun,4,4,@,BUF,W 16-10,8,58,8,76,16,134,NWE_BUF_2019-09-29
NWE,2019-09-22,8,Sun,3,3,,NYJ,W 30-14,8,70,5,67,13,137,NWE_NYJ_2019-09-22
CIN,2019-09-22,8,Sun,3,3,@,BUF,L 17-21,8,54,7,55,15,109,CIN_BUF_2019-09-22
DAL,2019-09-22,8,Sun,3,3,,MIA,W 31-6,8,100,5,35,13,135,DAL_MIA_2019-09-22
CLE,2019-09-22,8,Sun,3,3,,LAR,L 13-20,8,60,7,49,15,109,CLE_LAR_2019-09-22
LAR,2019-09-15,8,Sun,2,2,,NOR,W 27-9,8,65,11,87,19,152,LAR_NOR_2019-09-15
DAL,2019-09-15,8,Sun,2,2,@,WAS,W 31-21,8,67,6,44,14,111,DAL_WAS_2019-09-15
ARI,2019-09-15,8,Sun,2,2,@,BAL,L 17-23,8,70,10,62,18,132,ARI_BAL_2019-09-15
DET,2019-09-15,8,Sun,2,2,,LAC,W 13-10,8,71,9,70,17,141,DET_LAC_2019-09-15
MIN,2019-09-15,8,Sun,2,2,@,GNB,L 16-21,8,100,6,35,14,135,MIN_GNB_2019-09-15
IND,2019-09-15,8,Sun,2,2,@,TEN,W 19-17,8,65,5,75,13,140,IND_TEN_2019-09-15
HOU,2019-09-09,8,Mon,1,1,@,NOR,L 28-30,8,69,7,48,15,117,HOU_NOR_2019-09-09
NYG,2019-09-08,8,Sun,1,1,@,DAL,L 17-35,8,70,6,47,14,117,NYG_DAL_2019-09-08
NYJ,2019-09-08,8,Sun,1,1,,BUF,L 16-17,8,67,7,55,15,122,NYJ_BUF_2019-09-08
TAM,2019-09-08,8,Sun,1,1,,SFO,L 17-31,8,87,11,87,19,174,TAM_SFO_2019-09-08
SEA,2019-09-08,8,Sun,1,1,,CIN,W 21-20,8,55,7,57,15,112,SEA_CIN_2019-09-08
JAX,2018-12-30,8,Sun,16,17,@,HOU,L 3-20,8,68,2,15,10,83,JAX_HOU_2018-12-30
KAN,2018-12-23,8,Sun,15,16,@,SEA,L 31-38,8,76,3,20,11,96,KAN_SEA_2018-12-23
LAC,2018-12-22,8,Sat,15,16,,BAL,L 10-22,8,69,4,40,12,109,LAC_BAL_2018-12-22
WAS,2018-12-22,8,Sat,15,16,@,TEN,L 16-25,8,49,2,10,10,59,WAS_TEN_2018-12-22
JAX,2018-12-16,8,Sun,14,15,,WAS,L 13-16,8,55,6,48,14,103,JAX_WAS_2018-12-16
MIA,2018-12-16,8,Sun,14,15,@,MIN,L 17-41,8,49,6,45,14,94,MIA_MIN_2018-12-16
BAL,2018-12-16,8,Sun,14,15,,TAM,W 20-12,8,70,6,58,14,128,BAL_TAM_2018-12-16
OAK,2018-12-16,8,Sun,14,15,@,CIN,L 16-30,8,90,9,85,17,175,OAK_CIN_2018-12-16
SFO,2018-12-16,8,Sun,14,15,,SEA,W 26-23 (OT),8,66,14,148,22,214,SFO_SEA_2018-12-16
ARI,2018-12-16,8,Sun,14,15,@,ATL,L 14-40,8,75,6,50,14,125,ARI_ATL_2018-12-16
DEN,2018-12-15,8,Sat,14,15,,CLE,L 16-17,8,51,6,75,14,126,DEN_CLE_2018-12-15
ARI,2018-12-09,8,Sun,13,14,,DET,L 3-17,8,83,7,68,15,151,ARI_DET_2018-12-09
CHI,2018-12-02,8,Sun,12,13,@,NYG,L 27-30 (OT),8,58,12,107,20,165,CHI_NYG_2018-12-02
ATL,2018-12-02,8,Sun,12,13,,BAL,L 16-26,8,82,9,88,17,170,ATL_BAL_2018-12-02
JAX,2018-12-02,8,Sun,12,13,,IND,W 6-0,8,74,6,65,14,139,JAX_IND_2018-12-02
TEN,2018-12-02,8,Sun,12,13,,NYJ,W 26-22,8,75,11,96,19,171,TEN_NYJ_2018-12-02
MIA,2018-12-02,8,Sun,12,13,,BUF,W 21-17,8,89,13,120,21,209,MIA_BUF_2018-12-02
DET,2018-12-02,8,Sun,12,13,,LAR,L 16-30,8,54,7,105,15,159,DET_LAR_2018-12-02
OAK,2018-12-02,8,Sun,12,13,,KAN,L 33-40,8,74,11,94,19,168,OAK_KAN_2018-12-02
DAL,2018-11-29,8,Thu,12,13,,NOR,W 13-10,8,80,5,48,13,128,DAL_NOR_2018-11-29
SFO,2018-11-25,8,Sun,11,12,@,TAM,L 9-27,8,68,9,70,17,138,SFO_TAM_2018-11-25
NYJ,2018-11-25,8,Sun,11,12,,NWE,L 13-27,8,47,11,105,19,152,NYJ_NWE_2018-11-25
LAR,2018-11-19,8,Mon,11,11,,KAN,W 54-51,8,60,13,135,21,195,LAR_KAN_2018-11-19
TEN,2018-11-18,8,Sun,10,11,@,IND,L 10-38,8,112,7,60,15,172,TEN_IND_2018-11-18
NOR,2018-11-18,8,Sun,10,11,,PHI,W 48-7,8,69,6,49,14,118,NOR_PHI_2018-11-18
NYG,2018-11-18,8,Sun,10,11,,TAM,W 38-35,8,60,4,40,12,100,NYG_TAM_2018-11-18
NYG,2018-11-12,8,Mon,9,10,@,SFO,W 27-23,8,78,10,97,18,175,NYG_SFO_2018-11-12
JAX,2018-11-11,8,Sun,9,10,@,IND,L 26-29,8,61,7,45,15,106,JAX_IND_2018-11-11
WAS,2018-11-11,8,Sun,9,10,@,TAM,W 16-3,8,52,5,50,13,102,WAS_TAM_2018-11-11
KAN,2018-11-11,8,Sun,10,10,,ARI,W 26-14,8,63,3,30,11,93,KAN_ARI_2018-11-11
PIT,2018-11-04,8,Sun,8,9,@,BAL,W 23-16,8,103,5,25,13,128,PIT_BAL_2018-11-04
DET,2018-11-04,8,Sun,8,9,@,MIN,L 9-24,8,66,3,15,11,81,DET_MIN_2018-11-04
TAM,2018-11-04,8,Sun,8,9,@,CAR,L 28-42,8,49,9,84,17,133,TAM_CAR_2018-11-04
DEN,2018-11-04,8,Sun,9,9,,HOU,L 17-19,8,50,7,60,15,110,DEN_HOU_2018-11-04
WAS,2018-10-28,8,Sun,7,8,@,NYG,W 20-13,8,90,11,102,19,192,WAS_NYG_2018-10-28
NYJ,2018-10-28,8,Sun,8,8,@,CHI,L 10-24,8,45,2,25,10,70,NYJ_CHI_2018-10-28
PIT,2018-10-28,8,Sun,7,8,,CLE,W 33-18,8,60,7,52,15,112,PIT_CLE_2018-10-28
HOU,2018-10-25,8,Thu,8,8,,MIA,W 42-23,8,57,5,63,13,120,HOU_MIA_2018-10-25
DAL,2018-10-21,8,Sun,7,7,@,WAS,L 17-20,8,65,5,35,13,100,DAL_WAS_2018-10-21
NYJ,2018-10-21,8,Sun,7,7,,MIN,L 17-37,8,71,6,55,14,126,NYJ_MIN_2018-10-21
KAN,2018-10-21,8,Sun,7,7,,CIN,W 45-10,8,49,8,58,16,107,KAN_CIN_2018-10-21
TAM,2018-10-21,8,Sun,6,7,,CLE,W 26-23 (OT),8,65,14,114,22,179,TAM_CLE_2018-10-21
CIN,2018-10-21,8,Sun,7,7,@,KAN,L 10-45,8,58,8,49,16,107,CIN_KAN_2018-10-21
CAR,2018-10-14,8,Sun,5,6,@,WAS,L 17-23,8,55,5,43,13,98,CAR_WAS_2018-10-14
SEA,2018-10-14,8,Sun,6,6,@,OAK,W 27-3,8,64,5,38,13,102,SEA_OAK_2018-10-14
IND,2018-10-14,8,Sun,6,6,@,NYJ,L 34-42,8,66,7,49,15,115,IND_NYJ_2018-10-14
PHI,2018-10-07,8,Sun,5,5,,MIN,L 21-23,8,52,4,23,12,75,PHI_MIN_2018-10-07
DET,2018-10-07,8,Sun,5,5,,GNB,W 31-23,8,71,12,112,20,183,DET_GNB_2018-10-07
NYG,2018-10-07,8,Sun,5,5,@,CAR,L 31-33,8,62,4,22,12,84,NYG_CAR_2018-10-07
CLE,2018-09-30,8,Sun,4,4,@,OAK,L 42-45 (OT),8,55,6,65,14,120,CLE_OAK_2018-09-30
SEA,2018-09-30,8,Sun,4,4,@,ARI,W 20-17,8,57,5,38,13,95,SEA_ARI_2018-09-30
PHI,2018-09-30,8,Sun,4,4,@,TEN,L 23-26 (OT),8,77,4,30,12,107,PHI_TEN_2018-09-30
DET,2018-09-30,8,Sun,4,4,@,DAL,L 24-26,8,58,2,20,10,78,DET_DAL_2018-09-30
OAK,2018-09-23,8,Sun,3,3,@,MIA,L 20-28,8,38,9,74,17,112,OAK_MIA_2018-09-23
JAX,2018-09-23,8,Sun,3,3,,TEN,L 6-9,8,75,4,30,12,105,JAX_TEN_2018-09-23
MIN,2018-09-16,8,Sun,2,2,@,GNB,T 29-29 (OT),8,70,7,54,15,124,MIN_GNB_2018-09-16
TEN,2018-09-16,8,Sun,2,2,,HOU,W 20-17,8,70,11,88,19,158,TEN_HOU_2018-09-16
LAR,2018-09-10,8,Mon,1,1,@,OAK,W 33-13,8,70,11,155,19,225,LAR_OAK_2018-09-10
CIN,2018-09-09,8,Sun,1,1,@,IND,W 34-23,8,94,7,91,15,185,CIN_IND_2018-09-09
NOR,2018-09-09,8,Sun,1,1,,TAM,L 40-48,8,77,7,70,15,147,NOR_TAM_2018-09-09
GNB,2018-09-09,8,Sun,1,1,,CHI,W 24-23,8,72,5,35,13,107,GNB_CHI_2018-09-09
GNB,2017-12-31,8,Sun,16,17,@,DET,L 11-35,8,68,5,62,13,130,GNB_DET_2017-12-31
SEA,2017-12-31,8,Sun,16,17,,ARI,L 24-26,8,100,4,25,12,125,SEA_ARI_2017-12-31
PHI,2017-12-25,8,Mon,15,16,,OAK,W 19-10,8,60,7,50,15,110,PHI_OAK_2017-12-25
SFO,2017-12-24,8,Sun,15,16,,JAX,W 44-33,8,68,12,99,20,167,SFO_JAX_2017-12-24
LAC,2017-12-24,8,Sun,15,16,@,NYJ,W 14-7,8,80,5,34,13,114,LAC_NYJ_2017-12-24
CLE,2017-12-24,8,Sun,15,16,@,CHI,L 3-20,8,60,4,25,12,85,CLE_CHI_2017-12-24
NYJ,2017-12-17,8,Sun,14,15,@,NOR,L 19-31,8,50,8,92,16,142,NYJ_NOR_2017-12-17
JAX,2017-12-17,8,Sun,14,15,,HOU,W 45-7,8,54,14,127,22,181,JAX_HOU_2017-12-17
ARI,2017-12-17,8,Sun,14,15,@,WAS,L 15-20,8,71,7,82,15,153,ARI_WAS_2017-12-17
NOR,2017-12-17,8,Sun,14,15,,NYJ,W 31-19,8,92,8,50,16,142,NOR_NYJ_2017-12-17
DET,2017-12-16,8,Sat,14,15,,CHI,W 20-10,8,58,13,97,21,155,DET_CHI_2017-12-16
MIA,2017-12-11,8,Mon,13,14,,NWE,W 27-20,8,102,9,78,17,180,MIA_NWE_2017-12-11
DAL,2017-12-10,8,Sun,13,14,@,NYG,W 30-10,8,51,7,69,15,120,DAL_NYG_2017-12-10
DET,2017-12-10,8,Sun,13,14,@,TAM,W 24-21,8,105,7,65,15,170,DET_TAM_2017-12-10
HOU,2017-12-10,8,Sun,13,14,,SFO,L 16-26,8,81,11,87,19,168,HOU_SFO_2017-12-10
KAN,2017-12-03,8,Sun,12,13,@,NYJ,L 31-38,8,30,5,40,13,70,KAN_NYJ_2017-12-03
TAM,2017-12-03,8,Sun,12,13,@,GNB,L 20-26 (OT),8,74,7,47,15,121,TAM_GNB_2017-12-03
SFO,2017-12-03,8,Sun,12,13,@,CHI,W 15-14,8,53,4,29,12,82,SFO_CHI_2017-12-03
WAS,2017-11-23,8,Thu,11,12,,NYG,W 20-10,8,55,6,79,14,134,WAS_NYG_2017-11-23
DET,2017-11-23,8,Thu,11,12,,MIN,L 23-30,8,54,9,74,17,128,DET_MIN_2017-11-23
OAK,2017-11-19,8,Sun,10,11,,NWE,L 8-33,8,66,2,10,10,76,OAK_NWE_2017-11-19
LAR,2017-11-19,8,Sun,10,11,@,MIN,L 7-24,8,60,7,65,15,125,LAR_MIN_2017-11-19
HOU,2017-11-12,8,Sun,9,10,@,LAR,L 7-33,8,60,10,86,18,146,HOU_LAR_2017-11-12
BUF,2017-11-12,8,Sun,9,10,,NOR,L 10-47,8,56,4,41,12,97,BUF_NOR_2017-11-12
NYJ,2017-11-12,8,Sun,10,10,@,TAM,L 10-15,8,77,6,50,14,127,NYJ_TAM_2017-11-12
CHI,2017-11-12,8,Sun,9,10,,GNB,L 16-23,8,78,5,35,13,113,CHI_GNB_2017-11-12
ATL,2017-11-05,8,Sun,8,9,@,CAR,L 17-20,8,70,5,29,13,99,ATL_CAR_2017-11-05
CIN,2017-11-05,8,Sun,8,9,@,JAX,L 7-23,8,77,5,50,13,127,CIN_JAX_2017-11-05
KAN,2017-11-05,8,Sun,9,9,@,DAL,L 17-28,8,52,5,65,13,117,KAN_DAL_2017-11-05
SFO,2017-11-05,8,Sun,9,9,,ARI,L 10-20,8,53,2,25,10,78,SFO_ARI_2017-11-05
HOU,2017-10-29,8,Sun,7,8,@,SEA,L 38-41,8,93,10,120,18,213,HOU_SEA_2017-10-29
DAL,2017-10-29,8,Sun,7,8,@,WAS,W 33-19,8,89,5,32,13,121,DAL_WAS_2017-10-29
GNB,2017-10-22,8,Sun,7,7,,NOR,L 17-26,8,54,7,80,15,134,GNB_NOR_2017-10-22
NWE,2017-10-22,8,Sun,7,7,,ATL,W 23-7,8,65,6,40,14,105,NWE_ATL_2017-10-22
KAN,2017-10-19,8,Thu,7,7,@,OAK,L 30-31,8,108,10,97,18,205,KAN_OAK_2017-10-19
GNB,2017-10-15,8,Sun,6,6,@,MIN,L 10-23,8,92,7,65,15,157,GNB_MIN_2017-10-15
BAL,2017-10-15,8,Sun,6,6,,CHI,L 24-27 (OT),8,69,5,44,13,113,BAL_CHI_2017-10-15
CHI,2017-10-09,8,Mon,5,5,,MIN,L 17-20,8,55,9,69,17,124,CHI_MIN_2017-10-09
CIN,2017-10-01,8,Sun,4,4,@,CLE,W 31-7,8,66,4,28,12,94,CIN_CLE_2017-10-01
PIT,2017-10-01,8,Sun,4,4,@,BAL,W 26-9,8,60,6,55,14,115,PIT_BAL_2017-10-01
NOR,2017-10-01,8,Sun,4,4,@,MIA,W 20-0,8,71,11,90,19,161,NOR_MIA_2017-10-01
CHI,2017-09-28,8,Thu,4,4,@,GNB,L 14-35,8,62,7,55,15,117,CHI_GNB_2017-09-28
LAC,2017-09-24,8,Sun,3,3,,KAN,L 10-24,8,61,13,122,21,183,LAC_KAN_2017-09-24
ATL,2017-09-24,8,Sun,3,3,@,DET,W 30-26,8,68,9,98,17,166,ATL_DET_2017-09-24
MIA,2017-09-24,8,Sun,2,3,@,NYJ,L 6-20,8,51,10,94,18,145,MIA_NYJ_2017-09-24
BUF,2017-09-24,8,Sun,3,3,,DEN,W 26-16,8,69,10,79,18,148,BUF_DEN_2017-09-24
DEN,2017-09-17,8,Sun,2,2,,DAL,W 42-17,8,61,8,69,16,130,DEN_DAL_2017-09-17
CHI,2017-09-17,8,Sun,2,2,@,TAM,L 7-29,8,59,4,34,12,93,CHI_TAM_2017-09-17
DAL,2017-09-17,8,Sun,2,2,@,DEN,L 17-42,8,69,8,61,16,130,DAL_DEN_2017-09-17
IND,2017-09-17,8,Sun,2,2,,ARI,L 13-16 (OT),8,70,6,41,14,111,IND_ARI_2017-09-17
GNB,2017-09-10,8,Sun,1,1,,SEA,W 17-9,8,70,8,50,16,120,GNB_SEA_2017-09-10
PHI,2017-09-10,8,Sun,1,1,@,WAS,W 30-17,8,76,2,15,10,91,PHI_WAS_2017-09-10
SEA,2017-09-10,8,Sun,1,1,@,GNB,L 9-17,8,50,8,70,16,120,SEA_GNB_2017-09-10
ATL,2017-09-10,8,Sun,1,1,@,CHI,W 23-17,8,73,4,40,12,113,ATL_CHI_2017-09-10
ARI,2023-01-08,7,Sun,17,18,@,SFO,L 13-38,7,50,2,10,9,60,ARI_SFO_2023-01-08
HOU,2023-01-08,7,Sun,17,18,@,IND,W 32-31,7,41,2,10,9,51,HOU_IND_2023-01-08
HOU,2023-01-01,7,Sun,16,17,,JAX,L 3-31,7,45,2,30,9,75,HOU_JAX_2023-01-01
IND,2023-01-01,7,Sun,16,17,@,NYG,L 10-38,7,60,3,20,10,80,IND_NYG_2023-01-01
NYG,2022-12-24,7,Sat,15,16,@,MIN,L 24-27,7,63,2,14,9,77,NYG_MIN_2022-12-24
ARI,2022-12-18,7,Sun,14,15,@,DEN,L 15-24,7,46,4,31,11,77,ARI_DEN_2022-12-18
TAM,2022-12-18,7,Sun,14,15,,CIN,L 23-34,7,58,4,27,11,85,TAM_CIN_2022-12-18
PIT,2022-12-18,7,Sun,14,15,@,CAR,W 24-16,7,81,5,40,12,121,PIT_CAR_2022-12-18
BUF,2022-12-17,7,Sat,14,15,,MIA,W 32-29,7,51,8,51,15,102,BUF_MIA_2022-12-17
SFO,2022-12-15,7,Thu,14,15,@,SEA,W 21-13,7,60,8,79,15,139,SFO_SEA_2022-12-15
NYJ,2022-12-11,7,Sun,13,14,@,BUF,L 12-20,7,61,5,35,12,96,NYJ_BUF_2022-12-11
DET,2022-12-11,7,Sun,13,14,,MIN,W 34-23,7,51,3,25,10,76,DET_MIN_2022-12-11
LVR,2022-12-08,7,Thu,13,14,@,LAR,L 16-17,7,94,7,60,14,154,LVR_LAR_2022-12-08
LAR,2022-12-08,7,Thu,13,14,,LVR,W 17-16,7,60,7,94,14,154,LAR_LVR_2022-12-08
PIT,2022-12-04,7,Sun,12,13,@,ATL,W 19-16,7,30,6,48,13,78,PIT_ATL_2022-12-04
WAS,2022-12-04,7,Sun,13,13,@,NYG,T 20-20 (OT),7,55,4,34,11,89,WAS_NYG_2022-12-04
TEN,2022-12-04,7,Sun,12,13,@,PHI,L 10-35,7,82,12,80,19,162,TEN_PHI_2022-12-04
SFO,2022-11-27,7,Sun,11,12,,NOR,W 13-0,7,64,6,46,13,110,SFO_NOR_2022-11-27
LVR,2022-11-27,7,Sun,11,12,@,SEA,W 40-34 (OT),7,50,2,10,9,60,LVR_SEA_2022-11-27
NYG,2022-11-24,7,Thu,11,12,@,DAL,L 20-28,7,66,13,86,20,152,NYG_DAL_2022-11-24
CHI,2022-11-20,7,Sun,11,11,@,ATL,L 24-27,7,56,2,13,9,69,CHI_ATL_2022-11-20
MIN,2022-11-20,7,Sun,10,11,,DAL,L 3-40,7,59,6,39,13,98,MIN_DAL_2022-11-20
PHI,2022-11-20,7,Sun,10,11,@,IND,W 17-16,7,55,8,90,15,145,PHI_IND_2022-11-20
PHI,2022-11-14,7,Mon,9,10,,WAS,L 21-32,7,75,5,58,12,133,PHI_WAS_2022-11-14
MIN,2022-11-13,7,Sun,9,10,@,BUF,W 33-30 (OT),7,64,7,64,14,128,MIN_BUF_2022-11-13
HOU,2022-11-13,7,Sun,9,10,@,NYG,L 16-24,7,40,5,24,12,64,HOU_NYG_2022-11-13
BUF,2022-11-13,7,Sun,9,10,,MIN,L 30-33 (OT),7,64,7,64,14,128,BUF_MIN_2022-11-13
DET,2022-11-06,7,Sun,8,9,,GNB,W 15-9,7,62,8,81,15,143,DET_GNB_2022-11-06
CAR,2022-11-06,7,Sun,9,9,@,CIN,L 21-42,7,50,5,35,12,85,CAR_CIN_2022-11-06
TAM,2022-11-06,7,Sun,9,9,,LAR,W 16-13,7,55,4,53,11,108,TAM_LAR_2022-11-06
ATL,2022-10-30,7,Sun,8,8,,CAR,W 37-34 (OT),7,64,9,74,16,138,ATL_CAR_2022-10-30
MIA,2022-10-30,7,Sun,8,8,@,DET,W 31-27,7,55,6,30,13,85,MIA_DET_2022-10-30
BAL,2022-10-27,7,Thu,8,8,@,TAM,W 27-22,7,101,4,35,11,136,BAL_TAM_2022-10-27
WAS,2022-10-23,7,Sun,7,7,,GNB,W 23-21,7,54,9,69,16,123,WAS_GNB_2022-10-23
LAC,2022-10-23,7,Sun,7,7,,SEA,L 23-37,7,70,7,68,14,138,LAC_SEA_2022-10-23
DAL,2022-10-23,7,Sun,7,7,,DET,W 24-6,7,55,8,59,15,114,DAL_DET_2022-10-23
SEA,2022-10-23,7,Sun,7,7,@,LAC,W 37-23,7,68,7,70,14,138,SEA_LAC_2022-10-23
PIT,2022-10-16,7,Sun,6,6,,TAM,W 20-18,7,45,6,42,13,87,PIT_TAM_2022-10-16
NYJ,2022-10-16,7,Sun,6,6,@,GNB,W 27-10,7,79,7,42,14,121,NYJ_GNB_2022-10-16
CLE,2022-10-16,7,Sun,6,6,,NWE,L 15-38,7,63,12,92,19,155,CLE_NWE_2022-10-16
LAR,2022-10-16,7,Sun,6,6,,CAR,W 24-10,7,49,3,30,10,79,LAR_CAR_2022-10-16
IND,2022-10-16,7,Sun,6,6,,JAX,W 34-27,7,52,4,44,11,96,IND_JAX_2022-10-16
BUF,2022-10-16,7,Sun,6,6,@,KAN,W 24-20,7,35,5,58,12,93,BUF_KAN_2022-10-16
GNB,2022-10-16,7,Sun,6,6,,NYJ,L 10-27,7,42,7,79,14,121,GNB_NYJ_2022-10-16
WAS,2022-10-13,7,Thu,6,6,@,CHI,W 12-7,7,36,4,42,11,78,WAS_CHI_2022-10-13
MIN,2022-10-09,7,Sun,5,5,,CHI,W 29-22,7,70,6,40,13,110,MIN_CHI_2022-10-09
DET,2022-10-09,7,Sun,5,5,@,NWE,L 0-29,7,82,6,46,13,128,DET_NWE_2022-10-09
GNB,2022-10-09,7,Sun,5,5,,NYG,L 22-27,7,37,6,63,13,100,GNB_NYG_2022-10-09
DEN,2022-10-06,7,Thu,5,5,,IND,L 9-12 (OT),7,49,8,64,15,113,DEN_IND_2022-10-06
NWE,2022-10-02,7,Sun,4,4,@,GNB,L 24-27 (OT),7,75,4,40,11,115,NWE_GNB_2022-10-02
IND,2022-10-02,7,Sun,4,4,,TEN,L 17-24,7,50,6,40,13,90,IND_TEN_2022-10-02
NYG,2022-10-02,7,Sun,4,4,,CHI,W 20-12,7,55,5,65,12,120,NYG_CHI_2022-10-02
NYJ,2022-10-02,7,Sun,4,4,@,PIT,W 24-20,7,64,8,55,15,119,NYJ_PIT_2022-10-02
ARI,2022-10-02,7,Sun,4,4,@,CAR,W 26-16,7,61,6,76,13,137,ARI_CAR_2022-10-02
CLE,2022-10-02,7,Sun,4,4,@,ATL,L 20-23,7,51,1,15,8,66,CLE_ATL_2022-10-02
DEN,2022-10-02,7,Sun,4,4,@,LVR,L 23-32,7,50,4,25,11,75,DEN_LVR_2022-10-02
SFO,2022-09-25,7,Sun,3,3,@,DEN,L 10-11,7,40,5,30,12,70,SFO_DEN_2022-09-25
BUF,2022-09-25,7,Sun,3,3,@,MIA,L 19-21,7,52,4,20,11,72,BUF_MIA_2022-09-25
NOR,2022-09-25,7,Sun,3,3,@,CAR,L 14-22,7,58,4,40,11,98,NOR_CAR_2022-09-25
LAC,2022-09-25,7,Sun,3,3,,JAX,L 10-38,7,54,2,10,9,64,LAC_JAX_2022-09-25
DET,2022-09-25,7,Sun,3,3,@,MIN,L 24-28,7,59,3,15,10,74,DET_MIN_2022-09-25
TEN,2022-09-25,7,Sun,3,3,,LVR,W 24-22,7,85,6,44,13,129,TEN_LVR_2022-09-25
CHI,2022-09-18,7,Sun,2,2,@,GNB,L 10-27,7,50,3,25,10,75,CHI_GNB_2022-09-18
NWE,2022-09-18,7,Sun,2,2,@,PIT,W 17-14,7,55,3,20,10,75,NWE_PIT_2022-09-18
CIN,2022-09-18,7,Sun,2,2,@,DAL,L 17-20,7,35,5,45,12,80,CIN_DAL_2022-09-18
IND,2022-09-11,7,Sun,1,1,@,HOU,T 20-20 (OT),7,89,6,40,13,129,IND_HOU_2022-09-11
TEN,2022-09-11,7,Sun,1,1,,NYG,L 20-21,7,50,8,45,15,95,TEN_NYG_2022-09-11
DET,2022-09-11,7,Sun,1,1,,PHI,L 35-38,7,65,10,61,17,126,DET_PHI_2022-09-11
BUF,2022-01-02,7,Sun,16,17,,ATL,W 29-15,7,47,4,27,11,74,BUF_ATL_2022-01-02
SFO,2022-01-02,7,Sun,16,17,,HOU,W 23-7,7,111,5,67,12,178,SFO_HOU_2022-01-02
ARI,2022-01-02,7,Sun,16,17,@,DAL,W 25-22,7,45,10,88,17,133,ARI_DAL_2022-01-02
MIA,2021-12-27,7,Mon,15,16,@,NOR,W 20-3,7,65,7,62,14,127,MIA_NOR_2021-12-27
NOR,2021-12-27,7,Mon,15,16,,MIA,L 3-20,7,62,7,65,14,127,NOR_MIA_2021-12-27
SEA,2021-12-26,7,Sun,15,16,,CHI,L 24-25,7,88,8,73,15,161,SEA_CHI_2021-12-26
NYJ,2021-12-26,7,Sun,15,16,,JAX,W 26-21,7,81,2,10,9,91,NYJ_JAX_2021-12-26
LVR,2021-12-20,7,Mon,14,15,@,CLE,W 16-14,7,64,3,61,10,125,LVR_CLE_2021-12-20
MIN,2021-12-20,7,Mon,14,15,@,CHI,W 17-9,7,54,9,91,16,145,MIN_CHI_2021-12-20
ARI,2021-12-19,7,Sun,14,15,@,DET,L 12-30,7,83,6,49,13,132,ARI_DET_2021-12-19
TEN,2021-12-19,7,Sun,14,15,@,PIT,L 13-19,7,68,5,30,12,98,TEN_PIT_2021-12-19
ARI,2021-12-13,7,Mon,13,14,,LAR,L 23-30,7,54,5,40,12,94,ARI_LAR_2021-12-13
DAL,2021-12-12,7,Sun,13,14,@,WAS,W 27-20,7,60,7,65,14,125,DAL_WAS_2021-12-12
BUF,2021-12-12,7,Sun,13,14,@,TAM,L 27-33 (OT),7,65,4,24,11,89,BUF_TAM_2021-12-12
CHI,2021-12-12,7,Sun,13,14,@,GNB,L 30-45,7,41,3,30,10,71,CHI_GNB_2021-12-12
WAS,2021-12-12,7,Sun,13,14,,DAL,L 20-27,7,65,7,60,14,125,WAS_DAL_2021-12-12
LAR,2021-12-05,7,Sun,12,13,,JAX,W 37-7,7,47,3,39,10,86,LAR_JAX_2021-12-05
MIN,2021-12-05,7,Sun,12,13,@,DET,L 27-29,7,66,3,11,10,77,MIN_DET_2021-12-05
CIN,2021-12-05,7,Sun,12,13,,LAC,L 22-41,7,63,7,51,14,114,CIN_LAC_2021-12-05
KAN,2021-12-05,7,Sun,12,13,,DEN,W 22-9,7,60,5,37,12,97,KAN_DEN_2021-12-05
LAC,2021-12-05,7,Sun,12,13,@,CIN,W 41-22,7,51,7,63,14,114,LAC_CIN_2021-12-05
NOR,2021-12-02,7,Thu,12,13,,DAL,L 17-27,7,59,5,35,12,94,NOR_DAL_2021-12-02
CAR,2021-11-28,7,Sun,12,12,@,MIA,L 10-33,7,61,5,35,12,96,CAR_MIA_2021-11-28
CAR,2021-11-21,7,Sun,11,11,,WAS,L 21-27,7,65,8,69,15,134,CAR_WAS_2021-11-21
BUF,2021-11-21,7,Sun,10,11,,IND,L 15-41,7,56,3,30,10,86,BUF_IND_2021-11-21
NYJ,2021-11-21,7,Sun,10,11,,MIA,L 17-24,7,48,8,62,15,110,NYJ_MIA_2021-11-21
HOU,2021-11-21,7,Sun,10,11,@,TEN,W 22-13,7,50,5,52,12,102,HOU_TEN_2021-11-21
LVR,2021-11-21,7,Sun,10,11,,CIN,L 13-32,7,77,1,5,8,82,LVR_CIN_2021-11-21
DET,2021-11-21,7,Sun,10,11,@,CLE,L 10-13,7,67,10,82,17,149,DET_CLE_2021-11-21
BUF,2021-11-14,7,Sun,9,10,@,NYJ,W 45-17,7,50,9,69,16,119,BUF_NYJ_2021-11-14
PHI,2021-11-14,7,Sun,10,10,@,DEN,W 30-13,7,89,4,29,11,118,PHI_DEN_2021-11-14
PIT,2021-11-14,7,Sun,9,10,,DET,T 16-16 (OT),7,59,8,84,15,143,PIT_DET_2021-11-14
IND,2021-11-14,7,Sun,10,10,,JAX,W 23-17,7,47,8,79,15,126,IND_JAX_2021-11-14
LAC,2021-11-14,7,Sun,9,10,,MIN,L 20-27,7,52,10,118,17,170,LAC_MIN_2021-11-14
NYJ,2021-11-04,7,Thu,8,9,@,IND,L 30-45,7,43,2,22,9,65,NYJ_IND_2021-11-04
SFO,2021-10-31,7,Sun,7,8,@,CHI,W 33-22,7,55,4,30,11,85,SFO_CHI_2021-10-31
MIN,2021-10-31,7,Sun,7,8,,DAL,L 16-20,7,57,11,96,18,153,MIN_DAL_2021-10-31
GNB,2021-10-28,7,Thu,8,8,@,ARI,W 24-21,7,60,7,59,14,119,GNB_ARI_2021-10-28
ARI,2021-10-28,7,Thu,8,8,,GNB,L 21-24,7,59,7,60,14,119,ARI_GNB_2021-10-28
NOR,2021-10-25,7,Mon,6,7,@,SEA,W 13-10,7,90,6,53,13,143,NOR_SEA_2021-10-25
LVR,2021-10-24,7,Sun,7,7,,PHI,W 33-22,7,65,4,37,11,102,LVR_PHI_2021-10-24
SFO,2021-10-24,7,Sun,6,7,,IND,L 18-30,7,122,6,45,13,167,SFO_IND_2021-10-24
ARI,2021-10-24,7,Sun,7,7,,HOU,W 31-5,7,54,8,80,15,134,ARI_HOU_2021-10-24
CAR,2021-10-24,7,Sun,7,7,@,NYG,L 3-25,7,37,8,60,15,97,CAR_NYG_2021-10-24
TEN,2021-10-18,7,Mon,6,6,,BUF,W 34-31,7,91,8,60,15,151,TEN_BUF_2021-10-18
CHI,2021-10-17,7,Sun,6,6,,GNB,L 14-24,7,54,3,51,10,105,CHI_GNB_2021-10-17
MIA,2021-10-17,7,Sun,6,6,@,JAX,L 20-23,7,55,8,54,15,109,MIA_JAX_2021-10-17
LAR,2021-10-17,7,Sun,6,6,@,NYG,W 38-11,7,50,5,27,12,77,LAR_NYG_2021-10-17
TAM,2021-10-14,7,Thu,6,6,@,PHI,W 28-22,7,120,4,41,11,161,TAM_PHI_2021-10-14
DEN,2021-10-10,7,Sun,5,5,@,PIT,L 19-27,7,67,8,59,15,126,DEN_PIT_2021-10-10
CLE,2021-10-10,7,Sun,5,5,@,LAC,L 42-47,7,77,6,49,13,126,CLE_LAC_2021-10-10
NYJ,2021-10-10,7,Sun,5,5,@,ATL,L 20-27,7,58,4,66,11,124,NYJ_ATL_2021-10-10
KAN,2021-10-10,7,Sun,5,5,,BUF,L 20-38,7,55,10,103,17,158,KAN_BUF_2021-10-10
SFO,2021-10-10,7,Sun,5,5,@,ARI,L 10-17,7,60,6,62,13,122,SFO_ARI_2021-10-10
MIN,2021-10-10,7,Sun,5,5,,DET,W 19-17,7,74,3,30,10,104,MIN_DET_2021-10-10
TEN,2021-10-10,7,Sun,5,5,@,JAX,W 37-19,7,44,4,33,11,77,TEN_JAX_2021-10-10
LAC,2021-10-04,7,Mon,4,4,,LVR,W 28-14,7,105,7,58,14,163,LAC_LVR_2021-10-04
LVR,2021-10-04,7,Mon,4,4,@,LAC,L 14-28,7,58,7,105,14,163,LVR_LAC_2021-10-04
KAN,2021-10-03,7,Sun,4,4,@,PHI,W 42-30,7,46,9,49,16,95,KAN_PHI_2021-10-03
ARI,2021-10-03,7,Sun,4,4,@,LAR,W 37-20,7,63,5,36,12,99,ARI_LAR_2021-10-03
ATL,2021-10-03,7,Sun,4,4,,WAS,L 30-34,7,36,6,85,13,121,ATL_WAS_2021-10-03
DAL,2021-10-03,7,Sun,4,4,,CAR,W 36-28,7,50,6,32,13,82,DAL_CAR_2021-10-03
MIN,2021-10-03,7,Sun,4,4,,CLE,L 7-14,7,42,7,73,14,115,MIN_CLE_2021-10-03
CHI,2021-10-03,7,Sun,4,4,,DET,W 24-14,7,61,4,26,11,87,CHI_DET_2021-10-03
CLE,2021-10-03,7,Sun,4,4,@,MIN,W 14-7,7,73,7,42,14,115,CLE_MIN_2021-10-03
TAM,2021-10-03,7,Sun,4,4,@,NWE,W 19-17,7,74,8,77,15,151,TAM_NWE_2021-10-03
CLE,2021-09-26,7,Sun,3,3,,CHI,W 26-6,7,98,5,49,12,147,CLE_CHI_2021-09-26
ARI,2021-09-26,7,Sun,3,3,@,JAX,W 31-19,7,58,4,40,11,98,ARI_JAX_2021-09-26
TAM,2021-09-26,7,Sun,3,3,@,LAR,L 24-34,7,41,1,4,8,45,TAM_LAR_2021-09-26
DET,2021-09-26,7,Sun,3,3,,BAL,L 17-19,7,35,6,69,13,104,DET_BAL_2021-09-26
GNB,2021-09-26,7,Sun,3,3,@,SFO,W 30-28,7,87,4,86,11,173,GNB_SFO_2021-09-26
HOU,2021-09-23,7,Thu,3,3,,CAR,L 9-24,7,51,8,64,15,115,HOU_CAR_2021-09-23
JAX,2021-09-19,7,Sun,2,2,,DEN,L 13-23,7,70,10,101,17,171,JAX_DEN_2021-09-19
SEA,2021-09-12,7,Sun,1,1,@,IND,W 28-16,7,53,2,16,9,69,SEA_IND_2021-09-12
TEN,2021-09-12,7,Sun,1,1,,ARI,L 13-38,7,57,8,59,15,116,TEN_ARI_2021-09-12
SFO,2021-09-12,7,Sun,1,1,@,DET,W 41-33,7,79,5,45,12,124,SFO_DET_2021-09-12
DET,2021-01-03,7,Sun,16,17,,MIN,L 35-37,7,51,4,35,11,86,DET_MIN_2021-01-03
NYJ,2020-12-27,7,Sun,15,16,,CLE,W 23-16,7,58,6,51,13,109,NYJ_CLE_2020-12-27
ATL,2020-12-27,7,Sun,15,16,@,KAN,L 14-17,7,45,6,41,13,86,ATL_KAN_2020-12-27
MIA,2020-12-20,7,Sun,14,15,,NWE,W 22-12,7,40,2,20,9,60,MIA_NWE_2020-12-20
JAX,2020-12-20,7,Sun,14,15,@,BAL,L 14-40,7,67,4,40,11,107,JAX_BAL_2020-12-20
DEN,2020-12-19,7,Sat,14,15,,BUF,L 19-48,7,33,8,75,15,108,DEN_BUF_2020-12-19
CAR,2020-12-19,7,Sat,14,15,@,GNB,L 16-24,7,66,5,50,12,116,CAR_GNB_2020-12-19
CAR,2020-12-13,7,Sun,13,14,,DEN,L 27-32,7,48,2,18,9,66,CAR_DEN_2020-12-13
CHI,2020-12-13,7,Sun,13,14,,HOU,W 36-7,7,44,6,50,13,94,CHI_HOU_2020-12-13
TEN,2020-12-13,7,Sun,13,14,@,JAX,W 31-10,7,78,10,80,17,158,TEN_JAX_2020-12-13
BUF,2020-12-13,7,Sun,13,14,,PIT,W 26-15,7,48,3,55,10,103,BUF_PIT_2020-12-13
NYJ,2020-12-13,7,Sun,13,14,@,SEA,L 3-40,7,50,4,35,11,85,NYJ_SEA_2020-12-13
DAL,2020-12-08,7,Tue,12,13,@,BAL,L 17-34,7,58,4,23,11,81,DAL_BAL_2020-12-08
SFO,2020-12-07,7,Mon,12,13,,BUF,L 24-34,7,43,4,50,11,93,SFO_BUF_2020-12-07
DET,2020-12-06,7,Sun,12,13,@,CHI,W 34-30,7,45,3,20,10,65,DET_CHI_2020-12-06
IND,2020-12-06,7,Sun,12,13,@,HOU,W 26-20,7,50,3,30,10,80,IND_HOU_2020-12-06
BAL,2020-12-02,7,Wed,11,12,@,PIT,L 14-19,7,86,5,40,12,126,BAL_PIT_2020-12-02
CAR,2020-11-29,7,Sun,12,12,@,MIN,L 27-28,7,58,8,52,15,110,CAR_MIN_2020-11-29
GNB,2020-11-22,7,Sun,10,11,@,IND,L 31-34 (OT),7,45,8,116,15,161,GNB_IND_2020-11-22
CAR,2020-11-22,7,Sun,11,11,,DET,W 20-0,7,45,4,20,11,65,CAR_DET_2020-11-22
NWE,2020-11-22,7,Sun,10,11,@,HOU,L 20-27,7,55,5,35,12,90,NWE_HOU_2020-11-22
ATL,2020-11-22,7,Sun,10,11,@,NOR,L 9-24,7,53,5,35,12,88,ATL_NOR_2020-11-22
ARI,2020-11-15,7,Sun,9,10,,BUF,W 32-30,7,40,9,69,16,109,ARI_BUF_2020-11-15
JAX,2020-11-15,7,Sun,9,10,@,GNB,L 20-24,7,86,4,35,11,121,JAX_GNB_2020-11-15
NYG,2020-11-15,7,Sun,10,10,,PHI,W 27-17,7,64,11,74,18,138,NYG_PHI_2020-11-15
DEN,2020-11-15,7,Sun,9,10,@,LVR,L 12-37,7,37,8,82,15,119,DEN_LVR_2020-11-15
MIA,2020-11-08,7,Sun,8,9,@,ARI,W 34-31,7,75,7,71,14,146,MIA_ARI_2020-11-08
ARI,2020-11-08,7,Sun,8,9,,MIA,L 31-34,7,71,7,75,14,146,ARI_MIA_2020-11-08
DAL,2020-11-08,7,Sun,9,9,,PIT,L 19-24,7,70,3,16,10,86,DAL_PIT_2020-11-08
NYG,2020-11-02,7,Mon,8,8,,TAM,L 23-25,7,73,3,20,10,93,NYG_TAM_2020-11-02
TEN,2020-11-01,7,Sun,7,8,@,CIN,L 20-31,7,68,7,45,14,113,TEN_CIN_2020-11-01
MIN,2020-11-01,7,Sun,7,8,@,GNB,W 28-22,7,36,9,85,16,121,MIN_GNB_2020-11-01
CHI,2020-11-01,7,Sun,8,8,,NOR,L 23-26 (OT),7,53,5,45,12,98,CHI_NOR_2020-11-01
KAN,2020-11-01,7,Sun,8,8,,NYJ,W 35-9,7,61,3,25,10,86,KAN_NYJ_2020-11-01
CIN,2020-11-01,7,Sun,8,8,,TEN,W 31-20,7,45,7,68,14,113,CIN_TEN_2020-11-01
DAL,2020-11-01,7,Sun,8,8,@,PHI,L 9-23,7,68,4,28,11,96,DAL_PHI_2020-11-01
CLE,2020-11-01,7,Sun,8,8,,LVR,L 6-16,7,59,5,25,12,84,CLE_LVR_2020-11-01
CIN,2020-10-25,7,Sun,7,7,,CLE,L 34-37,7,45,5,40,12,85,CIN_CLE_2020-10-25
TEN,2020-10-25,7,Sun,6,7,,PIT,L 24-27,7,73,8,69,15,142,TEN_PIT_2020-10-25
PHI,2020-10-22,7,Thu,7,7,,NYG,W 22-21,7,75,9,62,16,137,PHI_NYG_2020-10-22
ARI,2020-10-19,7,Mon,6,6,@,DAL,W 38-10,7,43,6,36,13,79,ARI_DAL_2020-10-19
TEN,2020-10-18,7,Sun,5,6,,HOU,W 42-36 (OT),7,73,4,46,11,119,TEN_HOU_2020-10-18
DET,2020-10-18,7,Sun,5,6,@,JAX,W 34-16,7,60,5,56,12,116,DET_JAX_2020-10-18
NYJ,2020-10-18,7,Sun,6,6,@,MIA,L 0-24,7,80,5,25,12,105,NYJ_MIA_2020-10-18
CLE,2020-10-18,7,Sun,6,6,@,PIT,L 7-38,7,55,6,45,13,100,CLE_PIT_2020-10-18
SFO,2020-10-18,7,Sun,6,6,,LAR,W 24-16,7,63,6,34,13,97,SFO_LAR_2020-10-18
SFO,2020-10-11,7,Sun,5,5,,MIA,L 17-43,7,75,7,69,14,144,SFO_MIA_2020-10-11
MIA,2020-10-11,7,Sun,5,5,@,SFO,W 43-17,7,69,7,75,14,144,MIA_SFO_2020-10-11
LVR,2020-10-04,7,Sun,4,4,,BUF,L 23-30,7,65,5,81,12,146,LVR_BUF_2020-10-04
CIN,2020-10-04,7,Sun,4,4,,JAX,W 33-25,7,73,6,49,13,122,CIN_JAX_2020-10-04
LAC,2020-10-04,7,Sun,4,4,@,TAM,L 31-38,7,60,8,90,15,150,LAC_TAM_2020-10-04
ATL,2020-09-27,7,Sun,3,3,,CHI,L 26-30,7,75,10,80,17,155,ATL_CHI_2020-09-27
NYJ,2020-09-27,7,Sun,3,3,@,IND,L 7-36,7,57,4,40,11,97,NYJ_IND_2020-09-27
DET,2020-09-27,7,Sun,3,3,@,ARI,W 26-23,7,46,7,38,14,84,DET_ARI_2020-09-27
ARI,2020-09-27,7,Sun,3,3,,DET,L 23-26,7,38,7,46,14,84,ARI_DET_2020-09-27
DAL,2020-09-20,7,Sun,2,2,,ATL,W 40-39,7,75,8,51,15,126,DAL_ATL_2020-09-20
DET,2020-09-20,7,Sun,2,2,@,GNB,L 21-42,7,70,8,60,15,130,DET_GNB_2020-09-20
BAL,2020-09-13,7,Sun,1,1,,CLE,W 38-6,7,66,8,80,15,146,BAL_CLE_2020-09-13
BUF,2020-09-13,7,Sun,1,1,,NYJ,W 27-17,7,79,9,95,16,174,BUF_NYJ_2020-09-13
WAS,2020-09-13,7,Sun,1,1,,PHI,W 27-17,7,55,3,20,10,75,WAS_PHI_2020-09-13
DAL,2020-09-13,7,Sun,1,1,@,LAR,L 17-20,7,50,5,34,12,84,DAL_LAR_2020-09-13
CIN,2020-09-13,7,Sun,1,1,,LAC,L 13-16,7,44,6,35,13,79,CIN_LAC_2020-09-13
PHI,2019-12-29,7,Sun,16,17,@,NYG,W 34-17,7,55,4,48,11,103,PHI_NYG_2019-12-29
CHI,2019-12-22,7,Sun,15,16,,KAN,L 3-26,7,50,9,71,16,121,CHI_KAN_2019-12-22
CLE,2019-12-22,7,Sun,15,16,,BAL,L 15-31,7,62,7,50,14,112,CLE_BAL_2019-12-22
BAL,2019-12-22,7,Sun,15,16,@,CLE,W 31-15,7,50,7,62,14,112,BAL_CLE_2019-12-22
SEA,2019-12-22,7,Sun,15,16,,ARI,L 13-27,7,55,5,47,12,102,SEA_ARI_2019-12-22
DET,2019-12-22,7,Sun,15,16,@,DEN,L 17-27,7,68,6,50,13,118,DET_DEN_2019-12-22
BUF,2019-12-21,7,Sat,15,16,@,NWE,L 17-24,7,46,3,30,10,76,BUF_NWE_2019-12-21
LAR,2019-12-21,7,Sat,15,16,@,SFO,L 31-34,7,43,3,26,10,69,LAR_SFO_2019-12-21
IND,2019-12-16,7,Mon,14,15,@,NOR,L 7-34,7,49,6,52,13,101,IND_NOR_2019-12-16
DEN,2019-12-15,7,Sun,14,15,@,KAN,L 3-23,7,72,5,45,12,117,DEN_KAN_2019-12-15
MIA,2019-12-15,7,Sun,14,15,@,NYG,L 20-36,7,42,4,32,11,74,MIA_NYG_2019-12-15
PHI,2019-12-15,7,Sun,14,15,@,WAS,W 37-27,7,54,5,60,12,114,PHI_WAS_2019-12-15
SFO,2019-12-15,7,Sun,14,15,,ATL,L 22-29,7,67,11,98,18,165,SFO_ATL_2019-12-15
NYG,2019-12-09,7,Mon,13,14,@,PHI,L 17-23 (OT),7,54,4,30,11,84,NYG_PHI_2019-12-09
DEN,2019-12-08,7,Sun,13,14,@,HOU,W 38-24,7,50,9,44,16,94,DEN_HOU_2019-12-08
ARI,2019-12-08,7,Sun,13,14,,PIT,L 17-23,7,75,4,20,11,95,ARI_PIT_2019-12-08
CAR,2019-12-08,7,Sun,13,14,@,ATL,L 20-40,7,44,6,58,13,102,CAR_ATL_2019-12-08
LAC,2019-12-01,7,Sun,12,13,@,DEN,L 20-23,7,82,3,25,10,107,LAC_DEN_2019-12-01
GNB,2019-12-01,7,Sun,12,13,@,NYG,W 31-13,7,54,4,31,11,85,GNB_NYG_2019-12-01
MIA,2019-12-01,7,Sun,12,13,,PHI,W 37-31,7,59,10,91,17,150,MIA_PHI_2019-12-01
BUF,2019-11-28,7,Thu,12,13,@,DAL,W 26-15,7,53,5,66,12,119,BUF_DAL_2019-11-28
DEN,2019-11-24,7,Sun,11,12,@,BUF,L 3-20,7,70,12,90,19,160,DEN_BUF_2019-11-24
CLE,2019-11-24,7,Sun,11,12,,MIA,W 41-24,7,70,8,94,15,164,CLE_MIA_2019-11-24
DAL,2019-11-24,7,Sun,11,12,@,NWE,L 9-13,7,50,6,56,13,106,DAL_NWE_2019-11-24
CIN,2019-11-24,7,Sun,11,12,,PIT,L 10-16,7,79,10,77,17,156,CIN_PIT_2019-11-24
ATL,2019-11-24,7,Sun,11,12,,TAM,L 22-35,7,60,8,51,15,111,ATL_TAM_2019-11-24
TAM,2019-11-17,7,Sun,10,11,,NOR,L 17-34,7,55,9,76,16,131,TAM_NOR_2019-11-17
PHI,2019-11-17,7,Sun,10,11,,NWE,L 10-17,7,39,6,89,13,128,PHI_NWE_2019-11-17
OAK,2019-11-17,7,Sun,10,11,,CIN,W 17-10,7,42,4,40,11,82,OAK_CIN_2019-11-17
BUF,2019-11-10,7,Sun,9,10,@,CLE,L 16-19,7,40,4,70,11,110,BUF_CLE_2019-11-10
CHI,2019-11-10,7,Sun,9,10,,DET,W 20-13,7,57,8,76,15,133,CHI_DET_2019-11-10
ATL,2019-11-10,7,Sun,9,10,@,NOR,W 26-9,7,48,12,90,19,138,ATL_NOR_2019-11-10
NYJ,2019-11-10,7,Sun,9,10,,NYG,W 34-27,7,54,6,62,13,116,NYJ_NYG_2019-11-10
HOU,2019-11-03,7,Sun,9,9,@,JAX,W 26-3,7,60,4,34,11,94,HOU_JAX_2019-11-03
IND,2019-11-03,7,Sun,8,9,@,PIT,L 24-26,7,89,5,70,12,159,IND_PIT_2019-11-03
NWE,2019-11-03,7,Sun,9,9,@,BAL,L 20-37,7,48,4,34,11,82,NWE_BAL_2019-11-03
DEN,2019-11-03,7,Sun,9,9,,CLE,W 24-19,7,55,5,40,12,95,DEN_CLE_2019-11-03
DET,2019-10-27,7,Sun,7,8,,NYG,W 31-26,7,75,5,44,12,119,DET_NYG_2019-10-27
HOU,2019-10-27,7,Sun,8,8,,OAK,W 27-24,7,50,11,100,18,150,HOU_OAK_2019-10-27
MIN,2019-10-24,7,Thu,8,8,,WAS,W 19-9,7,74,4,46,11,120,MIN_WAS_2019-10-24
NWE,2019-10-21,7,Mon,7,7,@,NYJ,W 33-0,7,92,8,60,15,152,NWE_NYJ_2019-10-21
TEN,2019-10-20,7,Sun,7,7,,LAC,W 23-20,7,54,4,29,11,83,TEN_LAC_2019-10-20
WAS,2019-10-20,7,Sun,7,7,,SFO,L 0-9,7,47,2,20,9,67,WAS_SFO_2019-10-20
PHI,2019-10-13,7,Sun,6,6,@,MIN,L 20-38,7,49,4,30,11,79,PHI_MIN_2019-10-13
CLE,2019-10-07,7,Mon,5,5,@,SFO,L 3-31,7,55,4,34,11,89,CLE_SFO_2019-10-07
ATL,2019-10-06,7,Sun,5,5,@,HOU,L 32-53,7,63,9,89,16,152,ATL_HOU_2019-10-06
IND,2019-10-06,7,Sun,5,5,@,KAN,W 19-13,7,50,11,125,18,175,IND_KAN_2019-10-06
NWE,2019-10-06,7,Sun,5,5,@,WAS,W 33-7,7,55,6,72,13,127,NWE_WAS_2019-10-06
CIN,2019-10-06,7,Sun,5,5,,ARI,L 23-26,7,60,12,96,19,156,CIN_ARI_2019-10-06
HOU,2019-09-29,7,Sun,4,4,,CAR,L 10-16,7,81,6,35,13,116,HOU_CAR_2019-09-29
MIN,2019-09-29,7,Sun,4,4,@,CHI,L 6-16,7,55,7,50,14,105,MIN_CHI_2019-09-29
SEA,2019-09-29,7,Sun,4,4,@,ARI,W 27-10,7,65,7,44,14,109,SEA_ARI_2019-09-29
KAN,2019-09-29,7,Sun,4,4,@,DET,W 34-30,7,51,8,48,15,99,KAN_DET_2019-09-29
CHI,2019-09-29,7,Sun,4,4,,MIN,W 16-6,7,50,7,55,14,105,CHI_MIN_2019-09-29
ATL,2019-09-29,7,Sun,4,4,,TEN,L 10-24,7,50,5,77,12,127,ATL_TEN_2019-09-29
ARI,2019-09-29,7,Sun,4,4,,SEA,L 10-27,7,44,7,65,14,109,ARI_SEA_2019-09-29
LAC,2019-09-22,7,Sun,3,3,,HOU,L 20-27,7,69,6,65,13,134,LAC_HOU_2019-09-22
BAL,2019-09-22,7,Sun,3,3,@,KAN,L 28-33,7,60,4,31,11,91,BAL_KAN_2019-09-22
OAK,2019-09-22,7,Sun,3,3,@,MIN,L 14-34,7,84,6,59,13,143,OAK_MIN_2019-09-22
SEA,2019-09-22,7,Sun,3,3,,NOR,L 27-33,7,53,11,70,18,123,SEA_NOR_2019-09-22
ARI,2019-09-22,7,Sun,3,3,,CAR,L 20-38,7,52,3,35,10,87,ARI_CAR_2019-09-22
BUF,2019-09-22,7,Sun,3,3,,CIN,W 21-17,7,55,8,54,15,109,BUF_CIN_2019-09-22
LAR,2019-09-22,7,Sun,3,3,@,CLE,W 20-13,7,49,8,60,15,109,LAR_CLE_2019-09-22
GNB,2019-09-22,7,Sun,3,3,,DEN,W 27-16,7,53,3,27,10,80,GNB_DEN_2019-09-22
PHI,2019-09-15,7,Sun,2,2,@,ATL,L 20-24,7,60,10,58,17,118,PHI_ATL_2019-09-15
NYG,2019-09-15,7,Sun,2,2,,BUF,L 14-28,7,40,9,65,16,105,NYG_BUF_2019-09-15
CHI,2019-09-15,7,Sun,2,2,@,DEN,W 16-14,7,65,10,81,17,146,CHI_DEN_2019-09-15
HOU,2019-09-15,7,Sun,2,2,,JAX,W 13-12,7,47,9,70,16,117,HOU_JAX_2019-09-15
OAK,2019-09-15,7,Sun,2,2,,KAN,L 10-28,7,52,10,114,17,166,OAK_KAN_2019-09-15
CIN,2019-09-15,7,Sun,2,2,,SFO,L 17-41,7,60,9,75,16,135,CIN_SFO_2019-09-15
NOR,2019-09-09,7,Mon,1,1,,HOU,W 30-28,7,48,8,69,15,117,NOR_HOU_2019-09-09
BUF,2019-09-08,7,Sun,1,1,@,NYJ,W 17-16,7,55,8,67,15,122,BUF_NYJ_2019-09-08
NWE,2019-09-08,7,Sun,1,1,,PIT,W 33-3,7,55,6,54,13,109,NWE_PIT_2019-09-08
CIN,2019-09-08,7,Sun,1,1,@,SEA,L 20-21,7,57,8,55,15,112,CIN_SEA_2019-09-08
ARI,2019-09-08,7,Sun,1,1,,DET,T 27-27 (OT),7,35,9,59,16,94,ARI_DET_2019-09-08
DET,2018-12-23,7,Sun,15,16,,MIN,L 9-27,7,55,11,78,18,133,DET_MIN_2018-12-23
ARI,2018-12-23,7,Sun,15,16,,LAR,L 9-31,7,54,6,66,13,120,ARI_LAR_2018-12-23
GNB,2018-12-16,7,Sun,14,15,@,CHI,L 17-24,7,48,4,24,11,72,GNB_CHI_2018-12-16
LAC,2018-12-13,7,Thu,14,15,@,KAN,W 29-28,7,50,10,66,17,116,LAC_KAN_2018-12-13
NYJ,2018-12-09,7,Sun,13,14,@,BUF,W 27-23,7,93,7,47,14,140,NYJ_BUF_2018-12-09
CLE,2018-12-09,7,Sun,13,14,,CAR,W 26-20,7,52,10,68,17,120,CLE_CAR_2018-12-09
HOU,2018-12-09,7,Sun,13,14,,IND,L 21-24,7,35,9,59,16,94,HOU_IND_2018-12-09
DET,2018-12-09,7,Sun,13,14,@,ARI,W 17-3,7,68,8,83,15,151,DET_ARI_2018-12-09
MIA,2018-12-09,7,Sun,13,14,,NWE,W 34-33,7,81,5,30,12,111,MIA_NWE_2018-12-09
BUF,2018-12-09,7,Sun,13,14,,NYJ,L 23-27,7,47,7,93,14,140,BUF_NYJ_2018-12-09
KAN,2018-12-09,7,Sun,13,14,,BAL,W 27-24 (OT),7,53,11,112,18,165,KAN_BAL_2018-12-09
JAX,2018-12-06,7,Thu,13,14,@,TEN,L 9-30,7,67,3,30,10,97,JAX_TEN_2018-12-06
DEN,2018-12-02,7,Sun,12,13,@,CIN,W 24-10,7,60,12,100,19,160,DEN_CIN_2018-12-02
GNB,2018-12-02,7,Sun,12,13,,ARI,L 17-20,7,43,7,49,14,92,GNB_ARI_2018-12-02
LAR,2018-12-02,7,Sun,12,13,@,DET,W 30-16,7,105,8,54,15,159,LAR_DET_2018-12-02
ARI,2018-12-02,7,Sun,12,13,@,GNB,W 20-17,7,49,7,43,14,92,ARI_GNB_2018-12-02
ARI,2018-12-02,7,Sun,12,13,@,GNB,W 20-17,7,49,7,43,14,92,ARI_GNB_2018-12-02
GNB,2018-12-02,7,Sun,12,13,,ARI,L 17-20,7,43,7,49,14,92,GNB_ARI_2018-12-02
DEN,2018-12-02,7,Sun,12,13,@,CIN,W 24-10,7,60,12,100,19,160,DEN_CIN_2018-12-02
TEN,2018-11-26,7,Mon,11,12,@,HOU,L 17-34,7,50,3,53,10,103,TEN_HOU_2018-11-26
PHI,2018-11-25,7,Sun,11,12,,NYG,W 25-22,7,46,11,91,18,137,PHI_NYG_2018-11-25
IND,2018-11-25,7,Sun,11,12,,MIA,W 27-24,7,52,10,75,17,127,IND_MIA_2018-11-25
CLE,2018-11-25,7,Sun,11,12,@,CIN,W 35-20,7,61,13,96,20,157,CLE_CIN_2018-11-25
HOU,2018-11-18,7,Sun,10,11,@,WAS,W 23-21,7,40,6,43,13,83,HOU_WAS_2018-11-18
CIN,2018-11-18,7,Sun,10,11,@,BAL,L 21-24,7,58,5,31,12,89,CIN_BAL_2018-11-18
DEN,2018-11-18,7,Sun,10,11,@,LAC,W 23-22,7,43,14,120,21,163,DEN_LAC_2018-11-18
ARI,2018-11-18,7,Sun,10,11,,OAK,L 21-23,7,62,4,20,11,82,ARI_OAK_2018-11-18
IND,2018-11-18,7,Sun,10,11,,TEN,W 38-10,7,60,8,112,15,172,IND_TEN_2018-11-18
SEA,2018-11-11,7,Sun,9,10,@,LAR,L 31-36,7,56,10,102,17,158,SEA_LAR_2018-11-11
CLE,2018-11-11,7,Sun,10,10,,ATL,W 28-16,7,38,1,5,8,43,CLE_ATL_2018-11-11
IND,2018-11-11,7,Sun,9,10,,JAX,W 29-26,7,45,8,61,15,106,IND_JAX_2018-11-11
ATL,2018-11-04,7,Sun,8,9,@,WAS,W 38-14,7,50,10,147,17,197,ATL_WAS_2018-11-04
HOU,2018-11-04,7,Sun,9,9,@,DEN,W 19-17,7,60,8,50,15,110,HOU_DEN_2018-11-04
GNB,2018-11-04,7,Sun,8,9,@,NWE,L 17-31,7,63,5,30,12,93,GNB_NWE_2018-11-04
NOR,2018-10-28,7,Sun,7,8,@,MIN,W 30-20,7,64,6,54,13,118,NOR_MIN_2018-10-28
SEA,2018-10-28,7,Sun,7,8,@,DET,W 28-14,7,111,4,32,11,143,SEA_DET_2018-10-28
KAN,2018-10-28,7,Sun,8,8,,DEN,W 30-23,7,50,10,83,17,133,KAN_DEN_2018-10-28
CLE,2018-10-28,7,Sun,8,8,@,PIT,L 18-33,7,52,8,60,15,112,CLE_PIT_2018-10-28
BUF,2018-10-21,7,Sun,7,7,@,IND,L 5-37,7,59,4,35,11,94,BUF_IND_2018-10-21
NWE,2018-10-21,7,Sun,7,7,@,CHI,W 38-31,7,64,5,40,12,104,NWE_CHI_2018-10-21
ARI,2018-10-18,7,Thu,7,7,,DEN,L 10-45,7,45,5,50,12,95,ARI_DEN_2018-10-18
NYJ,2018-10-14,7,Sun,6,6,,IND,W 42-34,7,49,8,66,15,115,NYJ_IND_2018-10-14
MIA,2018-10-14,7,Sun,6,6,,CHI,W 31-28 (OT),7,67,6,58,13,125,MIA_CHI_2018-10-14
OAK,2018-10-07,7,Sun,5,5,@,LAC,L 10-26,7,55,9,82,16,137,OAK_LAC_2018-10-07
SEA,2018-10-07,7,Sun,5,5,,LAR,L 31-33,7,50,7,45,14,95,SEA_LAR_2018-10-07
LAR,2018-10-07,7,Sun,5,5,@,SEA,W 33-31,7,45,7,50,14,95,LAR_SEA_2018-10-07
ATL,2018-10-07,7,Sun,5,5,@,PIT,L 17-41,7,75,7,58,14,133,ATL_PIT_2018-10-07
PIT,2018-10-07,7,Sun,5,5,,ATL,W 41-17,7,58,7,75,14,133,PIT_ATL_2018-10-07
DAL,2018-10-07,7,Sun,5,5,@,HOU,L 16-19 (OT),7,72,5,25,12,97,DAL_HOU_2018-10-07
NWE,2018-10-04,7,Thu,5,5,,IND,W 38-24,7,50,4,35,11,85,NWE_IND_2018-10-04
BAL,2018-09-30,7,Sun,4,4,@,PIT,W 26-14,7,50,5,40,12,90,BAL_PIT_2018-09-30
HOU,2018-09-23,7,Sun,3,3,,NYG,L 22-27,7,50,3,20,10,70,HOU_NYG_2018-09-23
BAL,2018-09-23,7,Sun,3,3,,DEN,W 27-14,7,52,13,120,20,172,BAL_DEN_2018-09-23
CHI,2018-09-23,7,Sun,3,3,@,ARI,W 16-14,7,45,6,43,13,88,CHI_ARI_2018-09-23
DAL,2018-09-23,7,Sun,3,3,@,SEA,L 13-24,7,55,10,67,17,122,DAL_SEA_2018-09-23
CHI,2018-09-17,7,Mon,2,2,,SEA,W 24-17,7,55,5,37,12,92,CHI_SEA_2018-09-17
WAS,2018-09-16,7,Sun,2,2,,IND,L 9-21,7,90,6,26,13,116,WAS_IND_2018-09-16
GNB,2018-09-16,7,Sun,2,2,,MIN,T 29-29 (OT),7,54,8,70,15,124,GNB_MIN_2018-09-16
NYJ,2018-09-16,7,Sun,2,2,,MIA,L 12-20,7,50,2,10,9,60,NYJ_MIA_2018-09-16
JAX,2018-09-16,7,Sun,2,2,,NWE,W 31-20,7,71,2,25,9,96,JAX_NWE_2018-09-16
CAR,2018-09-16,7,Sun,2,2,@,ATL,L 24-31,7,49,2,26,9,75,CAR_ATL_2018-09-16
BAL,2018-09-13,7,Thu,2,2,@,CIN,L 23-34,7,51,9,92,16,143,BAL_CIN_2018-09-13
NYJ,2018-09-10,7,Mon,1,1,@,DET,W 48-17,7,49,3,15,10,64,NYJ_DET_2018-09-10
SEA,2018-09-09,7,Sun,1,1,@,DEN,L 24-27,7,45,7,60,14,105,SEA_DEN_2018-09-09
MIN,2018-09-09,7,Sun,1,1,,SFO,W 24-16,7,52,3,21,10,73,MIN_SFO_2018-09-09
MIA,2018-09-09,7,Sun,1,1,,TEN,W 27-20,7,51,5,48,12,99,MIA_TEN_2018-09-09
IND,2018-09-09,7,Sun,1,1,,CIN,L 23-34,7,91,8,94,15,185,IND_CIN_2018-09-09
TAM,2018-09-09,7,Sun,1,1,@,NOR,W 48-40,7,70,8,77,15,147,TAM_NOR_2018-09-09
DEN,2018-09-09,7,Sun,1,1,,SEA,W 27-24,7,60,7,45,14,105,DEN_SEA_2018-09-09
LAC,2018-09-09,7,Sun,1,1,,KAN,L 28-38,7,45,6,50,13,95,LAC_KAN_2018-09-09
ATL,2017-12-31,7,Sun,16,17,,CAR,W 22-10,7,60,5,35,12,95,ATL_CAR_2017-12-31
PHI,2017-12-31,7,Sun,16,17,,DAL,L 0-6,7,49,7,64,14,113,PHI_DAL_2017-12-31
HOU,2017-12-31,7,Sun,16,17,@,IND,L 13-22,7,34,4,20,11,54,HOU_IND_2017-12-31
LAC,2017-12-31,7,Sun,16,17,,OAK,W 30-10,7,65,6,85,13,150,LAC_OAK_2017-12-31
DAL,2017-12-31,7,Sun,16,17,@,PHI,W 6-0,7,64,7,49,14,113,DAL_PHI_2017-12-31
NOR,2017-12-31,7,Sun,16,17,@,TAM,L 24-31,7,38,2,15,9,53,NOR_TAM_2017-12-31
HOU,2017-12-25,7,Mon,15,16,,PIT,L 6-34,7,80,4,24,11,104,HOU_PIT_2017-12-25
OAK,2017-12-25,7,Mon,15,16,@,PHI,L 10-19,7,50,8,60,15,110,OAK_PHI_2017-12-25
DAL,2017-12-24,7,Sun,15,16,,SEA,L 12-21,7,75,11,142,18,217,DAL_SEA_2017-12-24
TAM,2017-12-18,7,Mon,14,15,,ATL,L 21-24,7,53,6,60,13,113,TAM_ATL_2017-12-18
BAL,2017-12-17,7,Sun,14,15,@,CLE,W 27-10,7,57,6,35,13,92,BAL_CLE_2017-12-17
PHI,2017-12-17,7,Sun,14,15,@,NYG,W 34-29,7,44,5,67,12,111,PHI_NYG_2017-12-17
DAL,2017-12-17,7,Sun,14,15,@,OAK,W 20-17,7,100,14,105,21,205,DAL_OAK_2017-12-17
MIA,2017-12-17,7,Sun,14,15,@,BUF,L 16-24,7,60,3,28,10,88,MIA_BUF_2017-12-17
WAS,2017-12-17,7,Sun,14,15,,ARI,W 20-15,7,82,8,71,15,153,WAS_ARI_2017-12-17
SFO,2017-12-17,7,Sun,14,15,,TEN,W 25-23,7,70,3,22,10,92,SFO_TEN_2017-12-17
KAN,2017-12-16,7,Sat,14,15,,LAC,W 30-13,7,71,9,61,16,132,KAN_LAC_2017-12-16
JAX,2017-12-10,7,Sun,13,14,,SEA,W 30-24,7,48,6,73,13,121,JAX_SEA_2017-12-10
NYG,2017-12-10,7,Sun,13,14,,DAL,L 10-30,7,69,8,51,15,120,NYG_DAL_2017-12-10
OAK,2017-12-10,7,Sun,13,14,@,KAN,L 15-26,7,39,7,69,14,108,OAK_KAN_2017-12-10
TAM,2017-12-10,7,Sun,13,14,,DET,L 21-24,7,65,8,105,15,170,TAM_DET_2017-12-10
KAN,2017-12-10,7,Sun,13,14,,OAK,W 26-15,7,69,7,39,14,108,KAN_OAK_2017-12-10
LAR,2017-12-10,7,Sun,13,14,,PHI,L 35-43,7,102,10,67,17,169,LAR_PHI_2017-12-10
CIN,2017-12-10,7,Sun,13,14,,CHI,L 7-33,7,56,10,74,17,130,CIN_CHI_2017-12-10
PIT,2017-12-04,7,Mon,12,13,@,CIN,W 23-20,7,66,13,173,20,239,PIT_CIN_2017-12-04
PHI,2017-12-03,7,Sun,12,13,@,SEA,L 10-24,7,64,5,46,12,110,PHI_SEA_2017-12-03
NOR,2017-12-03,7,Sun,12,13,,CAR,W 31-21,7,68,6,54,13,122,NOR_CAR_2017-12-03
TEN,2017-12-03,7,Sun,12,13,,HOU,W 24-13,7,63,11,85,18,148,TEN_HOU_2017-12-03
ATL,2017-12-03,7,Sun,12,13,,MIN,L 9-14,7,55,6,51,13,106,ATL_MIN_2017-12-03
GNB,2017-12-03,7,Sun,12,13,,TAM,W 26-20 (OT),7,47,8,74,15,121,GNB_TAM_2017-12-03
MIA,2017-12-03,7,Sun,12,13,,DEN,W 35-9,7,85,9,57,16,142,MIA_DEN_2017-12-03
LAR,2017-12-03,7,Sun,12,13,@,ARI,W 32-16,7,36,4,25,11,61,LAR_ARI_2017-12-03
WAS,2017-11-30,7,Thu,12,13,@,DAL,L 14-38,7,43,3,25,10,68,WAS_DAL_2017-11-30
BAL,2017-11-27,7,Mon,11,12,,HOU,W 23-16,7,89,6,36,13,125,BAL_HOU_2017-11-27
CLE,2017-11-26,7,Sun,11,12,@,CIN,L 16-30,7,69,4,35,11,104,CLE_CIN_2017-11-26
NOR,2017-11-26,7,Sun,11,12,@,LAR,L 20-26,7,112,9,90,16,202,NOR_LAR_2017-11-26
SFO,2017-11-26,7,Sun,11,12,,SEA,L 13-24,7,74,6,35,13,109,SFO_SEA_2017-11-26
NYJ,2017-11-26,7,Sun,11,12,,CAR,L 27-35,7,68,10,84,17,152,NYJ_CAR_2017-11-26
OAK,2017-11-26,7,Sun,11,12,,DEN,W 21-14,7,68,9,75,16,143,OAK_DEN_2017-11-26
NWE,2017-11-26,7,Sun,11,12,,MIA,W 35-17,7,70,6,52,13,122,NWE_MIA_2017-11-26
DAL,2017-11-23,7,Thu,11,12,,LAC,L 6-28,7,60,5,56,12,116,DAL_LAC_2017-11-23
ATL,2017-11-20,7,Mon,10,11,@,SEA,W 34-31,7,69,9,106,16,175,ATL_SEA_2017-11-20
MIN,2017-11-19,7,Sun,10,11,,LAR,W 24-7,7,65,8,60,15,125,MIN_LAR_2017-11-19
NOR,2017-11-19,7,Sun,10,11,,WAS,W 34-31 (OT),7,54,9,67,16,121,NOR_WAS_2017-11-19
PIT,2017-11-16,7,Thu,10,11,,TEN,W 40-17,7,61,9,65,16,126,PIT_TEN_2017-11-16
MIA,2017-11-13,7,Mon,9,10,@,CAR,L 21-45,7,57,6,37,13,94,MIA_CAR_2017-11-13
DET,2017-11-12,7,Sun,9,10,,CLE,W 38-24,7,81,7,60,14,141,DET_CLE_2017-11-12
LAC,2017-11-12,7,Sun,9,10,@,JAX,L 17-20 (OT),7,77,9,106,16,183,LAC_JAX_2017-11-12
CLE,2017-11-12,7,Sun,9,10,@,DET,L 24-38,7,60,7,81,14,141,CLE_DET_2017-11-12
TAM,2017-11-05,7,Sun,8,9,@,NOR,L 10-30,7,50,4,28,11,78,TAM_NOR_2017-11-05
WAS,2017-11-05,7,Sun,8,9,@,SEA,W 17-14,7,62,16,138,23,200,WAS_SEA_2017-11-05
HOU,2017-11-05,7,Sun,8,9,,IND,L 14-20,7,74,6,68,13,142,HOU_IND_2017-11-05
DEN,2017-10-30,7,Mon,7,8,@,KAN,L 19-29,7,53,7,69,14,122,DEN_KAN_2017-10-30
KAN,2017-10-30,7,Mon,8,8,,DEN,W 29-19,7,69,7,53,14,122,KAN_DEN_2017-10-30
IND,2017-10-29,7,Sun,8,8,@,CIN,L 23-24,7,45,5,54,12,99,IND_CIN_2017-10-29
NOR,2017-10-29,7,Sun,7,8,,CHI,W 20-12,7,51,4,31,11,82,NOR_CHI_2017-10-29
MIA,2017-10-26,7,Thu,7,8,@,BAL,L 0-40,7,43,5,40,12,83,MIA_BAL_2017-10-26
NYG,2017-10-22,7,Sun,7,7,,SEA,L 7-24,7,28,15,110,22,138,NYG_SEA_2017-10-22
NOR,2017-10-22,7,Sun,6,7,@,GNB,W 26-17,7,80,8,54,15,134,NOR_GNB_2017-10-22
DET,2017-10-15,7,Sun,6,6,@,NOR,L 38-52,7,46,13,118,20,164,DET_NOR_2017-10-15
KAN,2017-10-15,7,Sun,6,6,,PIT,L 13-19,7,48,6,57,13,105,KAN_PIT_2017-10-15
LAR,2017-10-15,7,Sun,6,6,@,JAX,W 27-17,7,70,5,40,12,110,LAR_JAX_2017-10-15
SFO,2017-10-15,7,Sun,6,6,@,WAS,L 24-26,7,40,5,43,12,83,SFO_WAS_2017-10-15
ARI,2017-10-15,7,Sun,6,6,,TAM,W 38-33,7,61,9,49,16,110,ARI_TAM_2017-10-15
MIN,2017-10-15,7,Sun,6,6,,GNB,W 23-10,7,65,8,92,15,157,MIN_GNB_2017-10-15
SEA,2017-10-08,7,Sun,5,5,@,LAR,W 16-10,7,40,5,45,12,85,SEA_LAR_2017-10-08
HOU,2017-10-08,7,Sun,5,5,,KAN,L 34-42,7,59,6,64,13,123,HOU_KAN_2017-10-08
ARI,2017-10-08,7,Sun,5,5,@,PHI,L 7-34,7,61,5,60,12,121,ARI_PHI_2017-10-08
DAL,2017-10-08,7,Sun,5,5,,GNB,L 31-35,7,70,6,38,13,108,DAL_GNB_2017-10-08
IND,2017-10-08,7,Sun,5,5,,SFO,W 26-23 (OT),7,62,10,77,17,139,IND_SFO_2017-10-08
WAS,2017-10-02,7,Mon,4,4,@,KAN,L 20-29,7,44,3,15,10,59,WAS_KAN_2017-10-02
NWE,2017-10-01,7,Sun,4,4,,CAR,L 30-33,7,55,1,33,8,88,NWE_CAR_2017-10-01
LAR,2017-10-01,7,Sun,4,4,@,DAL,W 35-30,7,41,4,45,11,86,LAR_DAL_2017-10-01
OAK,2017-10-01,7,Sun,4,4,@,DEN,L 10-16,7,75,6,40,13,115,OAK_DEN_2017-10-01
GNB,2017-09-28,7,Thu,4,4,,CHI,W 35-14,7,55,8,62,15,117,GNB_CHI_2017-09-28
TAM,2017-09-24,7,Sun,2,3,@,MIN,L 17-34,7,37,5,53,12,90,TAM_MIN_2017-09-24
CIN,2017-09-24,7,Sun,3,3,@,GNB,L 24-27 (OT),7,68,4,33,11,101,CIN_GNB_2017-09-24
LAR,2017-09-21,7,Thu,3,3,@,SFO,W 41-39,7,52,10,55,17,107,LAR_SFO_2017-09-21
NYG,2017-09-18,7,Mon,2,2,,DET,L 10-24,7,50,6,50,13,100,NYG_DET_2017-09-18
BAL,2017-09-17,7,Sun,2,2,,CLE,W 24-10,7,45,11,65,18,110,BAL_CLE_2017-09-17
TEN,2017-09-17,7,Sun,2,2,@,JAX,W 37-16,7,70,10,99,17,169,TEN_JAX_2017-09-17
LAR,2017-09-17,7,Sun,2,2,,WAS,L 20-27,7,75,4,25,11,100,LAR_WAS_2017-09-17
CIN,2017-09-14,7,Thu,2,2,,HOU,L 9-13,7,45,9,61,16,106,CIN_HOU_2017-09-14
LAR,2017-09-10,7,Sun,1,1,,IND,W 46-9,7,50,4,20,11,70,LAR_IND_2017-09-10
NYJ,2023-01-08,6,Sun,17,18,@,MIA,L 6-11,6,54,5,47,11,101,NYJ_MIA_2023-01-08
DAL,2023-01-08,6,Sun,17,18,@,WAS,L 6-26,6,74,2,10,8,84,DAL_WAS_2023-01-08
TEN,2023-01-07,6,Sat,17,18,@,JAX,L 16-20,6,40,4,25,10,65,TEN_JAX_2023-01-07
LVR,2023-01-07,6,Sat,17,18,,KAN,L 13-31,6,47,5,43,11,90,LVR_KAN_2023-01-07
NWE,2023-01-01,6,Sun,16,17,,MIA,W 23-21,6,39,9,71,15,110,NWE_MIA_2023-01-01
MIN,2023-01-01,6,Sun,16,17,@,GNB,L 17-41,6,35,3,30,9,65,MIN_GNB_2023-01-01
LVR,2023-01-01,6,Sun,16,17,,SFO,L 34-37 (OT),6,49,9,71,15,120,LVR_SFO_2023-01-01
DET,2023-01-01,6,Sun,16,17,,CHI,W 41-10,6,42,3,49,9,91,DET_CHI_2023-01-01
PIT,2023-01-01,6,Sun,16,17,@,BAL,W 16-13,6,43,4,30,10,73,PIT_BAL_2023-01-01
LAC,2022-12-26,6,Mon,15,16,@,IND,W 20-3,6,60,2,11,8,71,LAC_IND_2022-12-26
ARI,2022-12-25,6,Sun,15,16,,TAM,L 16-19 (OT),6,74,5,30,11,104,ARI_TAM_2022-12-25
DEN,2022-12-25,6,Sun,15,16,@,LAR,L 14-51,6,55,3,6,9,61,DEN_LAR_2022-12-25
WAS,2022-12-24,6,Sat,15,16,@,SFO,L 20-37,6,51,4,25,10,76,WAS_SFO_2022-12-24
SEA,2022-12-24,6,Sat,15,16,@,KAN,L 10-24,6,35,5,39,11,74,SEA_KAN_2022-12-24
NOR,2022-12-18,6,Sun,14,15,,ATL,W 21-18,6,46,3,30,9,76,NOR_ATL_2022-12-18
WAS,2022-12-18,6,Sun,14,15,,NYG,L 12-20,6,40,5,30,11,70,WAS_NYG_2022-12-18
TEN,2022-12-18,6,Sun,14,15,@,LAC,L 14-17,6,62,3,20,9,82,TEN_LAC_2022-12-18
NWE,2022-12-18,6,Sun,14,15,@,LVR,L 24-30,6,30,13,90,19,120,NWE_LVR_2022-12-18
CHI,2022-12-18,6,Sun,14,15,,PHI,L 20-25,6,30,2,25,8,55,CHI_PHI_2022-12-18
DET,2022-12-18,6,Sun,14,15,@,NYJ,W 20-17,6,52,2,20,8,72,DET_NYJ_2022-12-18
LAC,2022-12-11,6,Sun,13,14,,MIA,W 23-17,6,40,6,50,12,90,LAC_MIA_2022-12-11
CAR,2022-12-11,6,Sun,13,14,@,SEA,W 30-24,6,29,3,35,9,64,CAR_SEA_2022-12-11
DEN,2022-12-11,6,Sun,13,14,,KAN,L 28-34,6,38,4,70,10,108,DEN_KAN_2022-12-11
MIA,2022-12-11,6,Sun,13,14,@,LAC,L 17-23,6,50,6,40,12,90,MIA_LAC_2022-12-11
NOR,2022-12-05,6,Mon,13,13,@,TAM,L 16-17,6,84,4,39,10,123,NOR_TAM_2022-12-05
SEA,2022-12-04,6,Sun,12,13,@,LAR,W 27-23,6,42,4,39,10,81,SEA_LAR_2022-12-04
ATL,2022-12-04,6,Sun,13,13,,PIT,L 16-19,6,48,7,30,13,78,ATL_PIT_2022-12-04
CLE,2022-12-04,6,Sun,12,13,@,HOU,W 27-14,6,56,5,31,11,87,CLE_HOU_2022-12-04
IND,2022-12-04,6,Sun,13,13,@,DAL,L 19-54,6,88,3,43,9,131,IND_DAL_2022-12-04
CIN,2022-12-04,6,Sun,12,13,,KAN,W 27-24,6,65,4,35,10,100,CIN_KAN_2022-12-04
NYJ,2022-12-04,6,Sun,12,13,@,MIN,L 22-27,6,40,3,44,9,84,NYJ_MIN_2022-12-04
NWE,2022-12-01,6,Thu,12,13,,BUF,L 10-24,6,62,6,47,12,109,NWE_BUF_2022-12-01
BUF,2022-12-01,6,Thu,12,13,@,NWE,W 24-10,6,47,6,62,12,109,BUF_NWE_2022-12-01
NOR,2022-11-27,6,Sun,12,12,@,SFO,L 0-13,6,46,7,64,13,110,NOR_SFO_2022-11-27
NWE,2022-11-24,6,Thu,11,12,@,MIN,L 26-33,6,55,3,20,9,75,NWE_MIN_2022-11-24
CLE,2022-11-20,6,Sun,10,11,@,BUF,L 23-31,6,42,8,89,14,131,CLE_BUF_2022-11-20
LAR,2022-11-20,6,Sun,10,11,@,NOR,L 20-27,6,55,2,15,8,70,LAR_NOR_2022-11-20
CIN,2022-11-20,6,Sun,10,11,@,PIT,W 37-30,6,44,8,70,14,114,CIN_PIT_2022-11-20
DAL,2022-11-20,6,Sun,10,11,@,MIN,W 40-3,6,39,7,59,13,98,DAL_MIN_2022-11-20
SEA,2022-11-13,6,Sun,10,10,@,TAM,L 16-21,6,46,4,40,10,86,SEA_TAM_2022-11-13
CLE,2022-11-13,6,Sun,9,10,@,MIA,L 17-39,6,52,5,43,11,95,CLE_MIA_2022-11-13
GNB,2022-11-13,6,Sun,10,10,,DAL,W 31-28 (OT),6,40,9,83,15,123,GNB_DAL_2022-11-13
SEA,2022-11-06,6,Sun,9,9,@,ARI,W 31-21,6,34,12,77,18,111,SEA_ARI_2022-11-06
CLE,2022-10-31,6,Mon,8,8,,CIN,W 32-13,6,56,2,6,8,62,CLE_CIN_2022-10-31
DET,2022-10-30,6,Sun,7,8,,MIA,L 27-31,6,30,7,55,13,85,DET_MIA_2022-10-30
DAL,2022-10-30,6,Sun,8,8,,CHI,W 49-29,6,41,6,45,12,86,DAL_CHI_2022-10-30
HOU,2022-10-30,6,Sun,7,8,,TEN,L 10-17,6,45,6,35,12,80,HOU_TEN_2022-10-30
LVR,2022-10-30,6,Sun,7,8,@,NOR,L 0-24,6,59,5,27,11,86,LVR_NOR_2022-10-30
NYG,2022-10-30,6,Sun,8,8,@,SEA,L 13-27,6,53,3,25,9,78,NYG_SEA_2022-10-30
TEN,2022-10-30,6,Sun,7,8,@,HOU,W 17-10,6,35,6,45,12,80,TEN_HOU_2022-10-30
CHI,2022-10-30,6,Sun,8,8,@,DAL,L 29-49,6,45,6,41,12,86,CHI_DAL_2022-10-30
NWE,2022-10-30,6,Sun,8,8,@,NYJ,W 22-17,6,54,4,41,10,95,NWE_NYJ_2022-10-30
CLE,2022-10-23,6,Sun,7,7,@,BAL,L 20-23,6,45,3,53,9,98,CLE_BAL_2022-10-23
SEA,2022-10-16,6,Sun,6,6,,ARI,W 19-9,6,44,6,53,12,97,SEA_ARI_2022-10-16
ARI,2022-10-16,6,Sun,6,6,@,SEA,L 9-19,6,53,6,44,12,97,ARI_SEA_2022-10-16
TAM,2022-10-16,6,Sun,6,6,@,PIT,L 18-20,6,42,7,45,13,87,TAM_PIT_2022-10-16
ATL,2022-10-09,6,Sun,5,5,@,TAM,L 15-21,6,55,6,45,12,100,ATL_TAM_2022-10-09
PIT,2022-10-09,6,Sun,5,5,@,BUF,L 3-38,6,54,5,28,11,82,PIT_BUF_2022-10-09
NYG,2022-10-09,6,Sun,5,5,@,GNB,W 27-22,6,63,7,37,13,100,NYG_GNB_2022-10-09
BAL,2022-10-09,6,Sun,5,5,,CIN,W 19-17,6,48,4,20,10,68,BAL_CIN_2022-10-09
NOR,2022-10-09,6,Sun,5,5,,SEA,W 39-32,6,57,12,85,18,142,NOR_SEA_2022-10-09
TAM,2022-10-09,6,Sun,5,5,,ATL,W 21-15,6,45,6,55,12,100,TAM_ATL_2022-10-09
CHI,2022-10-09,6,Sun,5,5,@,MIN,L 22-29,6,40,7,70,13,110,CHI_MIN_2022-10-09
CLE,2022-10-09,6,Sun,5,5,,LAC,L 28-30,6,65,4,17,10,82,CLE_LAC_2022-10-09
NOR,2022-10-09,6,Sun,5,5,,SEA,W 39-32,6,57,12,85,18,142,NOR_SEA_2022-10-09
ATL,2022-10-09,6,Sun,5,5,@,TAM,L 15-21,6,55,6,45,12,100,ATL_TAM_2022-10-09
TEN,2022-10-02,6,Sun,4,4,@,IND,W 24-17,6,40,7,50,13,90,TEN_IND_2022-10-02
CAR,2022-10-02,6,Sun,4,4,,ARI,L 16-26,6,76,7,61,13,137,CAR_ARI_2022-10-02
LAC,2022-10-02,6,Sun,4,4,@,HOU,W 34-24,6,61,9,67,15,128,LAC_HOU_2022-10-02
MIA,2022-09-29,6,Thu,4,4,@,CIN,L 15-27,6,41,6,74,12,115,MIA_CIN_2022-09-29
CIN,2022-09-29,6,Thu,4,4,,MIA,W 27-15,6,74,6,41,12,115,CIN_MIA_2022-09-29
SEA,2022-09-25,6,Sun,3,3,,ATL,L 23-27,6,47,2,15,8,62,SEA_ATL_2022-09-25
KAN,2022-09-25,6,Sun,3,3,@,IND,L 17-20,6,45,4,34,10,79,KAN_IND_2022-09-25
LAR,2022-09-25,6,Sun,3,3,@,ARI,W 20-12,6,35,6,50,12,85,LAR_ARI_2022-09-25
TAM,2022-09-25,6,Sun,3,3,,GNB,L 12-14,6,40,8,65,14,105,TAM_GNB_2022-09-25
CHI,2022-09-25,6,Sun,3,3,,HOU,W 23-20,6,32,3,25,9,57,CHI_HOU_2022-09-25
LVR,2022-09-25,6,Sun,3,3,@,TEN,L 22-24,6,44,7,85,13,129,LVR_TEN_2022-09-25
ARI,2022-09-25,6,Sun,3,3,,LAR,L 12-20,6,50,6,35,12,85,ARI_LAR_2022-09-25
KAN,2022-09-15,6,Thu,2,2,,LAC,W 27-24,6,54,3,25,9,79,KAN_LAC_2022-09-15
HOU,2022-09-11,6,Sun,1,1,,IND,T 20-20 (OT),6,40,7,89,13,129,HOU_IND_2022-09-11
WAS,2022-09-11,6,Sun,1,1,,JAX,W 28-22,6,63,13,90,19,153,WAS_JAX_2022-09-11
NYJ,2022-09-11,6,Sun,1,1,,BAL,L 9-24,6,81,5,29,11,110,NYJ_BAL_2022-09-11
SFO,2022-01-09,6,Sun,17,18,@,LAR,W 27-24 (OT),6,56,3,15,9,71,SFO_LAR_2022-01-09
PIT,2022-01-09,6,Sun,17,18,@,BAL,W 16-13 (OT),6,43,1,5,7,48,PIT_BAL_2022-01-09
ARI,2022-01-09,6,Sun,17,18,,SEA,L 30-38,6,46,4,30,10,76,ARI_SEA_2022-01-09
JAX,2022-01-09,6,Sun,17,18,,IND,W 26-11,6,49,4,52,10,101,JAX_IND_2022-01-09
DEN,2022-01-08,6,Sat,17,18,,KAN,L 24-28,6,45,5,45,11,90,DEN_KAN_2022-01-08
LVR,2022-01-02,6,Sun,16,17,@,IND,W 23-20,6,41,3,25,9,66,LVR_IND_2022-01-02
TEN,2022-01-02,6,Sun,16,17,,MIA,W 34-3,6,70,5,55,11,125,TEN_MIA_2022-01-02
PHI,2022-01-02,6,Sun,16,17,@,WAS,W 20-16,6,42,1,4,7,46,PHI_WAS_2022-01-02
NYG,2021-12-26,6,Sun,15,16,@,PHI,L 10-34,6,40,11,79,17,119,NYG_PHI_2021-12-26
CAR,2021-12-26,6,Sun,15,16,,TAM,L 6-32,6,32,6,50,12,82,CAR_TAM_2021-12-26
DET,2021-12-26,6,Sun,15,16,@,ATL,L 16-20,6,30,2,15,8,45,DET_ATL_2021-12-26
TAM,2021-12-26,6,Sun,15,16,@,CAR,W 32-6,6,50,6,32,12,82,TAM_CAR_2021-12-26
BAL,2021-12-26,6,Sun,15,16,@,CIN,L 21-41,6,27,5,45,11,72,BAL_CIN_2021-12-26
CLE,2021-12-25,6,Sat,15,16,@,GNB,L 22-24,6,38,3,29,9,67,CLE_GNB_2021-12-25
TEN,2021-12-23,6,Thu,15,16,,SFO,W 20-17,6,57,5,41,11,98,TEN_SFO_2021-12-23
NOR,2021-12-19,6,Sun,14,15,@,TAM,W 9-0,6,41,3,30,9,71,NOR_TAM_2021-12-19
DEN,2021-12-19,6,Sun,14,15,,CIN,L 10-15,6,60,6,38,12,98,DEN_CIN_2021-12-19
DET,2021-12-19,6,Sun,14,15,,ARI,W 30-12,6,49,7,83,13,132,DET_ARI_2021-12-19
NYG,2021-12-19,6,Sun,14,15,,DAL,L 6-21,6,34,6,45,12,79,NYG_DAL_2021-12-19
CIN,2021-12-19,6,Sun,14,15,@,DEN,W 15-10,6,38,6,60,12,98,CIN_DEN_2021-12-19
DAL,2021-12-19,6,Sun,14,15,@,NYG,W 21-6,6,45,6,34,12,79,DAL_NYG_2021-12-19
CAR,2021-12-12,6,Sun,13,14,,ATL,L 21-29,6,45,6,60,12,105,CAR_ATL_2021-12-12
ATL,2021-12-12,6,Sun,13,14,@,CAR,W 29-21,6,60,6,45,12,105,ATL_CAR_2021-12-12
SFO,2021-12-12,6,Sun,13,14,@,CIN,W 26-23 (OT),6,40,2,19,8,59,SFO_CIN_2021-12-12
DET,2021-12-12,6,Sun,13,14,@,DEN,L 10-38,6,53,2,18,8,71,DET_DEN_2021-12-12
LAC,2021-12-12,6,Sun,13,14,,NYG,W 37-21,6,39,3,20,9,59,LAC_NYG_2021-12-12
HOU,2021-12-12,6,Sun,13,14,,SEA,L 13-33,6,52,8,69,14,121,HOU_SEA_2021-12-12
NWE,2021-12-06,6,Mon,13,13,@,BUF,W 14-10,6,47,3,20,9,67,NWE_BUF_2021-12-06
CHI,2021-12-05,6,Sun,12,13,,ARI,L 22-33,6,45,8,63,14,108,CHI_ARI_2021-12-05
NYJ,2021-12-05,6,Sun,12,13,,PHI,L 18-33,6,66,3,20,9,86,NYJ_PHI_2021-12-05
WAS,2021-12-05,6,Sun,12,13,@,LVR,W 17-15,6,47,6,54,12,101,WAS_LVR_2021-12-05
SEA,2021-12-05,6,Sun,12,13,,SFO,W 30-23,6,40,10,86,16,126,SEA_SFO_2021-12-05
ATL,2021-12-05,6,Sun,12,13,,TAM,L 17-30,6,39,3,15,9,54,ATL_TAM_2021-12-05
LVR,2021-12-05,6,Sun,12,13,,WAS,L 15-17,6,54,6,47,12,101,LVR_WAS_2021-12-05
SEA,2021-11-29,6,Mon,11,12,@,WAS,L 15-17,6,51,4,38,10,89,SEA_WAS_2021-11-29
IND,2021-11-28,6,Sun,12,12,,TAM,L 31-38,6,66,4,44,10,110,IND_TAM_2021-11-28
JAX,2021-11-28,6,Sun,11,12,,ATL,L 14-21,6,43,5,26,11,69,JAX_ATL_2021-11-28
TAM,2021-11-22,6,Mon,10,11,,NYG,W 30-10,6,39,4,30,10,69,TAM_NYG_2021-11-22
BAL,2021-11-21,6,Sun,10,11,@,CHI,W 16-13,6,36,6,58,12,94,BAL_CHI_2021-11-21
KAN,2021-11-21,6,Sun,11,11,,DAL,W 19-9,6,64,6,45,12,109,KAN_DAL_2021-11-21
DAL,2021-11-21,6,Sun,10,11,@,KAN,L 9-19,6,45,6,64,12,109,DAL_KAN_2021-11-21
PHI,2021-11-21,6,Sun,11,11,,NOR,W 40-29,6,49,3,25,9,74,PHI_NOR_2021-11-21
CHI,2021-11-21,6,Sun,10,11,,BAL,L 13-16,6,58,6,36,12,94,CHI_BAL_2021-11-21
TAM,2021-11-14,6,Sun,9,10,@,WAS,L 19-29,6,43,3,33,9,76,TAM_WAS_2021-11-14
NWE,2021-11-14,6,Sun,10,10,,CLE,W 45-7,6,46,6,42,12,88,NWE_CLE_2021-11-14
ATL,2021-11-14,6,Sun,9,10,@,DAL,L 3-43,6,41,8,80,14,121,ATL_DAL_2021-11-14
CLE,2021-11-14,6,Sun,10,10,@,NWE,L 7-45,6,42,6,46,12,88,CLE_NWE_2021-11-14
NWE,2021-11-07,6,Sun,9,9,@,CAR,W 24-6,6,35,10,83,16,118,NWE_CAR_2021-11-07
KAN,2021-11-07,6,Sun,9,9,,GNB,W 13-7,6,33,4,19,10,52,KAN_GNB_2021-11-07
ATL,2021-11-07,6,Sun,8,9,@,NOR,W 27-25,6,76,10,74,16,150,ATL_NOR_2021-11-07
LVR,2021-11-07,6,Sun,8,9,@,NYG,L 16-23,6,65,4,35,10,100,LVR_NYG_2021-11-07
HOU,2021-10-31,6,Sun,8,8,,LAR,L 22-38,6,38,3,20,9,58,HOU_LAR_2021-10-31
SEA,2021-10-25,6,Mon,7,7,,NOR,L 10-13,6,53,7,90,13,143,SEA_NOR_2021-10-25
MIA,2021-10-24,6,Sun,7,7,,ATL,L 28-30,6,44,3,29,9,73,MIA_ATL_2021-10-24
TEN,2021-10-24,6,Sun,7,7,,KAN,W 27-3,6,31,9,77,15,108,TEN_KAN_2021-10-24
NWE,2021-10-24,6,Sun,7,7,,NYJ,W 54-13,6,95,5,29,11,124,NWE_NYJ_2021-10-24
IND,2021-10-24,6,Sun,7,7,@,SFO,W 30-18,6,45,7,122,13,167,IND_SFO_2021-10-24
SEA,2021-10-17,6,Sun,6,6,@,PIT,L 20-23 (OT),6,45,5,38,11,83,SEA_PIT_2021-10-17
DEN,2021-10-17,6,Sun,6,6,,LVR,L 24-34,6,53,6,54,12,107,DEN_LVR_2021-10-17
LVR,2021-10-17,6,Sun,6,6,@,DEN,W 34-24,6,54,6,53,12,107,LVR_DEN_2021-10-17
WAS,2021-10-17,6,Sun,6,6,,KAN,L 13-31,6,44,5,47,11,91,WAS_KAN_2021-10-17
CAR,2021-10-17,6,Sun,6,6,,MIN,L 28-34 (OT),6,28,11,98,17,126,CAR_MIN_2021-10-17
PHI,2021-10-10,6,Sun,5,5,@,CAR,W 21-18,6,60,9,69,15,129,PHI_CAR_2021-10-10
LAC,2021-10-10,6,Sun,5,5,,CLE,W 47-42,6,49,7,77,13,126,LAC_CLE_2021-10-10
TAM,2021-10-10,6,Sun,5,5,,MIA,W 45-17,6,47,5,37,11,84,TAM_MIA_2021-10-10
ARI,2021-10-10,6,Sun,5,5,,SFO,W 17-10,6,62,7,60,13,122,ARI_SFO_2021-10-10
NOR,2021-10-10,6,Sun,5,5,@,WAS,W 33-22,6,45,5,37,11,82,NOR_WAS_2021-10-10
NYJ,2021-10-03,6,Sun,4,4,,TEN,W 27-24 (OT),6,65,8,98,14,163,NYJ_TEN_2021-10-03
WAS,2021-10-03,6,Sun,4,4,@,ATL,W 34-30,6,85,7,36,13,121,WAS_ATL_2021-10-03
CAR,2021-10-03,6,Sun,4,4,@,DAL,L 28-36,6,32,7,50,13,82,CAR_DAL_2021-10-03
BAL,2021-10-03,6,Sun,4,4,@,DEN,W 23-7,6,55,4,25,10,80,BAL_DEN_2021-10-03
CIN,2021-09-30,6,Thu,4,4,,JAX,W 24-21,6,38,2,10,8,48,CIN_JAX_2021-09-30
BAL,2021-09-26,6,Sun,3,3,@,DET,W 19-17,6,69,7,35,13,104,BAL_DET_2021-09-26
DEN,2021-09-26,6,Sun,3,3,,NYJ,W 26-0,6,50,9,90,15,140,DEN_NYJ_2021-09-26
KAN,2021-09-26,6,Sun,3,3,,LAC,L 24-30,6,56,8,50,14,106,KAN_LAC_2021-09-26
ATL,2021-09-19,6,Sun,2,2,@,TAM,L 25-48,6,49,9,83,15,132,ATL_TAM_2021-09-19
BUF,2021-09-19,6,Sun,2,2,@,MIA,W 35-0,6,53,9,83,15,136,BUF_MIA_2021-09-19
NWE,2021-09-19,6,Sun,2,2,@,NYJ,W 25-6,6,54,8,77,14,131,NWE_NYJ_2021-09-19
NOR,2021-09-12,6,Sun,1,1,,GNB,W 38-3,6,36,5,33,11,69,NOR_GNB_2021-09-12
CAR,2021-09-12,6,Sun,1,1,,NYJ,W 19-14,6,38,5,30,11,68,CAR_NYJ_2021-09-12
LAC,2021-09-12,6,Sun,1,1,@,WAS,W 20-16,6,94,8,57,14,151,LAC_WAS_2021-09-12
BAL,2021-01-03,6,Sun,16,17,@,CIN,W 38-3,6,49,3,29,9,78,BAL_CIN_2021-01-03
NYG,2021-01-03,6,Sun,16,17,,DAL,W 23-19,6,45,6,58,12,103,NYG_DAL_2021-01-03
TEN,2021-01-03,6,Sun,16,17,@,HOU,W 41-38,6,50,6,44,12,94,TEN_HOU_2021-01-03
DAL,2021-01-03,6,Sun,16,17,@,NYG,L 19-23,6,58,6,45,12,103,DAL_NYG_2021-01-03
NWE,2021-01-03,6,Sun,16,17,,NYJ,W 28-14,6,47,3,30,9,77,NWE_NYJ_2021-01-03
HOU,2021-01-03,6,Sun,16,17,,TEN,L 38-41,6,44,6,50,12,94,HOU_TEN_2021-01-03
ARI,2021-01-03,6,Sun,16,17,@,LAR,L 7-18,6,38,5,38,11,76,ARI_LAR_2021-01-03
PHI,2021-01-03,6,Sun,16,17,,WAS,L 14-20,6,41,5,56,11,97,PHI_WAS_2021-01-03
KAN,2020-12-27,6,Sun,15,16,,ATL,W 17-14,6,41,7,45,13,86,KAN_ATL_2020-12-27
HOU,2020-12-27,6,Sun,15,16,,CIN,L 31-37,6,46,5,35,11,81,HOU_CIN_2020-12-27
PIT,2020-12-27,6,Sun,15,16,,IND,W 28-24,6,49,9,83,15,132,PIT_IND_2020-12-27
LAC,2020-12-27,6,Sun,15,16,,DEN,W 19-16,6,45,6,44,12,89,LAC_DEN_2020-12-27
CLE,2020-12-27,6,Sun,15,16,@,NYJ,L 16-23,6,51,7,58,13,109,CLE_NYJ_2020-12-27
DEN,2020-12-27,6,Sun,15,16,@,LAC,L 16-19,6,44,6,45,12,89,DEN_LAC_2020-12-27
CLE,2020-12-20,6,Sun,14,15,@,NYG,W 20-6,6,60,2,25,8,85,CLE_NYG_2020-12-20
NYJ,2020-12-20,6,Sun,14,15,@,LAR,W 23-20,6,61,5,43,11,104,NYJ_LAR_2020-12-20
WAS,2020-12-20,6,Sun,14,15,,SEA,L 15-20,6,41,4,45,10,86,WAS_SEA_2020-12-20
LVR,2020-12-17,6,Thu,14,15,,LAC,L 27-30 (OT),6,69,3,20,9,89,LVR_LAC_2020-12-17
LAC,2020-12-13,6,Sun,13,14,,ATL,W 20-17,6,40,4,35,10,75,LAC_ATL_2020-12-13
HOU,2020-12-13,6,Sun,13,14,@,CHI,L 7-36,6,50,7,44,13,94,HOU_CHI_2020-12-13
LVR,2020-12-13,6,Sun,13,14,,IND,L 27-44,6,33,6,50,12,83,LVR_IND_2020-12-13
PHI,2020-12-13,6,Sun,13,14,,NOR,W 24-21,6,27,8,52,14,79,PHI_NOR_2020-12-13
IND,2020-12-13,6,Sun,13,14,@,LVR,W 44-27,6,50,6,33,12,83,IND_LVR_2020-12-13
PIT,2020-12-07,6,Mon,12,13,,WAS,L 17-23,6,45,9,62,15,107,PIT_WAS_2020-12-07
LAR,2020-12-06,6,Sun,12,13,@,ARI,W 38-28,6,75,5,21,11,96,LAR_ARI_2020-12-06
MIN,2020-12-06,6,Sun,12,13,,JAX,W 27-24 (OT),6,41,10,83,16,124,MIN_JAX_2020-12-06
CIN,2020-12-06,6,Sun,12,13,@,MIA,L 7-19,6,62,8,54,14,116,CIN_MIA_2020-12-06
SEA,2020-12-06,6,Sun,12,13,,NYG,L 12-17,6,41,6,35,12,76,SEA_NYG_2020-12-06
NYJ,2020-12-06,6,Sun,12,13,,LVR,L 28-31,6,40,3,21,9,61,NYJ_LVR_2020-12-06
NYG,2020-12-06,6,Sun,12,13,@,SEA,W 17-12,6,35,6,41,12,76,NYG_SEA_2020-12-06
NWE,2020-11-29,6,Sun,11,12,,ARI,W 20-17,6,42,6,50,12,92,NWE_ARI_2020-11-29
CLE,2020-11-29,6,Sun,11,12,@,JAX,W 27-25,6,47,5,24,11,71,CLE_JAX_2020-11-29
NYJ,2020-11-29,6,Sun,11,12,,MIA,L 3-20,6,74,3,20,9,94,NYJ_MIA_2020-11-29
ARI,2020-11-29,6,Sun,11,12,@,NWE,L 17-20,6,50,6,42,12,92,ARI_NWE_2020-11-29
IND,2020-11-29,6,Sun,11,12,,TEN,L 26-45,6,50,9,63,15,113,IND_TEN_2020-11-29
ATL,2020-11-29,6,Sun,11,12,,LVR,W 43-6,6,49,11,141,17,190,ATL_LVR_2020-11-29
WAS,2020-11-22,6,Sun,10,11,,CIN,W 20-9,6,49,3,31,9,80,WAS_CIN_2020-11-22
PIT,2020-11-22,6,Sun,10,11,@,JAX,W 27-3,6,42,8,105,14,147,PIT_JAX_2020-11-22
BAL,2020-11-22,6,Sun,10,11,,TEN,L 24-30 (OT),6,81,4,44,10,125,BAL_TEN_2020-11-22
PIT,2020-11-15,6,Sun,9,10,,CIN,W 36-10,6,45,6,65,12,110,PIT_CIN_2020-11-15
HOU,2020-11-15,6,Sun,9,10,@,CLE,L 7-10,6,49,6,63,12,112,HOU_CLE_2020-11-15
WAS,2020-11-15,6,Sun,9,10,@,DET,L 27-30,6,58,9,55,15,113,WAS_DET_2020-11-15
CLE,2020-11-15,6,Sun,9,10,,HOU,W 10-7,6,63,6,49,12,112,CLE_HOU_2020-11-15
SFO,2020-11-15,6,Sun,10,10,@,NOR,L 13-27,6,51,5,61,11,112,SFO_NOR_2020-11-15
CIN,2020-11-15,6,Sun,9,10,@,PIT,L 10-36,6,65,6,45,12,110,CIN_PIT_2020-11-15
NWE,2020-11-09,6,Mon,8,9,@,NYJ,W 30-27,6,81,4,32,10,113,NWE_NYJ_2020-11-09
TEN,2020-11-08,6,Sun,8,9,,CHI,W 24-17,6,57,5,35,11,92,TEN_CHI_2020-11-08
WAS,2020-11-08,6,Sun,8,9,,NYG,L 20-23,6,45,4,40,10,85,WAS_NYG_2020-11-08
BUF,2020-11-08,6,Sun,9,9,,SEA,W 44-34,6,70,4,13,10,83,BUF_SEA_2020-11-08
LAC,2020-11-01,6,Sun,7,8,@,DEN,L 30-31,6,67,8,70,14,137,LAC_DEN_2020-11-01
SFO,2020-11-01,6,Sun,8,8,@,SEA,L 27-37,6,36,6,30,12,66,SFO_SEA_2020-11-01
SEA,2020-11-01,6,Sun,7,8,,SFO,W 37-27,6,30,6,36,12,66,SEA_SFO_2020-11-01
CAR,2020-10-29,6,Thu,8,8,,ATL,L 17-25,6,30,6,63,12,93,CAR_ATL_2020-10-29
ATL,2020-10-29,6,Thu,8,8,@,CAR,W 25-17,6,63,6,30,12,93,ATL_CAR_2020-10-29
CHI,2020-10-26,6,Mon,7,7,@,LAR,L 10-24,6,46,4,46,10,92,CHI_LAR_2020-10-26
NYJ,2020-10-25,6,Sun,7,7,,BUF,L 10-18,6,49,11,106,17,155,NYJ_BUF_2020-10-25
NOR,2020-10-25,6,Sun,6,7,,CAR,W 27-24,6,50,1,5,7,55,NOR_CAR_2020-10-25
HOU,2020-10-25,6,Sun,7,7,,GNB,L 20-35,6,55,5,40,11,95,HOU_GNB_2020-10-25
SFO,2020-10-25,6,Sun,7,7,@,NWE,W 33-6,6,65,3,30,9,95,SFO_NWE_2020-10-25
JAX,2020-10-25,6,Sun,7,7,@,LAC,L 29-39,6,55,3,35,9,90,JAX_LAC_2020-10-25
ARI,2020-10-25,6,Sun,7,7,,SEA,W 37-34 (OT),6,40,8,78,14,118,ARI_SEA_2020-10-25
DAL,2020-10-25,6,Sun,7,7,@,WAS,L 3-25,6,49,4,30,10,79,DAL_WAS_2020-10-25
DAL,2020-10-19,6,Mon,6,6,,ARI,L 10-38,6,36,7,43,13,79,DAL_ARI_2020-10-19
IND,2020-10-18,6,Sun,6,6,,CIN,W 31-27,6,55,6,20,12,75,IND_CIN_2020-10-18
PIT,2020-10-18,6,Sun,5,6,,CLE,W 38-7,6,45,7,55,13,100,PIT_CLE_2020-10-18
CIN,2020-10-18,6,Sun,6,6,@,IND,L 27-31,6,20,6,55,12,75,CIN_IND_2020-10-18
LAR,2020-10-18,6,Sun,6,6,@,SFO,L 16-24,6,34,7,63,13,97,LAR_SFO_2020-10-18
GNB,2020-10-18,6,Sun,5,6,@,TAM,L 10-38,6,76,0,0,6,76,GNB_TAM_2020-10-18
TEN,2020-10-13,6,Tue,4,5,,BUF,W 42-16,6,46,10,56,16,102,TEN_BUF_2020-10-13
NYJ,2020-10-11,6,Sun,5,5,,ARI,L 10-30,6,30,10,59,16,89,NYJ_ARI_2020-10-11
MIN,2020-10-11,6,Sun,5,5,@,SEA,L 26-27,6,55,3,25,9,80,MIN_SEA_2020-10-11
CHI,2020-10-08,6,Thu,5,5,,TAM,W 20-19,6,66,11,109,17,175,CHI_TAM_2020-10-08
JAX,2020-10-04,6,Sun,4,4,@,CIN,L 25-33,6,49,7,73,13,122,JAX_CIN_2020-10-04
DAL,2020-10-04,6,Sun,4,4,,CLE,L 38-49,6,65,5,40,11,105,DAL_CLE_2020-10-04
SFO,2020-10-04,6,Sun,4,4,,PHI,L 20-25,6,42,3,25,9,67,SFO_PHI_2020-10-04
BAL,2020-09-28,6,Mon,3,3,,KAN,L 20-34,6,45,6,38,12,83,BAL_KAN_2020-09-28
KAN,2020-09-28,6,Mon,3,3,@,BAL,W 34-20,6,38,6,45,12,83,KAN_BAL_2020-09-28
LVR,2020-09-27,6,Sun,3,3,@,NWE,L 20-36,6,40,2,33,8,73,LVR_NWE_2020-09-27
SFO,2020-09-27,6,Sun,3,3,@,NYG,W 36-9,6,45,5,28,11,73,SFO_NYG_2020-09-27
CLE,2020-09-27,6,Sun,3,3,,WAS,W 34-20,6,50,4,40,10,90,CLE_WAS_2020-09-27
MIA,2020-09-24,6,Thu,3,3,@,JAX,W 31-13,6,51,8,63,14,114,MIA_JAX_2020-09-24
MIN,2020-09-20,6,Sun,2,2,@,IND,L 11-28,6,45,9,93,15,138,MIN_IND_2020-09-20
WAS,2020-09-20,6,Sun,2,2,@,ARI,L 15-30,6,42,11,97,17,139,WAS_ARI_2020-09-20
LAC,2020-09-20,6,Sun,2,2,,KAN,L 20-23 (OT),6,40,11,90,17,130,LAC_KAN_2020-09-20
BUF,2020-09-20,6,Sun,2,2,@,MIA,W 31-28,6,55,3,20,9,75,BUF_MIA_2020-09-20
SEA,2020-09-13,6,Sun,1,1,@,ATL,W 38-25,6,46,6,72,12,118,SEA_ATL_2020-09-13
LAC,2020-09-13,6,Sun,1,1,@,CIN,W 16-13,6,35,7,44,13,79,LAC_CIN_2020-09-13
JAX,2020-09-13,6,Sun,1,1,,IND,W 27-20,6,61,5,80,11,141,JAX_IND_2020-09-13
CHI,2020-09-13,6,Sun,1,1,@,DET,W 27-23,6,48,8,77,14,125,CHI_DET_2020-09-13
GNB,2020-09-13,6,Sun,1,1,@,MIN,W 43-34,6,63,5,20,11,83,GNB_MIN_2020-09-13
ATL,2020-09-13,6,Sun,1,1,,SEA,L 25-38,6,72,6,46,12,118,ATL_SEA_2020-09-13
NOR,2020-09-13,6,Sun,1,1,,TAM,W 34-23,6,119,9,103,15,222,NOR_TAM_2020-09-13
NWE,2019-12-29,6,Sun,16,17,,MIA,L 24-27,6,54,4,35,10,89,NWE_MIA_2019-12-29
BAL,2019-12-29,6,Sun,16,17,,PIT,W 28-10,6,35,6,47,12,82,BAL_PIT_2019-12-29
PIT,2019-12-29,6,Sun,16,17,@,BAL,L 10-28,6,47,6,35,12,82,PIT_BAL_2019-12-29
TEN,2019-12-22,6,Sun,15,16,,NOR,L 28-38,6,56,11,70,17,126,TEN_NOR_2019-12-22
WAS,2019-12-22,6,Sun,15,16,,NYG,L 35-41 (OT),6,51,4,33,10,84,WAS_NYG_2019-12-22
JAX,2019-12-22,6,Sun,15,16,@,ATL,L 12-24,6,36,9,64,15,100,JAX_ATL_2019-12-22
MIA,2019-12-22,6,Sun,15,16,,CIN,W 38-35 (OT),6,47,10,77,16,124,MIA_CIN_2019-12-22
CAR,2019-12-22,6,Sun,15,16,@,IND,L 6-38,6,46,0,0,6,46,CAR_IND_2019-12-22
DEN,2019-12-22,6,Sun,15,16,,DET,W 27-17,6,50,7,68,13,118,DEN_DET_2019-12-22
TAM,2019-12-21,6,Sat,15,16,,HOU,L 20-23,6,45,4,35,10,80,TAM_HOU_2019-12-21
NOR,2019-12-16,6,Mon,14,15,,IND,W 34-7,6,52,7,49,13,101,NOR_IND_2019-12-16
OAK,2019-12-15,6,Sun,14,15,,JAX,L 16-20,6,51,8,87,14,138,OAK_JAX_2019-12-15
PIT,2019-12-15,6,Sun,14,15,,BUF,L 10-17,6,30,8,70,14,100,PIT_BUF_2019-12-15
CLE,2019-12-15,6,Sun,14,15,@,ARI,L 24-38,6,55,5,34,11,89,CLE_ARI_2019-12-15
BAL,2019-12-12,6,Thu,14,15,,NYJ,W 42-21,6,35,8,94,14,129,BAL_NYJ_2019-12-12
CLE,2019-12-08,6,Sun,13,14,,CIN,W 27-19,6,30,8,99,14,129,CLE_CIN_2019-12-08
ATL,2019-12-08,6,Sun,13,14,,CAR,W 40-20,6,58,7,44,13,102,ATL_CAR_2019-12-08
LAC,2019-12-08,6,Sun,13,14,@,JAX,W 45-10,6,65,10,101,16,166,LAC_JAX_2019-12-08
TAM,2019-12-08,6,Sun,13,14,,IND,W 38-35,6,104,3,35,9,139,TAM_IND_2019-12-08
DAL,2019-12-05,6,Thu,13,14,@,CHI,L 24-31,6,52,4,30,10,82,DAL_CHI_2019-12-05
IND,2019-12-01,6,Sun,12,13,,TEN,L 17-31,6,40,3,33,9,73,IND_TEN_2019-12-01
WAS,2019-12-01,6,Sun,12,13,@,CAR,W 29-21,6,65,5,43,11,108,WAS_CAR_2019-12-01
SFO,2019-12-01,6,Sun,12,13,@,BAL,L 17-20,6,54,3,23,9,77,SFO_BAL_2019-12-01
TEN,2019-11-24,6,Sun,11,12,,JAX,W 42-20,6,54,11,104,17,158,TEN_JAX_2019-11-24
NWE,2019-11-24,6,Sun,11,12,,DAL,W 13-9,6,56,7,50,13,106,NWE_DAL_2019-11-24
CHI,2019-11-24,6,Sun,11,12,,NYG,W 19-14,6,40,6,35,12,75,CHI_NYG_2019-11-24
DET,2019-11-24,6,Sun,11,12,@,WAS,L 16-19,6,65,8,63,14,128,DET_WAS_2019-11-24
NYG,2019-11-24,6,Sun,11,12,@,CHI,L 14-19,6,35,6,40,12,75,NYG_CHI_2019-11-24
NWE,2019-11-17,6,Sun,10,11,@,PHI,W 17-10,6,89,7,39,13,128,NWE_PHI_2019-11-17
MIA,2019-11-17,6,Sun,10,11,,BUF,L 20-37,6,44,5,50,11,94,MIA_BUF_2019-11-17
LAR,2019-11-17,6,Sun,10,11,,CHI,W 17-7,6,34,2,25,8,59,LAR_CHI_2019-11-17
NYJ,2019-11-17,6,Sun,10,11,@,WAS,W 34-17,6,55,11,66,17,121,NYJ_WAS_2019-11-17
DEN,2019-11-17,6,Sun,10,11,@,MIN,L 23-27,6,35,5,49,11,84,DEN_MIN_2019-11-17
DAL,2019-11-17,6,Sun,10,11,@,DET,W 35-27,6,45,11,89,17,134,DAL_DET_2019-11-17
PIT,2019-11-14,6,Thu,10,11,@,CLE,L 7-21,6,41,8,121,14,162,PIT_CLE_2019-11-14
NYG,2019-11-10,6,Sun,10,10,@,NYJ,L 27-34,6,62,7,54,13,116,NYG_NYJ_2019-11-10
MIA,2019-11-03,6,Sun,8,9,,NYJ,W 26-18,6,51,10,105,16,156,MIA_NYJ_2019-11-03
CAR,2019-11-03,6,Sun,8,9,,TEN,W 30-20,6,77,11,99,17,176,CAR_TEN_2019-11-03
TEN,2019-10-27,6,Sun,8,8,,TAM,W 27-23,6,77,9,87,15,164,TEN_TAM_2019-10-27
CIN,2019-10-27,6,Sun,8,8,@,LAR,L 10-24,6,40,9,59,15,99,CIN_LAR_2019-10-27
IND,2019-10-20,6,Sun,6,7,,HOU,W 30-23,6,45,10,54,16,99,IND_HOU_2019-10-20
CIN,2019-10-20,6,Sun,7,7,,JAX,L 17-27,6,50,11,130,17,180,CIN_JAX_2019-10-20
MIN,2019-10-20,6,Sun,7,7,@,DET,W 42-30,6,60,8,67,14,127,MIN_DET_2019-10-20
DAL,2019-10-20,6,Sun,7,7,,PHI,W 37-10,6,65,5,40,11,105,DAL_PHI_2019-10-20
MIA,2019-10-20,6,Sun,6,7,@,BUF,L 21-31,6,55,9,83,15,138,MIA_BUF_2019-10-20
NYG,2019-10-20,6,Sun,7,7,,ARI,L 21-27,6,75,10,85,16,160,NYG_ARI_2019-10-20
KAN,2019-10-17,6,Thu,7,7,@,DEN,W 30-6,6,46,4,33,10,79,KAN_DEN_2019-10-17
GNB,2019-10-14,6,Mon,6,6,,DET,W 23-22,6,48,8,50,14,98,GNB_DET_2019-10-14
PIT,2019-10-13,6,Sun,6,6,@,LAC,W 24-17,6,45,8,74,14,119,PIT_LAC_2019-10-13
TEN,2019-10-13,6,Sun,6,6,@,DEN,L 0-16,6,40,8,51,14,91,TEN_DEN_2019-10-13
WAS,2019-10-13,6,Sun,6,6,@,MIA,W 17-16,6,56,5,45,11,101,WAS_MIA_2019-10-13
NOR,2019-10-06,6,Sun,5,5,,TAM,W 31-24,6,40,4,30,10,70,NOR_TAM_2019-10-06
OAK,2019-10-06,6,Sun,5,5,,CHI,W 24-21,6,69,10,75,16,144,OAK_CHI_2019-10-06
WAS,2019-10-06,6,Sun,5,5,,NWE,L 7-33,6,72,7,55,13,127,WAS_NWE_2019-10-06
LAR,2019-10-03,6,Thu,5,5,@,SEA,L 29-30,6,45,5,45,11,90,LAR_SEA_2019-10-03
DAL,2019-09-29,6,Sun,4,4,@,NOR,L 10-12,6,64,9,80,15,144,DAL_NOR_2019-09-29
CAR,2019-09-29,6,Sun,4,4,@,HOU,W 16-10,6,35,7,81,13,116,CAR_HOU_2019-09-29
CLE,2019-09-29,6,Sun,4,4,@,BAL,W 40-25,6,41,3,15,9,56,CLE_BAL_2019-09-29
HOU,2019-09-22,6,Sun,3,3,@,LAC,W 27-20,6,65,7,69,13,134,HOU_LAC_2019-09-22
MIN,2019-09-22,6,Sun,3,3,,OAK,W 34-14,6,59,7,84,13,143,MIN_OAK_2019-09-22
NYG,2019-09-22,6,Sun,3,3,@,TAM,W 32-31,6,59,4,30,10,89,NYG_TAM_2019-09-22
PIT,2019-09-22,6,Sun,3,3,@,SFO,L 20-24,6,42,5,71,11,113,PIT_SFO_2019-09-22
WAS,2019-09-15,6,Sun,2,2,,DAL,L 21-31,6,44,8,67,14,111,WAS_DAL_2019-09-15
GNB,2019-09-15,6,Sun,2,2,,MIN,W 21-16,6,35,8,100,14,135,GNB_MIN_2019-09-15
DEN,2019-09-09,6,Mon,1,1,@,OAK,L 16-24,6,44,9,62,15,106,DEN_OAK_2019-09-09
CAR,2019-09-08,6,Sun,1,1,,LAR,L 27-30,6,46,5,43,11,89,CAR_LAR_2019-09-08
PIT,2019-09-08,6,Sun,1,1,@,NWE,L 3-33,6,54,7,55,13,109,PIT_NWE_2019-09-08
TEN,2019-09-08,6,Sun,1,1,@,CLE,W 43-13,6,54,18,182,24,236,TEN_CLE_2019-09-08
DAL,2019-09-08,6,Sun,1,1,,NYG,W 35-17,6,47,8,70,14,117,DAL_NYG_2019-09-08
PHI,2019-09-08,6,Sun,1,1,,WAS,W 32-27,6,55,12,96,18,151,PHI_WAS_2019-09-08
DAL,2018-12-30,6,Sun,16,17,@,NYG,W 36-35,6,46,11,78,17,124,DAL_NYG_2018-12-30
LAC,2018-12-30,6,Sun,16,17,@,DEN,W 23-9,6,51,11,99,17,150,LAC_DEN_2018-12-30
LAR,2018-12-30,6,Sun,16,17,,SFO,W 48-32,6,57,5,41,11,98,LAR_SFO_2018-12-30
NOR,2018-12-30,6,Sun,16,17,,CAR,L 14-33,6,94,2,10,8,104,NOR_CAR_2018-12-30
OAK,2018-12-24,6,Mon,15,16,,DEN,W 27-14,6,50,11,91,17,141,OAK_DEN_2018-12-24
IND,2018-12-23,6,Sun,15,16,,NYG,W 28-27,6,29,6,24,12,53,IND_NYG_2018-12-23
NYG,2018-12-23,6,Sun,15,16,@,IND,L 27-28,6,24,6,29,12,53,NYG_IND_2018-12-23
LAR,2018-12-23,6,Sun,15,16,@,ARI,W 31-9,6,66,7,54,13,120,LAR_ARI_2018-12-23
SFO,2018-12-23,6,Sun,15,16,,CHI,L 9-14,6,45,4,30,10,75,SFO_CHI_2018-12-23
CLE,2018-12-23,6,Sun,15,16,,CIN,W 26-18,6,57,3,15,9,72,CLE_CIN_2018-12-23
PIT,2018-12-23,6,Sun,15,16,@,NOR,L 28-31,6,79,9,91,15,170,PIT_NOR_2018-12-23
TAM,2018-12-16,6,Sun,14,15,@,BAL,L 12-20,6,58,8,70,14,128,TAM_BAL_2018-12-16
MIN,2018-12-16,6,Sun,14,15,,MIA,W 41-17,6,45,8,49,14,94,MIN_MIA_2018-12-16
ATL,2018-12-16,6,Sun,14,15,,ARI,W 40-14,6,50,8,75,14,125,ATL_ARI_2018-12-16
PHI,2018-12-16,6,Sun,14,15,@,LAR,W 30-23,6,49,5,50,11,99,PHI_LAR_2018-12-16
WAS,2018-12-16,6,Sun,14,15,@,JAX,W 16-13,6,48,8,55,14,103,WAS_JAX_2018-12-16
IND,2018-12-16,6,Sun,14,15,,DAL,W 23-0,6,55,9,74,15,129,IND_DAL_2018-12-16
CLE,2018-12-15,6,Sat,14,15,@,DEN,W 17-16,6,75,8,51,14,126,CLE_DEN_2018-12-15
CIN,2018-12-09,6,Sun,13,14,@,LAC,L 21-26,6,34,6,38,12,72,CIN_LAC_2018-12-09
NOR,2018-12-09,6,Sun,13,14,@,TAM,W 28-14,6,51,10,84,16,135,NOR_TAM_2018-12-09
LAC,2018-12-09,6,Sun,13,14,,CIN,W 26-21,6,38,6,34,12,72,LAC_CIN_2018-12-09
CHI,2018-12-09,6,Sun,13,14,,LAR,W 15-6,6,45,9,57,15,102,CHI_LAR_2018-12-09
GNB,2018-12-09,6,Sun,13,14,,ATL,W 34-20,6,37,13,101,19,138,GNB_ATL_2018-12-09
CLE,2018-12-02,6,Sun,12,13,@,HOU,L 13-29,6,45,5,77,11,122,CLE_HOU_2018-12-02
IND,2018-12-02,6,Sun,12,13,@,JAX,L 0-6,6,65,8,74,14,139,IND_JAX_2018-12-02
BAL,2018-11-25,6,Sun,11,12,,OAK,W 34-17,6,45,4,24,10,69,BAL_OAK_2018-11-25
MIN,2018-11-25,6,Sun,11,12,,GNB,W 24-17,6,55,4,20,10,75,MIN_GNB_2018-11-25
DEN,2018-11-25,6,Sun,11,12,,PIT,W 24-17,6,50,5,34,11,84,DEN_PIT_2018-11-25
PHI,2018-11-18,6,Sun,10,11,@,NOR,L 7-48,6,49,8,69,14,118,PHI_NOR_2018-11-18
WAS,2018-11-18,6,Sun,10,11,,HOU,L 21-23,6,43,7,40,13,83,WAS_HOU_2018-11-18
SEA,2018-11-15,6,Thu,10,11,,GNB,W 27-24,6,30,5,80,11,110,SEA_GNB_2018-11-15
CHI,2018-11-11,6,Sun,9,10,,DET,W 34-22,6,46,6,41,12,87,CHI_DET_2018-11-11
OAK,2018-11-11,6,Sun,9,10,,LAC,L 6-20,6,55,6,70,12,125,OAK_LAC_2018-11-11
LAC,2018-11-11,6,Sun,9,10,@,OAK,W 20-6,6,70,6,55,12,125,LAC_OAK_2018-11-11
GNB,2018-11-11,6,Sun,9,10,,MIA,W 31-12,6,45,3,10,9,55,GNB_MIA_2018-11-11
DET,2018-11-11,6,Sun,9,10,@,CHI,L 22-34,6,41,6,46,12,87,DET_CHI_2018-11-11
DAL,2018-11-05,6,Mon,8,9,,TEN,L 14-28,6,52,3,20,9,72,DAL_TEN_2018-11-05
OAK,2018-11-01,6,Thu,8,9,@,SFO,L 3-34,6,40,3,23,9,63,OAK_SFO_2018-11-01
BUF,2018-10-29,6,Mon,8,8,,NWE,L 6-25,6,51,5,33,11,84,BUF_NWE_2018-10-29
MIN,2018-10-28,6,Sun,8,8,,NOR,L 20-30,6,54,7,64,13,118,MIN_NOR_2018-10-28
NOR,2018-10-21,6,Sun,6,7,@,BAL,W 24-23,6,52,5,54,11,106,NOR_BAL_2018-10-21
MIN,2018-10-21,6,Sun,7,7,@,NYJ,W 37-17,6,55,8,71,14,126,MIN_NYJ_2018-10-21
DET,2018-10-21,6,Sun,6,7,@,MIA,W 32-21,6,43,4,50,10,93,DET_MIA_2018-10-21
HOU,2018-10-21,6,Sun,7,7,@,JAX,W 20-7,6,35,2,15,8,50,HOU_JAX_2018-10-21
GNB,2018-10-15,6,Mon,6,6,,SFO,W 33-30,6,54,2,10,8,64,GNB_SFO_2018-10-15
CLE,2018-10-14,6,Sun,6,6,,LAC,L 14-38,6,53,10,72,16,125,CLE_LAC_2018-10-14
HOU,2018-10-14,6,Sun,6,6,,BUF,W 20-13,6,50,12,104,18,154,HOU_BUF_2018-10-14
CHI,2018-10-14,6,Sun,5,6,@,MIA,L 28-31 (OT),6,58,7,67,13,125,CHI_MIA_2018-10-14
DEN,2018-10-14,6,Sun,6,6,,LAR,L 20-23,6,61,10,81,16,142,DEN_LAR_2018-10-14
CIN,2018-10-14,6,Sun,6,6,,PIT,L 21-28,6,30,9,69,15,99,CIN_PIT_2018-10-14
WAS,2018-10-08,6,Mon,4,5,@,NOR,L 19-43,6,38,4,45,10,83,WAS_NOR_2018-10-08
DEN,2018-10-07,6,Sun,5,5,@,NYJ,L 16-34,6,45,4,33,10,78,DEN_NYJ_2018-10-07
CIN,2018-10-07,6,Sun,5,5,,MIA,W 27-17,6,47,9,85,15,132,CIN_MIA_2018-10-07
NWE,2018-09-30,6,Sun,4,4,,MIA,W 38-7,6,57,10,89,16,146,NWE_MIA_2018-09-30
NYG,2018-09-30,6,Sun,4,4,,NOR,L 18-33,6,67,5,51,11,118,NYG_NOR_2018-09-30
CIN,2018-09-30,6,Sun,4,4,@,ATL,W 37-36,6,55,10,95,16,150,CIN_ATL_2018-09-30
OAK,2018-09-30,6,Sun,4,4,,CLE,W 45-42 (OT),6,65,8,55,14,120,OAK_CLE_2018-09-30
NYJ,2018-09-30,6,Sun,4,4,@,JAX,L 12-31,6,43,9,89,15,132,NYJ_JAX_2018-09-30
LAR,2018-09-23,6,Sun,3,3,,LAC,W 35-23,6,64,4,30,10,94,LAR_LAC_2018-09-23
MIN,2018-09-23,6,Sun,3,3,,BUF,L 6-27,6,59,12,84,18,143,MIN_BUF_2018-09-23
WAS,2018-09-23,6,Sun,3,3,,GNB,W 31-17,6,66,11,115,17,181,WAS_GNB_2018-09-23
KAN,2018-09-23,6,Sun,3,3,,SFO,W 38-27,6,48,14,147,20,195,KAN_SFO_2018-09-23
ARI,2018-09-23,6,Sun,3,3,,CHI,L 14-16,6,43,7,45,13,88,ARI_CHI_2018-09-23
DET,2018-09-23,6,Sun,3,3,,NWE,W 26-10,6,70,5,38,11,108,DET_NWE_2018-09-23
NYJ,2018-09-20,6,Thu,3,3,@,CLE,L 17-21,6,55,5,41,11,96,NYJ_CLE_2018-09-20
DAL,2018-09-16,6,Sun,2,2,,NYG,W 20-13,6,47,3,24,9,71,DAL_NYG_2018-09-16
IND,2018-09-16,6,Sun,2,2,@,WAS,W 21-9,6,26,7,90,13,116,IND_WAS_2018-09-16
BUF,2018-09-16,6,Sun,2,2,,LAC,L 20-31,6,31,6,45,12,76,BUF_LAC_2018-09-16
DEN,2018-09-16,6,Sun,2,2,,OAK,W 20-19,6,35,4,30,10,65,DEN_OAK_2018-09-16
PHI,2018-09-16,6,Sun,2,2,@,TAM,L 21-27,6,55,4,44,10,99,PHI_TAM_2018-09-16
LAC,2018-09-16,6,Sun,2,2,@,BUF,W 31-20,6,45,6,31,12,76,LAC_BUF_2018-09-16
KAN,2018-09-09,6,Sun,1,1,@,LAC,W 38-28,6,50,7,45,13,95,KAN_LAC_2018-09-09
HOU,2018-09-09,6,Sun,1,1,@,NWE,L 20-27,6,44,6,36,12,80,HOU_NWE_2018-09-09
NWE,2018-09-09,6,Sun,1,1,,HOU,W 27-20,6,36,6,44,12,80,NWE_HOU_2018-09-09
NYG,2018-09-09,6,Sun,1,1,,JAX,L 15-20,6,43,11,119,17,162,NYG_JAX_2018-09-09
CIN,2017-12-31,6,Sun,16,17,@,BAL,W 31-27,6,60,5,47,11,107,CIN_BAL_2017-12-31
OAK,2017-12-31,6,Sun,16,17,@,LAC,L 10-30,6,85,7,65,13,150,OAK_LAC_2017-12-31
BUF,2017-12-31,6,Sun,16,17,@,MIA,W 22-16,6,45,14,145,20,190,BUF_MIA_2017-12-31
LAR,2017-12-31,6,Sun,16,17,,SFO,L 13-34,6,46,4,23,10,69,LAR_SFO_2017-12-31
JAX,2017-12-31,6,Sun,16,17,@,TEN,L 10-15,6,41,2,15,8,56,JAX_TEN_2017-12-31
ARI,2017-12-24,6,Sun,15,16,,NYG,W 23-0,6,45,10,101,16,146,ARI_NYG_2017-12-24
CAR,2017-12-24,6,Sun,15,16,,TAM,W 22-19,6,50,12,72,18,122,CAR_TAM_2017-12-24
WAS,2017-12-24,6,Sun,15,16,,DEN,W 27-11,6,35,3,30,9,65,WAS_DEN_2017-12-24
GNB,2017-12-23,6,Sat,15,16,,MIN,L 0-16,6,79,2,10,8,89,GNB_MIN_2017-12-23
ATL,2017-12-18,6,Mon,14,15,@,TAM,W 24-21,6,60,7,53,13,113,ATL_TAM_2017-12-18
PIT,2017-12-17,6,Sun,14,15,,NWE,L 24-27,6,63,2,4,8,67,PIT_NWE_2017-12-17
GNB,2017-12-17,6,Sun,14,15,@,CAR,L 24-31,6,28,5,40,11,68,GNB_CAR_2017-12-17
CLE,2017-12-17,6,Sun,14,15,,BAL,L 10-27,6,35,7,57,13,92,CLE_BAL_2017-12-17
SEA,2017-12-10,6,Sun,13,14,@,JAX,L 24-30,6,73,7,48,13,121,SEA_JAX_2017-12-10
PIT,2017-12-10,6,Sun,13,14,,BAL,W 39-38,6,101,5,35,11,136,PIT_BAL_2017-12-10
CAR,2017-12-10,6,Sun,13,14,,MIN,W 31-24,6,48,2,30,8,78,CAR_MIN_2017-12-10
CLE,2017-12-10,6,Sun,13,14,,GNB,L 21-27 (OT),6,45,3,20,9,65,CLE_GNB_2017-12-10
TEN,2017-12-10,6,Sun,13,14,@,ARI,L 7-12,6,48,5,30,11,78,TEN_ARI_2017-12-10
CAR,2017-12-03,6,Sun,12,13,@,NOR,L 21-31,6,54,7,68,13,122,CAR_NOR_2017-12-03
MIN,2017-12-03,6,Sun,12,13,@,ATL,W 14-9,6,51,7,55,13,106,MIN_ATL_2017-12-03
OAK,2017-12-03,6,Sun,12,13,,NYG,W 24-17,6,42,1,5,7,47,OAK_NYG_2017-12-03
DET,2017-12-03,6,Sun,12,13,@,BAL,L 20-44,6,45,2,25,8,70,DET_BAL_2017-12-03
JAX,2017-12-03,6,Sun,12,13,,IND,W 30-10,6,55,4,31,10,86,JAX_IND_2017-12-03
HOU,2017-11-27,6,Mon,11,12,@,BAL,L 16-23,6,36,7,89,13,125,HOU_BAL_2017-11-27
MIA,2017-11-26,6,Sun,11,12,@,NWE,L 17-35,6,52,7,70,13,122,MIA_NWE_2017-11-26
BUF,2017-11-26,6,Sun,11,12,@,KAN,W 16-10,6,50,6,50,12,100,BUF_KAN_2017-11-26
KAN,2017-11-26,6,Sun,11,12,,BUF,L 10-16,6,50,6,50,12,100,KAN_BUF_2017-11-26
SEA,2017-11-26,6,Sun,11,12,@,SFO,W 24-13,6,35,7,74,13,109,SEA_SFO_2017-11-26
NYG,2017-11-23,6,Thu,11,12,@,WAS,L 10-20,6,79,8,55,14,134,NYG_WAS_2017-11-23
JAX,2017-11-19,6,Sun,10,11,@,CLE,W 19-7,6,40,0,0,6,40,JAX_CLE_2017-11-19
BUF,2017-11-19,6,Sun,10,11,@,LAC,L 24-54,6,48,1,13,7,61,BUF_LAC_2017-11-19
HOU,2017-11-19,6,Sun,10,11,,ARI,W 31-21,6,42,10,90,16,132,HOU_ARI_2017-11-19
DET,2017-11-19,6,Sun,10,11,@,CHI,W 27-24,6,49,5,64,11,113,DET_CHI_2017-11-19
CAR,2017-11-13,6,Mon,10,10,,MIA,W 45-21,6,37,7,57,13,94,CAR_MIA_2017-11-13
SFO,2017-11-12,6,Sun,10,10,,NYG,W 31-21,6,44,4,35,10,79,SFO_NYG_2017-11-12
TAM,2017-11-12,6,Sun,9,10,,NYJ,W 15-10,6,50,8,77,14,127,TAM_NYJ_2017-11-12
IND,2017-11-05,6,Sun,9,9,@,HOU,W 20-14,6,68,7,74,13,142,IND_HOU_2017-11-05
LAR,2017-11-05,6,Sun,8,9,@,NYG,W 51-17,6,55,4,52,10,107,LAR_NYG_2017-11-05
BAL,2017-11-05,6,Sun,9,9,@,TEN,L 20-23,6,39,3,39,9,78,BAL_TEN_2017-11-05
DET,2017-10-29,6,Sun,7,8,,PIT,L 15-20,6,57,5,37,11,94,DET_PIT_2017-10-29
TAM,2017-10-29,6,Sun,7,8,,CAR,L 3-17,6,55,5,51,11,106,TAM_CAR_2017-10-29
NYJ,2017-10-29,6,Sun,8,8,,ATL,L 20-25,6,50,6,68,12,118,NYJ_ATL_2017-10-29
NWE,2017-10-29,6,Sun,8,8,,LAC,W 21-13,6,80,10,77,16,157,NWE_LAC_2017-10-29
SFO,2017-10-29,6,Sun,8,8,@,PHI,L 10-33,6,69,4,35,10,104,SFO_PHI_2017-10-29
ATL,2017-10-29,6,Sun,7,8,@,NYJ,W 25-20,6,68,6,50,12,118,ATL_NYJ_2017-10-29
OAK,2017-10-29,6,Sun,8,8,@,BUF,L 14-34,6,50,11,95,17,145,OAK_BUF_2017-10-29
ATL,2017-10-22,6,Sun,6,7,@,NWE,L 7-23,6,40,8,65,14,105,ATL_NWE_2017-10-22
LAR,2017-10-22,6,Sun,7,7,,ARI,W 33-0,6,45,10,65,16,110,LAR_ARI_2017-10-22
NYJ,2017-10-15,6,Sun,6,6,,NWE,L 17-24,6,69,6,45,12,114,NYJ_NWE_2017-10-15
PIT,2017-10-15,6,Sun,6,6,@,KAN,W 19-13,6,57,7,48,13,105,PIT_KAN_2017-10-15
NWE,2017-10-15,6,Sun,6,6,@,NYJ,W 24-17,6,45,6,69,12,114,NWE_NYJ_2017-10-15
ATL,2017-10-15,6,Sun,5,6,,MIA,L 17-20,6,73,4,42,10,115,ATL_MIA_2017-10-15
BUF,2017-10-08,6,Sun,5,5,@,CIN,L 16-20,6,71,6,71,12,142,BUF_CIN_2017-10-08
KAN,2017-10-08,6,Sun,5,5,@,HOU,W 42-34,6,64,7,59,13,123,KAN_HOU_2017-10-08
GNB,2017-10-08,6,Sun,5,5,@,DAL,W 35-31,6,38,7,70,13,108,GNB_DAL_2017-10-08
CLE,2017-10-08,6,Sun,5,5,,NYJ,L 14-17,6,60,9,80,15,140,CLE_NYJ_2017-10-08
CIN,2017-10-08,6,Sun,5,5,,BUF,W 20-16,6,71,6,71,12,142,CIN_BUF_2017-10-08
BAL,2017-10-01,6,Sun,4,4,,PIT,L 9-26,6,55,8,60,14,115,BAL_PIT_2017-10-01
TEN,2017-10-01,6,Sun,4,4,@,HOU,L 14-57,6,88,3,20,9,108,TEN_HOU_2017-10-01
DET,2017-10-01,6,Sun,4,4,@,MIN,W 14-7,6,60,2,10,8,70,DET_MIN_2017-10-01
SEA,2017-10-01,6,Sun,4,4,,IND,W 46-18,6,45,5,31,11,76,SEA_IND_2017-10-01
DEN,2017-10-01,6,Sun,4,4,,OAK,W 16-10,6,40,7,75,13,115,DEN_OAK_2017-10-01
JAX,2017-10-01,6,Sun,4,4,@,NYJ,L 20-23 (OT),6,47,10,70,16,117,JAX_NYJ_2017-10-01
ARI,2017-09-25,6,Mon,3,3,,DAL,L 17-28,6,50,9,76,15,126,ARI_DAL_2017-09-25
PIT,2017-09-24,6,Sun,3,3,@,CHI,L 17-23 (OT),6,40,10,73,16,113,PIT_CHI_2017-09-24
DET,2017-09-18,6,Mon,2,2,@,NYG,W 24-10,6,50,7,50,13,100,DET_NYG_2017-09-18
SFO,2017-09-17,6,Sun,2,2,@,SEA,L 9-12,6,66,9,71,15,137,SFO_SEA_2017-09-17
ARI,2017-09-17,6,Sun,2,2,@,IND,W 16-13 (OT),6,41,8,70,14,111,ARI_IND_2017-09-17
CAR,2017-09-17,6,Sun,2,2,,BUF,W 9-3,6,40,5,44,11,84,CAR_BUF_2017-09-17
LAC,2017-09-17,6,Sun,2,2,,MIA,L 17-19,6,56,5,23,11,79,LAC_MIA_2017-09-17
ATL,2017-09-17,6,Sun,2,2,,GNB,W 34-23,6,34,10,70,16,104,ATL_GNB_2017-09-17
NOR,2017-09-11,6,Mon,1,1,@,MIN,L 19-29,6,52,5,50,11,102,NOR_MIN_2017-09-11
NYG,2017-09-10,6,Sun,1,1,@,DAL,L 3-19,6,55,5,50,11,105,NYG_DAL_2017-09-10
ARI,2017-09-10,6,Sun,1,1,@,DET,L 23-35,6,55,10,100,16,155,ARI_DET_2017-09-10
BUF,2017-09-10,6,Sun,1,1,,NYJ,W 21-12,6,50,5,62,11,112,BUF_NYJ_2017-09-10
NWE,2017-09-07,6,Thu,1,1,,KAN,L 27-42,6,55,15,139,21,194,NWE_KAN_2017-09-07
LAC,2023-01-08,5,Sun,17,18,@,DEN,L 28-31,5,34,3,36,8,70,LAC_DEN_2023-01-08
DET,2023-01-08,5,Sun,17,18,@,GNB,W 20-16,5,75,4,35,9,110,DET_GNB_2023-01-08
BAL,2023-01-08,5,Sun,17,18,@,CIN,L 16-27,5,22,3,35,8,57,BAL_CIN_2023-01-08
MIA,2023-01-08,5,Sun,17,18,,NYJ,W 11-6,5,47,6,54,11,101,MIA_NYJ_2023-01-08
KAN,2023-01-07,5,Sat,17,18,@,LVR,W 31-13,5,43,6,47,11,90,KAN_LVR_2023-01-07
KAN,2023-01-01,5,Sun,16,17,,DEN,W 27-24,5,31,3,23,8,54,KAN_DEN_2023-01-01
ATL,2023-01-01,5,Sun,16,17,,ARI,W 20-19,5,70,8,50,13,120,ATL_ARI_2023-01-01
WAS,2023-01-01,5,Sun,16,17,,CLE,L 10-24,5,24,3,20,8,44,WAS_CLE_2023-01-01
SEA,2023-01-01,5,Sun,16,17,,NYJ,W 23-6,5,25,2,10,7,35,SEA_NYJ_2023-01-01
GNB,2022-12-25,5,Sun,15,16,@,MIA,W 26-20,5,40,8,62,13,102,GNB_MIA_2022-12-25
TAM,2022-12-25,5,Sun,15,16,@,ARI,W 19-16 (OT),5,30,6,74,11,104,TAM_ARI_2022-12-25
KAN,2022-12-24,5,Sat,15,16,,SEA,W 24-10,5,39,6,35,11,74,KAN_SEA_2022-12-24
TEN,2022-12-24,5,Sat,15,16,,HOU,L 14-19,5,30,4,35,9,65,TEN_HOU_2022-12-24
ATL,2022-12-24,5,Sat,15,16,@,BAL,L 9-17,5,48,1,6,6,54,ATL_BAL_2022-12-24
CAR,2022-12-18,5,Sun,14,15,,PIT,L 16-24,5,40,7,81,12,121,CAR_PIT_2022-12-18
NYG,2022-12-18,5,Sun,14,15,@,WAS,W 20-12,5,30,6,40,11,70,NYG_WAS_2022-12-18
BAL,2022-12-11,5,Sun,13,14,@,PIT,W 16-14,5,46,2,15,7,61,BAL_PIT_2022-12-11
TEN,2022-12-11,5,Sun,13,14,,JAX,L 22-36,5,50,9,70,14,120,TEN_JAX_2022-12-11
NYG,2022-12-11,5,Sun,13,14,,PHI,L 22-48,5,34,2,9,7,43,NYG_PHI_2022-12-11
BUF,2022-12-11,5,Sun,13,14,,NYJ,W 20-12,5,35,7,61,12,96,BUF_NYJ_2022-12-11
CHI,2022-12-04,5,Sun,13,13,,GNB,L 19-28,5,63,2,20,7,83,CHI_GNB_2022-12-04
HOU,2022-12-04,5,Sun,12,13,,CLE,L 14-27,5,31,6,56,11,87,HOU_CLE_2022-12-04
JAX,2022-12-04,5,Sun,12,13,@,DET,L 14-40,5,24,1,10,6,34,JAX_DET_2022-12-04
CLE,2022-11-27,5,Sun,11,12,,TAM,W 23-17 (OT),5,42,9,70,14,112,CLE_TAM_2022-11-27
HOU,2022-11-27,5,Sun,11,12,@,MIA,L 15-30,5,45,4,35,9,80,HOU_MIA_2022-11-27
LAR,2022-11-27,5,Sun,11,12,@,KAN,L 10-26,5,25,3,25,8,50,LAR_KAN_2022-11-27
BUF,2022-11-24,5,Thu,11,12,@,DET,W 28-25,5,36,3,32,8,68,BUF_DET_2022-11-24
ARI,2022-11-21,5,Mon,11,11,,SFO,L 10-38,5,50,3,30,8,80,ARI_SFO_2022-11-21
WAS,2022-11-20,5,Sun,11,11,@,HOU,W 23-10,5,36,2,15,7,51,WAS_HOU_2022-11-20
DET,2022-11-20,5,Sun,10,11,@,NYG,W 31-18,5,45,8,63,13,108,DET_NYG_2022-11-20
DEN,2022-11-20,5,Sun,10,11,,LVR,L 16-22 (OT),5,45,9,98,14,143,DEN_LVR_2022-11-20
GNB,2022-11-17,5,Thu,11,11,,TEN,L 17-27,5,40,2,19,7,59,GNB_TEN_2022-11-17
WAS,2022-11-14,5,Mon,10,10,@,PHI,W 32-21,5,58,7,75,12,133,WAS_PHI_2022-11-14
LAR,2022-11-13,5,Sun,9,10,,ARI,L 17-27,5,29,10,67,15,96,LAR_ARI_2022-11-13
MIA,2022-11-13,5,Sun,10,10,,CLE,W 39-17,5,43,6,52,11,95,MIA_CLE_2022-11-13
NYG,2022-11-13,5,Sun,9,10,,HOU,W 24-16,5,24,7,40,12,64,NYG_HOU_2022-11-13
JAX,2022-11-13,5,Sun,10,10,@,KAN,L 17-27,5,30,0,0,5,30,JAX_KAN_2022-11-13
SFO,2022-11-13,5,Sun,9,10,,LAC,W 22-16,5,52,1,5,6,57,SFO_LAC_2022-11-13
BAL,2022-11-07,5,Mon,9,9,@,NOR,W 27-13,5,31,5,40,10,71,BAL_NOR_2022-11-07
NOR,2022-11-07,5,Mon,9,9,,BAL,L 13-27,5,40,5,31,10,71,NOR_BAL_2022-11-07
CIN,2022-11-06,5,Sun,9,9,,CAR,W 42-21,5,35,7,50,12,85,CIN_CAR_2022-11-06
LAC,2022-11-06,5,Sun,8,9,@,ATL,W 20-17,5,45,2,15,7,60,LAC_ATL_2022-11-06
LVR,2022-11-06,5,Sun,8,9,@,JAX,L 20-27,5,45,4,30,9,75,LVR_JAX_2022-11-06
MIN,2022-11-06,5,Sun,8,9,@,WAS,W 20-17,5,42,3,26,8,68,MIN_WAS_2022-11-06
JAX,2022-10-30,5,Sun,8,8,,DEN,L 17-21,5,54,12,80,17,134,JAX_DEN_2022-10-30
NOR,2022-10-30,5,Sun,8,8,,LVR,W 24-0,5,27,6,59,11,86,NOR_LVR_2022-10-30
PIT,2022-10-23,5,Sun,7,7,@,MIA,L 10-16,5,40,5,30,10,70,PIT_MIA_2022-10-23
MIA,2022-10-23,5,Sun,7,7,,PIT,W 16-10,5,30,5,40,10,70,MIA_PIT_2022-10-23
CIN,2022-10-23,5,Sun,7,7,,ATL,W 35-17,5,17,3,22,8,39,CIN_ATL_2022-10-23
LVR,2022-10-23,5,Sun,6,7,,HOU,W 38-20,5,44,3,14,8,58,LVR_HOU_2022-10-23
KAN,2022-10-16,5,Sun,6,6,,BUF,L 20-24,5,58,7,35,12,93,KAN_BUF_2022-10-16
ATL,2022-10-16,5,Sun,6,6,,SFO,W 28-14,5,40,5,30,10,70,ATL_SFO_2022-10-16
SFO,2022-10-16,5,Sun,6,6,@,ATL,L 14-28,5,30,5,40,10,70,SFO_ATL_2022-10-16
KAN,2022-10-10,5,Mon,5,5,,LVR,W 30-29,5,72,11,99,16,171,KAN_LVR_2022-10-10
NYJ,2022-10-09,5,Sun,5,5,,MIA,W 40-17,5,105,11,102,16,207,NYJ_MIA_2022-10-09
CAR,2022-10-09,5,Sun,5,5,,SFO,L 15-37,5,33,9,50,14,83,CAR_SFO_2022-10-09
DAL,2022-10-09,5,Sun,5,5,@,LAR,W 22-10,5,42,3,25,8,67,DAL_LAR_2022-10-09
BUF,2022-10-09,5,Sun,5,5,,PIT,W 38-3,5,28,6,54,11,82,BUF_PIT_2022-10-09
MIN,2022-10-02,5,Sun,4,4,@,NOR,W 28-25,5,35,10,102,15,137,MIN_NOR_2022-10-02
TAM,2022-10-02,5,Sun,4,4,,KAN,L 31-41,5,40,4,32,9,72,TAM_KAN_2022-10-02
CHI,2022-10-02,5,Sun,4,4,@,NYG,L 12-20,5,65,7,55,12,120,CHI_NYG_2022-10-02
DEN,2022-09-25,5,Sun,3,3,,SFO,W 11-10,5,30,7,40,12,70,DEN_SFO_2022-09-25
PHI,2022-09-25,5,Sun,3,3,@,WAS,W 24-8,5,52,4,48,9,100,PHI_WAS_2022-09-25
CIN,2022-09-25,5,Sun,3,3,@,NYJ,W 27-12,5,30,4,55,9,85,CIN_NYJ_2022-09-25
CLE,2022-09-22,5,Thu,3,3,,PIT,W 29-17,5,24,5,25,10,49,CLE_PIT_2022-09-22
PIT,2022-09-22,5,Thu,3,3,@,CLE,L 17-29,5,25,5,24,10,49,PIT_CLE_2022-09-22
MIN,2022-09-19,5,Mon,2,2,@,PHI,L 7-24,5,25,8,60,13,85,MIN_PHI_2022-09-19
DAL,2022-09-18,5,Sun,2,2,,CIN,W 20-17,5,45,7,35,12,80,DAL_CIN_2022-09-18
ATL,2022-09-18,5,Sun,2,2,@,LAR,L 27-31,5,29,3,61,8,90,ATL_LAR_2022-09-18
IND,2022-09-18,5,Sun,2,2,@,JAX,L 0-24,5,30,3,19,8,49,IND_JAX_2022-09-18
CAR,2022-09-18,5,Sun,2,2,@,NYG,L 16-19,5,38,8,62,13,100,CAR_NYG_2022-09-18
CLE,2022-09-18,5,Sun,2,2,,NYJ,L 30-31,5,38,8,57,13,95,CLE_NYJ_2022-09-18
SEA,2022-09-12,5,Mon,1,1,,DEN,W 17-16,5,77,12,106,17,183,SEA_DEN_2022-09-12
TAM,2022-09-11,5,Sun,1,1,@,DAL,W 19-3,5,25,10,73,15,98,TAM_DAL_2022-09-11
ARI,2022-09-11,5,Sun,1,1,,KAN,L 21-44,5,49,3,25,8,74,ARI_KAN_2022-09-11
LAC,2022-09-11,5,Sun,1,1,,LVR,W 24-19,5,21,3,11,8,32,LAC_LVR_2022-09-11
BAL,2022-09-11,5,Sun,1,1,@,NYJ,W 24-9,5,29,6,81,11,110,BAL_NYJ_2022-09-11
BUF,2022-09-08,5,Thu,1,1,@,LAR,W 31-10,5,35,4,30,9,65,BUF_LAR_2022-09-08
ATL,2022-01-09,5,Sun,17,18,,NOR,L 20-30,5,46,4,40,9,86,ATL_NOR_2022-01-09
MIA,2022-01-09,5,Sun,17,18,,NWE,W 33-24,5,33,8,78,13,111,MIA_NWE_2022-01-09
TEN,2022-01-09,5,Sun,17,18,@,HOU,W 28-25,5,42,4,65,9,107,TEN_HOU_2022-01-09
DAL,2022-01-08,5,Sat,17,18,@,PHI,W 51-26,5,44,3,30,8,74,DAL_PHI_2022-01-08
KAN,2022-01-08,5,Sat,17,18,@,DEN,W 28-24,5,45,6,45,11,90,KAN_DEN_2022-01-08
PIT,2022-01-03,5,Mon,16,17,,CLE,W 26-14,5,51,10,77,15,128,PIT_CLE_2022-01-03
NOR,2022-01-02,5,Sun,16,17,,CAR,W 18-10,5,33,1,5,6,38,NOR_CAR_2022-01-02
CIN,2022-01-02,5,Sun,16,17,,KAN,W 34-31,5,62,10,83,15,145,CIN_KAN_2022-01-02
CHI,2022-01-02,5,Sun,16,17,,NYG,W 29-3,5,35,3,26,8,61,CHI_NYG_2022-01-02
SEA,2022-01-02,5,Sun,16,17,,DET,W 51-29,5,31,4,30,9,61,SEA_DET_2022-01-02
HOU,2022-01-02,5,Sun,16,17,@,SFO,L 7-23,5,67,7,111,12,178,HOU_SFO_2022-01-02
MIA,2022-01-02,5,Sun,16,17,@,TEN,L 3-34,5,55,6,70,11,125,MIA_TEN_2022-01-02
CIN,2021-12-26,5,Sun,15,16,,BAL,W 41-21,5,45,6,27,11,72,CIN_BAL_2021-12-26
BUF,2021-12-26,5,Sun,15,16,@,NWE,W 33-21,5,45,3,30,8,75,BUF_NWE_2021-12-26
KAN,2021-12-26,5,Sun,15,16,,PIT,W 36-10,5,41,5,40,10,81,KAN_PIT_2021-12-26
LAC,2021-12-26,5,Sun,15,16,@,HOU,L 29-41,5,49,10,70,15,119,LAC_HOU_2021-12-26
PIT,2021-12-26,5,Sun,15,16,@,KAN,L 10-36,5,40,5,41,10,81,PIT_KAN_2021-12-26
IND,2021-12-25,5,Sat,15,16,@,ARI,W 22-16,5,40,11,85,16,125,IND_ARI_2021-12-25
SFO,2021-12-23,5,Thu,15,16,@,TEN,L 17-20,5,41,6,57,11,98,SFO_TEN_2021-12-23
MIA,2021-12-19,5,Sun,14,15,,NYJ,W 31-24,5,45,3,32,8,77,MIA_NYJ_2021-12-19
CAR,2021-12-19,5,Sun,14,15,@,BUF,L 14-31,5,55,8,67,13,122,CAR_BUF_2021-12-19
PIT,2021-12-19,5,Sun,14,15,,TEN,W 19-13,5,30,7,68,12,98,PIT_TEN_2021-12-19
SFO,2021-12-19,5,Sun,14,15,,ATL,W 31-13,5,35,4,29,9,64,SFO_ATL_2021-12-19
LAC,2021-12-16,5,Thu,14,15,,KAN,L 28-34 (OT),5,60,4,36,9,96,LAC_KAN_2021-12-16
LAR,2021-12-13,5,Mon,13,14,@,ARI,W 30-23,5,40,7,54,12,94,LAR_ARI_2021-12-13
NYJ,2021-12-12,5,Sun,13,14,,NOR,L 9-30,5,45,4,42,9,87,NYJ_NOR_2021-12-12
IND,2021-12-05,5,Sun,13,13,@,HOU,W 31-0,5,25,4,25,9,50,IND_HOU_2021-12-05
DEN,2021-12-05,5,Sun,12,13,@,KAN,L 9-22,5,37,7,60,12,97,DEN_KAN_2021-12-05
PIT,2021-12-05,5,Sun,12,13,,BAL,W 20-19,5,81,10,55,15,136,PIT_BAL_2021-12-05
DAL,2021-12-02,5,Thu,12,13,@,NOR,W 27-17,5,35,7,59,12,94,DAL_NOR_2021-12-02
TEN,2021-11-28,5,Sun,12,12,@,NWE,L 13-36,5,50,4,35,9,85,TEN_NWE_2021-11-28
MIA,2021-11-28,5,Sun,12,12,,CAR,W 33-10,5,35,7,61,12,96,MIA_CAR_2021-11-28
BAL,2021-11-28,5,Sun,11,12,,CLE,W 16-10,5,54,5,45,10,99,BAL_CLE_2021-11-28
NYJ,2021-11-28,5,Sun,11,12,@,HOU,W 21-14,5,40,4,32,9,72,NYJ_HOU_2021-11-28
ATL,2021-11-28,5,Sun,11,12,@,JAX,W 21-14,5,26,6,43,11,69,ATL_JAX_2021-11-28
CLE,2021-11-28,5,Sun,12,12,@,BAL,L 10-16,5,45,5,54,10,99,CLE_BAL_2021-11-28
SFO,2021-11-28,5,Sun,11,12,,MIN,W 34-26,5,57,5,38,10,95,SFO_MIN_2021-11-28
DEN,2021-11-28,5,Sun,11,12,,LAC,W 28-13,5,35,9,75,14,110,DEN_LAC_2021-11-28
MIN,2021-11-28,5,Sun,11,12,@,SFO,L 26-34,5,38,5,57,10,95,MIN_SFO_2021-11-28
CHI,2021-11-25,5,Thu,11,12,@,DET,W 16-14,5,50,10,67,15,117,CHI_DET_2021-11-25
TEN,2021-11-21,5,Sun,11,11,,HOU,L 13-22,5,52,7,50,12,102,TEN_HOU_2021-11-21
NWE,2021-11-18,5,Thu,11,11,@,ATL,W 25-0,5,59,9,72,14,131,NWE_ATL_2021-11-18
LAR,2021-11-15,5,Mon,10,10,@,SFO,L 10-31,5,35,9,53,14,88,LAR_SFO_2021-11-15
SEA,2021-11-14,5,Sun,9,10,@,GNB,L 0-17,5,39,3,43,8,82,SEA_GNB_2021-11-14
PIT,2021-11-08,5,Mon,8,9,,CHI,W 29-27,5,30,12,115,17,145,PIT_CHI_2021-11-08
DAL,2021-11-07,5,Sun,8,9,,DEN,L 16-30,5,38,5,37,10,75,DAL_DEN_2021-11-07
DEN,2021-11-07,5,Sun,9,9,@,DAL,W 30-16,5,37,5,38,10,75,DEN_DAL_2021-11-07
LAC,2021-10-31,5,Sun,7,8,,NWE,L 24-27,5,40,4,30,9,70,LAC_NWE_2021-10-31
CLE,2021-10-31,5,Sun,8,8,,PIT,L 10-15,5,30,8,65,13,95,CLE_PIT_2021-10-31
SEA,2021-10-31,5,Sun,8,8,,JAX,W 31-7,5,40,12,93,17,133,SEA_JAX_2021-10-31
CIN,2021-10-31,5,Sun,8,8,@,NYJ,L 31-34,5,51,8,46,13,97,CIN_NYJ_2021-10-31
BAL,2021-10-24,5,Sun,7,7,,CIN,L 17-41,5,46,1,5,6,51,BAL_CIN_2021-10-24
NYJ,2021-10-24,5,Sun,6,7,@,NWE,L 13-54,5,29,6,95,11,124,NYJ_NWE_2021-10-24
PIT,2021-10-17,5,Sun,6,6,,SEA,W 23-20 (OT),5,38,6,45,11,83,PIT_SEA_2021-10-17
ARI,2021-10-17,5,Sun,6,6,@,CLE,W 37-14,5,45,9,88,14,133,ARI_CLE_2021-10-17
NWE,2021-10-17,5,Sun,6,6,,DAL,L 29-35 (OT),5,47,12,115,17,162,NWE_DAL_2021-10-17
KAN,2021-10-17,5,Sun,6,6,@,WAS,W 31-13,5,47,6,44,11,91,KAN_WAS_2021-10-17
NYG,2021-10-17,5,Sun,6,6,,LAR,L 11-38,5,27,7,50,12,77,NYG_LAR_2021-10-17
IND,2021-10-11,5,Mon,5,5,@,BAL,L 25-31 (OT),5,45,8,74,13,119,IND_BAL_2021-10-11
MIA,2021-10-10,5,Sun,5,5,@,TAM,L 17-45,5,37,6,47,11,84,MIA_TAM_2021-10-10
WAS,2021-10-10,5,Sun,5,5,,NOR,L 22-33,5,37,6,45,11,82,WAS_NOR_2021-10-10
NWE,2021-10-10,5,Sun,5,5,@,HOU,W 25-22,5,27,8,70,13,97,NWE_HOU_2021-10-10
NYG,2021-10-10,5,Sun,5,5,@,DAL,L 20-44,5,48,8,58,13,106,NYG_DAL_2021-10-10
LAR,2021-10-07,5,Thu,5,5,@,SEA,W 26-17,5,85,3,20,8,105,LAR_SEA_2021-10-07
NOR,2021-10-03,5,Sun,4,4,,NYG,L 21-27 (OT),5,35,3,25,8,60,NOR_NYG_2021-10-03
MIA,2021-10-03,5,Sun,4,4,,IND,L 17-27,5,32,8,86,13,118,MIA_IND_2021-10-03
PIT,2021-10-03,5,Sun,4,4,@,GNB,L 17-27,5,34,3,25,8,59,PIT_GNB_2021-10-03
SEA,2021-10-03,5,Sun,4,4,@,SFO,W 28-21,5,27,8,78,13,105,SEA_SFO_2021-10-03
LAR,2021-10-03,5,Sun,4,4,,ARI,L 20-37,5,36,7,63,12,99,LAR_ARI_2021-10-03
BUF,2021-09-26,5,Sun,3,3,,WAS,W 43-21,5,30,5,38,10,68,BUF_WAS_2021-09-26
WAS,2021-09-26,5,Sun,3,3,@,BUF,L 21-43,5,38,5,30,10,68,WAS_BUF_2021-09-26
CHI,2021-09-26,5,Sun,3,3,@,CLE,L 6-26,5,49,7,98,12,147,CHI_CLE_2021-09-26
GNB,2021-09-20,5,Mon,2,2,,DET,W 35-17,5,50,9,78,14,128,GNB_DET_2021-09-20
KAN,2021-09-19,5,Sun,2,2,@,BAL,L 35-36,5,46,8,55,13,101,KAN_BAL_2021-09-19
ARI,2021-09-19,5,Sun,2,2,,MIN,W 34-33,5,40,3,16,8,56,ARI_MIN_2021-09-19
PIT,2021-09-19,5,Sun,2,2,,LVR,L 17-26,5,43,5,40,10,83,PIT_LVR_2021-09-19
SFO,2021-09-19,5,Sun,2,2,@,PHI,W 17-11,5,60,8,57,13,117,SFO_PHI_2021-09-19
CAR,2021-09-19,5,Sun,2,2,,NOR,W 26-7,5,49,11,115,16,164,CAR_NOR_2021-09-19
TEN,2021-09-19,5,Sun,2,2,@,SEA,W 33-30 (OT),5,45,10,100,15,145,TEN_SEA_2021-09-19
LVR,2021-09-19,5,Sun,2,2,@,PIT,W 26-17,5,40,5,43,10,83,LVR_PIT_2021-09-19
CLE,2021-09-19,5,Sun,2,2,,HOU,W 31-21,5,62,9,78,14,140,CLE_HOU_2021-09-19
BAL,2021-09-13,5,Mon,1,1,@,LVR,L 27-33 (OT),5,71,10,62,15,133,BAL_LVR_2021-09-13
PIT,2021-09-12,5,Sun,1,1,@,BUF,W 23-16,5,32,8,81,13,113,PIT_BUF_2021-09-12
DET,2021-09-12,5,Sun,1,1,,SFO,L 33-41,5,45,7,79,12,124,DET_SFO_2021-09-12
GNB,2021-09-12,5,Sun,1,1,@,NOR,L 3-38,5,33,6,36,11,69,GNB_NOR_2021-09-12
MIA,2021-09-12,5,Sun,1,1,@,NWE,W 17-16,5,28,8,84,13,112,MIA_NWE_2021-09-12
NYJ,2021-09-12,5,Sun,1,1,@,CAR,L 14-19,5,30,6,38,11,68,NYJ_CAR_2021-09-12
KAN,2021-09-12,5,Sun,1,1,,CLE,W 33-29,5,36,5,30,10,66,KAN_CLE_2021-09-12
HOU,2021-09-12,5,Sun,1,1,,JAX,W 37-21,5,50,10,82,15,132,HOU_JAX_2021-09-12
CLE,2021-09-12,5,Sun,1,1,@,KAN,L 29-33,5,30,5,36,10,66,CLE_KAN_2021-09-12
DEN,2021-09-12,5,Sun,1,1,@,NYG,W 27-13,5,51,4,48,9,99,DEN_NYG_2021-09-12
KAN,2021-01-03,5,Sun,16,17,,LAC,L 21-38,5,69,4,23,9,92,KAN_LAC_2021-01-03
WAS,2021-01-03,5,Sun,16,17,@,PHI,W 20-14,5,56,6,41,11,97,WAS_PHI_2021-01-03
LAR,2021-01-03,5,Sun,16,17,,ARI,W 18-7,5,38,6,38,11,76,LAR_ARI_2021-01-03
SEA,2020-12-27,5,Sun,15,16,,LAR,W 20-9,5,31,5,45,10,76,SEA_LAR_2020-12-27
LAR,2020-12-27,5,Sun,15,16,@,SEA,L 9-20,5,45,5,31,10,76,LAR_SEA_2020-12-27
WAS,2020-12-27,5,Sun,15,16,,CAR,L 13-20,5,26,3,35,8,61,WAS_CAR_2020-12-27
CIN,2020-12-27,5,Sun,15,16,@,HOU,W 37-31,5,35,6,46,11,81,CIN_HOU_2020-12-27
NYG,2020-12-27,5,Sun,15,16,@,BAL,L 13-27,5,35,10,65,15,100,NYG_BAL_2020-12-27
DAL,2020-12-27,5,Sun,15,16,,PHI,W 37-17,5,73,12,115,17,188,DAL_PHI_2020-12-27
MIA,2020-12-26,5,Sat,15,16,@,LVR,W 26-25,5,76,4,40,9,116,MIA_LVR_2020-12-26
KAN,2020-12-20,5,Sun,14,15,@,NOR,W 32-29,5,54,10,93,15,147,KAN_NOR_2020-12-20
HOU,2020-12-20,5,Sun,14,15,@,IND,L 20-27,5,24,4,35,9,59,HOU_IND_2020-12-20
LAR,2020-12-20,5,Sun,14,15,,NYJ,L 20-23,5,43,6,61,11,104,LAR_NYJ_2020-12-20
DAL,2020-12-20,5,Sun,14,15,,SFO,W 41-33,5,58,4,39,9,97,DAL_SFO_2020-12-20
GNB,2020-12-19,5,Sat,14,15,,CAR,W 24-16,5,50,7,66,12,116,GNB_CAR_2020-12-19
SFO,2020-12-13,5,Sun,13,14,,WAS,L 15-23,5,35,5,30,10,65,SFO_WAS_2020-12-13
TAM,2020-12-13,5,Sun,13,14,,MIN,W 26-14,5,34,5,71,10,105,TAM_MIN_2020-12-13
MIN,2020-12-13,5,Sun,13,14,@,TAM,L 14-26,5,71,5,34,10,105,MIN_TAM_2020-12-13
WAS,2020-12-13,5,Sun,13,14,@,SFO,W 23-15,5,30,5,35,10,65,WAS_SFO_2020-12-13
DAL,2020-12-13,5,Sun,13,14,@,CIN,W 30-7,5,30,3,25,8,55,DAL_CIN_2020-12-13
NWE,2020-12-10,5,Thu,13,14,@,LAR,L 3-24,5,27,5,35,10,62,NWE_LAR_2020-12-10
LAR,2020-12-10,5,Thu,13,14,,NWE,W 24-3,5,35,5,27,10,62,LAR_NWE_2020-12-10
ARI,2020-12-06,5,Sun,12,13,,LAR,L 28-38,5,21,6,75,11,96,ARI_LAR_2020-12-06
LAC,2020-12-06,5,Sun,12,13,,NWE,L 0-45,5,30,3,15,8,45,LAC_NWE_2020-12-06
TEN,2020-12-06,5,Sun,12,13,,CLE,L 35-41,5,52,13,92,18,144,TEN_CLE_2020-12-06
GNB,2020-12-06,5,Sun,12,13,,PHI,W 30-16,5,30,4,40,9,70,GNB_PHI_2020-12-06
KAN,2020-12-06,5,Sun,12,13,,DEN,W 22-16,5,44,4,31,9,75,KAN_DEN_2020-12-06
PIT,2020-12-02,5,Wed,11,12,,BAL,W 19-14,5,40,7,86,12,126,PIT_BAL_2020-12-02
SFO,2020-11-29,5,Sun,11,12,@,LAR,W 23-20,5,40,3,27,8,67,SFO_LAR_2020-11-29
JAX,2020-11-29,5,Sun,11,12,,CLE,L 25-27,5,24,6,47,11,71,JAX_CLE_2020-11-29
NOR,2020-11-29,5,Sun,11,12,@,DEN,W 31-3,5,35,2,10,7,45,NOR_DEN_2020-11-29
LAC,2020-11-29,5,Sun,11,12,@,BUF,L 17-27,5,91,9,85,14,176,LAC_BUF_2020-11-29
CHI,2020-11-29,5,Sun,11,12,@,GNB,L 25-41,5,45,3,17,8,62,CHI_GNB_2020-11-29
NYG,2020-11-29,5,Sun,11,12,@,CIN,W 19-17,5,51,3,27,8,78,NYG_CIN_2020-11-29
WAS,2020-11-26,5,Thu,11,12,@,DAL,W 41-16,5,53,5,45,10,98,WAS_DAL_2020-11-26
DAL,2020-11-26,5,Thu,11,12,,WAS,L 16-41,5,45,5,53,10,98,DAL_WAS_2020-11-26
LAR,2020-11-23,5,Mon,10,11,@,TAM,W 27-24,5,65,2,7,7,72,LAR_TAM_2020-11-23
HOU,2020-11-22,5,Sun,10,11,,NWE,W 27-20,5,35,7,55,12,90,HOU_NWE_2020-11-22
NOR,2020-11-22,5,Sun,10,11,,ATL,W 24-9,5,35,7,53,12,88,NOR_ATL_2020-11-22
PHI,2020-11-22,5,Sun,10,11,@,CLE,L 17-22,5,33,3,53,8,86,PHI_CLE_2020-11-22
MIA,2020-11-22,5,Sun,10,11,@,DEN,L 13-20,5,50,8,70,13,120,MIA_DEN_2020-11-22
CAR,2020-11-15,5,Sun,10,10,,TAM,L 23-46,5,40,3,30,8,70,CAR_TAM_2020-11-15
LAC,2020-11-15,5,Sun,9,10,@,MIA,L 21-29,5,31,3,15,8,46,LAC_MIA_2020-11-15
NOR,2020-11-15,5,Sun,9,10,,SFO,W 27-13,5,61,6,51,11,112,NOR_SFO_2020-11-15
TAM,2020-11-08,5,Sun,9,9,,NOR,L 3-38,5,39,3,28,8,67,TAM_NOR_2020-11-08
DEN,2020-11-08,5,Sun,8,9,@,ATL,L 27-34,5,65,5,61,10,126,DEN_ATL_2020-11-08
BAL,2020-11-08,5,Sun,8,9,@,IND,W 24-10,5,55,4,30,9,85,BAL_IND_2020-11-08
LAC,2020-11-08,5,Sun,8,9,,LVR,L 26-31,5,45,2,10,7,55,LAC_LVR_2020-11-08
ATL,2020-11-08,5,Sun,9,9,,DEN,W 34-27,5,61,5,65,10,126,ATL_DEN_2020-11-08
CHI,2020-11-08,5,Sun,9,9,@,TEN,L 17-24,5,35,6,57,11,92,CHI_TEN_2020-11-08
GNB,2020-11-05,5,Thu,8,9,@,SFO,W 34-17,5,45,4,33,9,78,GNB_SFO_2020-11-05
BUF,2020-11-01,5,Sun,8,8,,NWE,W 24-21,5,30,5,35,10,65,BUF_NWE_2020-11-01
LVR,2020-11-01,5,Sun,7,8,@,CLE,W 16-6,5,25,7,59,12,84,LVR_CLE_2020-11-01
NWE,2020-11-01,5,Sun,7,8,@,BUF,L 21-24,5,35,5,30,10,65,NWE_BUF_2020-11-01
LAR,2020-11-01,5,Sun,8,8,@,MIA,L 17-28,5,45,3,30,8,75,LAR_MIA_2020-11-01
NOR,2020-11-01,5,Sun,7,8,@,CHI,W 26-23 (OT),5,45,7,53,12,98,NOR_CHI_2020-11-01
DET,2020-10-25,5,Sun,6,7,@,ATL,W 23-22,5,50,8,53,13,103,DET_ATL_2020-10-25
GNB,2020-10-25,5,Sun,6,7,@,HOU,W 35-20,5,40,6,55,11,95,GNB_HOU_2020-10-25
DEN,2020-10-25,5,Sun,6,7,,KAN,L 16-43,5,34,1,15,6,49,DEN_KAN_2020-10-25
CLE,2020-10-25,5,Sun,7,7,@,CIN,W 37-34,5,40,7,45,12,85,CLE_CIN_2020-10-25
ATL,2020-10-18,5,Sun,6,6,@,MIN,W 40-23,5,25,3,30,8,55,ATL_MIN_2020-10-18
JAX,2020-10-18,5,Sun,6,6,,DET,L 16-34,5,56,7,60,12,116,JAX_DET_2020-10-18
MIA,2020-10-18,5,Sun,6,6,,NYJ,W 24-0,5,25,7,80,12,105,MIA_NYJ_2020-10-18
NOR,2020-10-12,5,Mon,5,5,,LAC,W 30-27 (OT),5,60,1,10,6,70,NOR_LAC_2020-10-12
IND,2020-10-11,5,Sun,5,5,@,CLE,L 23-32,5,34,2,10,7,44,IND_CLE_2020-10-11
HOU,2020-10-11,5,Sun,5,5,,JAX,W 30-14,5,25,4,35,9,60,HOU_JAX_2020-10-11
LAR,2020-10-11,5,Sun,5,5,@,WAS,W 30-10,5,60,3,40,8,100,LAR_WAS_2020-10-11
CIN,2020-10-11,5,Sun,5,5,@,BAL,L 3-27,5,40,4,25,9,65,CIN_BAL_2020-10-11
DET,2020-10-04,5,Sun,4,4,,NOR,L 29-35,5,49,4,67,9,116,DET_NOR_2020-10-04
ARI,2020-10-04,5,Sun,4,4,@,CAR,L 21-31,5,29,10,72,15,101,ARI_CAR_2020-10-04
CLE,2020-10-04,5,Sun,4,4,@,DAL,W 49-38,5,40,6,65,11,105,CLE_DAL_2020-10-04
BAL,2020-10-04,5,Sun,4,4,@,WAS,W 31-17,5,30,2,20,7,50,BAL_WAS_2020-10-04
BUF,2020-10-04,5,Sun,4,4,@,LVR,W 30-23,5,81,7,65,12,146,BUF_LVR_2020-10-04
BUF,2020-09-27,5,Sun,3,3,,LAR,W 35-32,5,55,3,30,8,85,BUF_LAR_2020-09-27
SEA,2020-09-27,5,Sun,3,3,,DAL,W 38-31,5,30,10,59,15,89,SEA_DAL_2020-09-27
NYG,2020-09-27,5,Sun,3,3,,SFO,L 9-36,5,28,6,45,11,73,NYG_SFO_2020-09-27
PHI,2020-09-20,5,Sun,2,2,,LAR,L 19-37,5,30,4,24,9,54,PHI_LAR_2020-09-20
TAM,2020-09-20,5,Sun,2,2,,CAR,W 31-17,5,37,9,77,14,114,TAM_CAR_2020-09-20
CHI,2020-09-20,5,Sun,2,2,,NYG,W 17-13,5,48,3,10,8,58,CHI_NYG_2020-09-20
SFO,2020-09-20,5,Sun,2,2,@,NYJ,W 31-13,5,59,5,65,10,124,SFO_NYJ_2020-09-20
NYJ,2020-09-20,5,Sun,2,2,,SFO,L 13-31,5,65,5,59,10,124,NYJ_SFO_2020-09-20
TEN,2020-09-14,5,Mon,1,1,@,DEN,W 16-14,5,37,5,56,10,93,TEN_DEN_2020-09-14
DEN,2020-09-14,5,Mon,1,1,,TEN,L 14-16,5,56,5,37,10,93,DEN_TEN_2020-09-14
IND,2020-09-13,5,Sun,1,1,@,JAX,L 20-27,5,80,6,61,11,141,IND_JAX_2020-09-13
LAR,2020-09-13,5,Sun,1,1,,DAL,W 20-17,5,34,7,50,12,84,LAR_DAL_2020-09-13
CAR,2020-09-13,5,Sun,1,1,,LVR,L 30-34,5,65,3,40,8,105,CAR_LVR_2020-09-13
MIN,2020-09-13,5,Sun,1,1,,GNB,L 34-43,5,20,6,63,11,83,MIN_GNB_2020-09-13
SFO,2020-09-13,5,Sun,1,1,,ARI,L 20-24,5,53,9,102,14,155,SFO_ARI_2020-09-13
HOU,2020-09-10,5,Thu,1,1,@,KAN,L 20-34,5,37,1,5,6,42,HOU_KAN_2020-09-10
CAR,2019-12-29,5,Sun,16,17,,NOR,L 10-42,5,54,3,44,8,98,CAR_NOR_2019-12-29
TEN,2019-12-29,5,Sun,16,17,@,HOU,W 35-14,5,37,5,35,10,72,TEN_HOU_2019-12-29
KAN,2019-12-29,5,Sun,16,17,,LAC,W 31-21,5,39,8,40,13,79,KAN_LAC_2019-12-29
BUF,2019-12-29,5,Sun,16,17,,NYJ,L 6-13,5,40,2,13,7,53,BUF_NYJ_2019-12-29
ATL,2019-12-29,5,Sun,16,17,@,TAM,W 28-22 (OT),5,53,12,97,17,150,ATL_TAM_2019-12-29
SEA,2019-12-29,5,Sun,16,17,,SFO,L 21-26,5,29,8,57,13,86,SEA_SFO_2019-12-29
HOU,2019-12-29,5,Sun,16,17,,TEN,L 14-35,5,35,5,37,10,72,HOU_TEN_2019-12-29
ARI,2019-12-22,5,Sun,15,16,@,SEA,W 27-13,5,47,7,55,12,102,ARI_SEA_2019-12-22
OAK,2019-12-22,5,Sun,15,16,@,LAC,W 24-17,5,47,2,15,7,62,OAK_LAC_2019-12-22
CIN,2019-12-15,5,Sun,14,15,,NWE,L 13-34,5,25,4,30,9,55,CIN_NWE_2019-12-15
SEA,2019-12-15,5,Sun,14,15,@,CAR,W 30-24,5,40,2,15,7,55,SEA_CAR_2019-12-15
ARI,2019-12-15,5,Sun,14,15,,CLE,W 38-24,5,34,6,55,11,89,ARI_CLE_2019-12-15
LAR,2019-12-15,5,Sun,14,15,@,DAL,L 21-44,5,29,4,16,9,45,LAR_DAL_2019-12-15
LAC,2019-12-15,5,Sun,14,15,,MIN,L 10-39,5,48,5,41,10,89,LAC_MIN_2019-12-15
MIN,2019-12-15,5,Sun,14,15,@,LAC,W 39-10,5,41,5,48,10,89,MIN_LAC_2019-12-15
WAS,2019-12-15,5,Sun,14,15,,PHI,L 27-37,5,60,7,54,12,114,WAS_PHI_2019-12-15
KAN,2019-12-15,5,Sun,14,15,,DEN,W 23-3,5,45,7,72,12,117,KAN_DEN_2019-12-15
HOU,2019-12-15,5,Sun,14,15,@,TEN,W 24-21,5,27,4,30,9,57,HOU_TEN_2019-12-15
MIA,2019-12-08,5,Sun,13,14,@,NYJ,L 21-22,5,48,5,88,10,136,MIA_NYJ_2019-12-08
NYJ,2019-12-08,5,Sun,13,14,,MIA,W 22-21,5,88,5,48,10,136,NYJ_MIA_2019-12-08
NOR,2019-12-08,5,Sun,13,14,,SFO,L 46-48,5,50,10,67,15,117,NOR_SFO_2019-12-08
NWE,2019-12-08,5,Sun,13,14,,KAN,L 16-23,5,25,10,136,15,161,NWE_KAN_2019-12-08
GNB,2019-12-08,5,Sun,13,14,,WAS,W 20-15,5,34,3,25,8,59,GNB_WAS_2019-12-08
BUF,2019-12-08,5,Sun,13,14,,BAL,L 17-24,5,49,9,99,14,148,BUF_BAL_2019-12-08
CLE,2019-12-01,5,Sun,12,13,@,PIT,L 13-20,5,34,10,65,15,99,CLE_PIT_2019-12-01
CAR,2019-12-01,5,Sun,12,13,,WAS,L 21-29,5,43,6,65,11,108,CAR_WAS_2019-12-01
DAL,2019-11-28,5,Thu,12,13,,BUF,L 15-26,5,66,7,53,12,119,DAL_BUF_2019-11-28
GNB,2019-11-24,5,Sun,11,12,@,SFO,L 8-37,5,50,9,78,14,128,GNB_SFO_2019-11-24
MIN,2019-11-17,5,Sun,11,11,,DEN,W 27-23,5,49,6,35,11,84,MIN_DEN_2019-11-17
BUF,2019-11-17,5,Sun,10,11,@,MIA,W 37-20,5,50,6,44,11,94,BUF_MIA_2019-11-17
HOU,2019-11-17,5,Sun,10,11,@,BAL,L 7-41,5,60,8,65,13,125,HOU_BAL_2019-11-17
SFO,2019-11-11,5,Mon,9,10,,SEA,L 24-27 (OT),5,40,9,75,14,115,SFO_SEA_2019-11-11
MIN,2019-11-10,5,Sun,10,10,@,DAL,W 28-24,5,35,5,39,10,74,MIN_DAL_2019-11-10
DAL,2019-11-10,5,Sun,9,10,,MIN,L 24-28,5,39,5,35,10,74,DAL_MIN_2019-11-10
CAR,2019-11-10,5,Sun,9,10,@,GNB,L 16-24,5,46,10,64,15,110,CAR_GNB_2019-11-10
BAL,2019-11-10,5,Sun,9,10,@,CIN,W 49-13,5,35,1,5,6,40,BAL_CIN_2019-11-10
CLE,2019-11-03,5,Sun,8,9,@,DEN,L 19-24,5,40,7,55,12,95,CLE_DEN_2019-11-03
LAC,2019-11-03,5,Sun,9,9,,GNB,W 26-11,5,45,8,45,13,90,LAC_GNB_2019-11-03
PIT,2019-11-03,5,Sun,8,9,,IND,W 26-24,5,70,7,89,12,159,PIT_IND_2019-11-03
DET,2019-11-03,5,Sun,8,9,@,OAK,L 24-31,5,35,10,96,15,131,DET_OAK_2019-11-03
MIA,2019-10-28,5,Mon,7,8,@,PIT,L 14-27,5,45,9,70,14,115,MIA_PIT_2019-10-28
ARI,2019-10-27,5,Sun,8,8,@,NOR,L 9-31,5,35,2,15,7,50,ARI_NOR_2019-10-27
ATL,2019-10-27,5,Sun,8,8,,SEA,L 20-27,5,40,9,60,14,100,ATL_SEA_2019-10-27
NYG,2019-10-27,5,Sun,8,8,@,DET,L 26-31,5,44,7,75,12,119,NYG_DET_2019-10-27
CHI,2019-10-27,5,Sun,7,8,,LAC,L 16-17,5,42,8,53,13,95,CHI_LAC_2019-10-27
ATL,2019-10-20,5,Sun,7,7,,LAR,L 10-37,5,48,5,24,10,72,ATL_LAR_2019-10-20
LAR,2019-10-20,5,Sun,7,7,@,ATL,W 37-10,5,24,5,48,10,72,LAR_ATL_2019-10-20
PHI,2019-10-20,5,Sun,7,7,@,DAL,L 10-37,5,40,6,65,11,105,PHI_DAL_2019-10-20
MIA,2019-10-13,5,Sun,5,6,,WAS,L 16-17,5,45,6,56,11,101,MIA_WAS_2019-10-13
NYG,2019-10-10,5,Thu,6,6,@,NWE,L 14-35,5,40,3,20,8,60,NYG_NWE_2019-10-10
NYG,2019-10-06,5,Sun,5,5,,MIN,L 10-28,5,45,12,112,17,157,NYG_MIN_2019-10-06
SEA,2019-10-03,5,Thu,5,5,,LAR,W 30-29,5,45,6,45,11,90,SEA_LAR_2019-10-03
TEN,2019-09-29,5,Sun,4,4,@,ATL,W 24-10,5,77,7,50,12,127,TEN_ATL_2019-09-29
DEN,2019-09-29,5,Sun,4,4,,JAX,L 24-26,5,48,12,104,17,152,DEN_JAX_2019-09-29
NYG,2019-09-29,5,Sun,4,4,,WAS,W 24-3,5,45,12,58,17,103,NYG_WAS_2019-09-29
IND,2019-09-29,5,Sun,4,4,,OAK,L 24-31,5,35,11,80,16,115,IND_OAK_2019-09-29
MIA,2019-09-29,5,Sun,4,4,,LAC,L 10-30,5,53,10,89,15,142,MIA_LAC_2019-09-29
GNB,2019-09-26,5,Thu,4,4,,PHI,L 27-34,5,50,9,93,14,143,GNB_PHI_2019-09-26
NYJ,2019-09-22,5,Sun,3,3,@,NWE,L 14-30,5,67,8,70,13,137,NYJ_NWE_2019-09-22
SFO,2019-09-22,5,Sun,3,3,,PIT,W 24-20,5,71,6,42,11,113,SFO_PIT_2019-09-22
MIA,2019-09-22,5,Sun,3,3,@,DAL,L 6-31,5,35,8,100,13,135,MIA_DAL_2019-09-22
PIT,2019-09-15,5,Sun,2,2,,SEA,L 26-28,5,78,10,93,15,171,PIT_SEA_2019-09-15
TEN,2019-09-15,5,Sun,2,2,,IND,L 17-19,5,75,8,65,13,140,TEN_IND_2019-09-15
NWE,2019-09-15,5,Sun,2,2,@,MIA,W 43-0,5,54,4,22,9,76,NWE_MIA_2019-09-15
CAR,2019-09-12,5,Thu,2,2,,TAM,L 14-20,5,50,12,66,17,116,CAR_TAM_2019-09-12
LAR,2019-09-08,5,Sun,1,1,@,CAR,W 30-27,5,43,6,46,11,89,LAR_CAR_2019-09-08
KAN,2019-09-08,5,Sun,1,1,@,JAX,W 40-26,5,55,10,71,15,126,KAN_JAX_2019-09-08
PHI,2018-12-30,5,Sun,16,17,@,WAS,W 24-0,5,25,2,15,7,40,PHI_WAS_2018-12-30
GNB,2018-12-30,5,Sun,16,17,,DET,L 0-31,5,38,3,34,8,72,GNB_DET_2018-12-30
SFO,2018-12-30,5,Sun,16,17,@,LAR,L 32-48,5,41,6,57,11,98,SFO_LAR_2018-12-30
NWE,2018-12-23,5,Sun,15,16,,BUF,W 24-12,5,49,3,29,8,78,NWE_BUF_2018-12-23
LAR,2018-12-16,5,Sun,14,15,,PHI,L 23-30,5,50,6,49,11,99,LAR_PHI_2018-12-16
HOU,2018-12-15,5,Sat,14,15,@,NYJ,W 29-22,5,43,9,60,14,103,HOU_NYJ_2018-12-15
NWE,2018-12-09,5,Sun,13,14,@,MIA,L 33-34,5,30,7,81,12,111,NWE_MIA_2018-12-09
PHI,2018-12-09,5,Sun,13,14,@,DAL,L 23-29 (OT),5,49,11,110,16,159,PHI_DAL_2018-12-09
PHI,2018-12-03,5,Mon,12,13,,WAS,W 28-13,5,38,10,69,15,107,PHI_WAS_2018-12-03
MIN,2018-12-02,5,Sun,12,13,@,NWE,L 10-24,5,55,7,60,12,115,MIN_NWE_2018-12-02
LAC,2018-12-02,5,Sun,12,13,@,PIT,W 33-30,5,80,7,59,12,139,LAC_PIT_2018-12-02
HOU,2018-12-02,5,Sun,12,13,,CLE,W 29-13,5,77,6,45,11,122,HOU_CLE_2018-12-02
NOR,2018-11-29,5,Thu,12,13,@,DAL,L 10-13,5,48,8,80,13,128,NOR_DAL_2018-11-29
PIT,2018-11-25,5,Sun,11,12,@,DEN,L 17-24,5,34,6,50,11,84,PIT_DEN_2018-11-25
DET,2018-11-22,5,Thu,11,12,,CHI,L 16-23,5,54,3,20,8,74,DET_CHI_2018-11-22
CHI,2018-11-18,5,Sun,10,11,,MIN,W 25-20,5,46,4,50,9,96,CHI_MIN_2018-11-18
BAL,2018-11-18,5,Sun,10,11,,CIN,W 24-21,5,31,7,58,12,89,BAL_CIN_2018-11-18
GNB,2018-11-15,5,Thu,10,11,@,SEA,L 24-27,5,80,6,30,11,110,GNB_SEA_2018-11-15
TAM,2018-11-11,5,Sun,9,10,,WAS,L 3-16,5,50,8,52,13,102,TAM_WAS_2018-11-11
DAL,2018-11-11,5,Sun,9,10,@,PHI,W 27-20,5,37,0,0,5,37,DAL_PHI_2018-11-11
CAR,2018-11-08,5,Thu,9,10,@,PIT,L 21-52,5,42,1,24,6,66,CAR_PIT_2018-11-08
MIA,2018-11-04,5,Sun,9,9,,NYJ,W 13-6,5,55,5,45,10,100,MIA_NYJ_2018-11-04
NYJ,2018-11-04,5,Sun,9,9,@,MIA,L 6-13,5,45,5,55,10,100,NYJ_MIA_2018-11-04
NWE,2018-11-04,5,Sun,9,9,,GNB,W 31-17,5,30,7,63,12,93,NWE_GNB_2018-11-04
BAL,2018-11-04,5,Sun,9,9,,PIT,L 16-23,5,25,8,103,13,128,BAL_PIT_2018-11-04
NWE,2018-10-29,5,Mon,8,8,@,BUF,W 25-6,5,33,6,51,11,84,NWE_BUF_2018-10-29
JAX,2018-10-28,5,Sun,8,8,,PHI,L 18-24,5,45,4,36,9,81,JAX_PHI_2018-10-28
SFO,2018-10-28,5,Sun,8,8,@,ARI,L 15-18,5,59,9,62,14,121,SFO_ARI_2018-10-28
MIA,2018-10-25,5,Thu,8,8,@,HOU,L 23-42,5,63,8,57,13,120,MIA_HOU_2018-10-25
ATL,2018-10-22,5,Mon,7,7,,NYG,W 23-20,5,29,4,58,9,87,ATL_NYG_2018-10-22
CAR,2018-10-21,5,Sun,6,7,@,PHI,W 21-17,5,78,4,35,9,113,CAR_PHI_2018-10-21
BAL,2018-10-21,5,Sun,7,7,,NOR,L 23-24,5,54,6,52,11,106,BAL_NOR_2018-10-21
CHI,2018-10-21,5,Sun,6,7,,NWE,L 31-38,5,40,7,64,12,104,CHI_NWE_2018-10-21
WAS,2018-10-21,5,Sun,6,7,,DAL,W 20-17,5,35,8,65,13,100,WAS_DAL_2018-10-21
DEN,2018-10-18,5,Thu,7,7,@,ARI,W 45-10,5,50,7,45,12,95,DEN_ARI_2018-10-18
ARI,2018-10-14,5,Sun,6,6,@,MIN,L 17-27,5,30,9,52,14,82,ARI_MIN_2018-10-14
ATL,2018-10-14,5,Sun,6,6,,TAM,W 34-29,5,30,4,20,9,50,ATL_TAM_2018-10-14
KAN,2018-10-14,5,Sun,6,6,@,NWE,L 40-43,5,58,0,0,5,58,KAN_NWE_2018-10-14
OAK,2018-10-14,5,Sun,6,6,,SEA,L 3-27,5,38,8,64,13,102,OAK_SEA_2018-10-14
WAS,2018-10-14,5,Sun,5,6,,CAR,W 23-17,5,43,8,55,13,98,WAS_CAR_2018-10-14
NYG,2018-10-11,5,Thu,6,6,,PHI,L 13-34,5,61,4,25,9,86,NYG_PHI_2018-10-11
TEN,2018-10-07,5,Sun,5,5,@,BUF,L 12-13,5,40,4,30,9,70,TEN_BUF_2018-10-07
ARI,2018-10-07,5,Sun,5,5,@,SFO,W 28-18,5,46,9,65,14,111,ARI_SFO_2018-10-07
HOU,2018-10-07,5,Sun,5,5,,DAL,W 19-16 (OT),5,25,7,72,12,97,HOU_DAL_2018-10-07
JAX,2018-10-07,5,Sun,5,5,@,KAN,L 14-30,5,45,11,105,16,150,JAX_KAN_2018-10-07
NOR,2018-09-30,5,Sun,4,4,@,NYG,W 33-18,5,51,6,67,11,118,NOR_NYG_2018-09-30
PIT,2018-09-30,5,Sun,4,4,,BAL,L 14-26,5,40,7,50,12,90,PIT_BAL_2018-09-30
GNB,2018-09-30,5,Sun,4,4,,BUF,W 22-0,5,60,3,20,8,80,GNB_BUF_2018-09-30
LAC,2018-09-30,5,Sun,4,4,,SFO,W 29-27,5,49,4,29,9,78,LAC_SFO_2018-09-30
ARI,2018-09-30,5,Sun,4,4,,SEA,L 17-20,5,38,8,57,13,95,ARI_SEA_2018-09-30
NWE,2018-09-23,5,Sun,3,3,@,DET,L 10-26,5,38,6,70,11,108,NWE_DET_2018-09-23
ATL,2018-09-23,5,Sun,3,3,,NOR,L 37-43 (OT),5,54,11,120,16,174,ATL_NOR_2018-09-23
CLE,2018-09-20,5,Thu,3,3,,NYJ,W 21-17,5,41,6,55,11,96,CLE_NYJ_2018-09-20
SEA,2018-09-17,5,Mon,2,2,@,CHI,L 17-24,5,37,7,55,12,92,SEA_CHI_2018-09-17
LAR,2018-09-16,5,Sun,2,2,,ARI,W 34-0,5,49,9,47,14,96,LAR_ARI_2018-09-16
TEN,2018-09-09,5,Sun,1,1,@,MIA,L 20-27,5,48,7,51,12,99,TEN_MIA_2018-09-09
CHI,2018-09-09,5,Sun,1,1,@,GNB,L 23-24,5,35,8,72,13,107,CHI_GNB_2018-09-09
BAL,2017-12-31,5,Sun,16,17,,CIN,L 27-31,5,47,6,60,11,107,BAL_CIN_2017-12-31
CAR,2017-12-31,5,Sun,16,17,@,ATL,L 10-22,5,35,7,60,12,95,CAR_ATL_2017-12-31
DET,2017-12-31,5,Sun,16,17,,GNB,W 35-11,5,62,8,68,13,130,DET_GNB_2017-12-31
TEN,2017-12-24,5,Sun,15,16,,LAR,L 23-27,5,54,5,44,10,98,TEN_LAR_2017-12-24
KAN,2017-12-24,5,Sun,15,16,,MIA,W 29-13,5,40,11,75,16,115,KAN_MIA_2017-12-24
LAR,2017-12-24,5,Sun,15,16,@,TEN,W 27-23,5,44,5,54,10,98,LAR_TEN_2017-12-24
TEN,2017-12-24,5,Sun,15,16,,LAR,L 23-27,5,54,5,44,10,98,TEN_LAR_2017-12-24
NYJ,2017-12-24,5,Sun,15,16,,LAC,L 7-14,5,34,8,80,13,114,NYJ_LAC_2017-12-24
BAL,2017-12-23,5,Sat,15,16,,IND,W 23-16,5,25,2,19,7,44,BAL_IND_2017-12-23
CAR,2017-12-17,5,Sun,14,15,,GNB,W 31-24,5,40,6,28,11,68,CAR_GNB_2017-12-17
CIN,2017-12-17,5,Sun,14,15,@,MIN,L 7-34,5,44,11,93,16,137,CIN_MIN_2017-12-17
NYG,2017-12-17,5,Sun,14,15,,PHI,L 29-34,5,67,7,44,12,111,NYG_PHI_2017-12-17
ARI,2017-12-10,5,Sun,13,14,,TEN,W 12-7,5,30,6,48,11,78,ARI_TEN_2017-12-10
BAL,2017-12-10,5,Sun,13,14,@,PIT,L 38-39,5,35,6,101,11,136,BAL_PIT_2017-12-10
LAC,2017-12-10,5,Sun,13,14,,WAS,W 30-13,5,40,4,48,9,88,LAC_WAS_2017-12-10
LAC,2017-12-03,5,Sun,12,13,,CLE,W 19-10,5,62,4,24,9,86,LAC_CLE_2017-12-03
NYJ,2017-12-03,5,Sun,12,13,,KAN,W 38-31,5,40,8,30,13,70,NYJ_KAN_2017-12-03
SEA,2017-12-03,5,Sun,12,13,,PHI,W 24-10,5,46,7,64,12,110,SEA_PHI_2017-12-03
JAX,2017-11-26,5,Sun,11,12,@,ARI,L 24-27,5,45,10,98,15,143,JAX_ARI_2017-11-26
PIT,2017-11-26,5,Sun,11,12,,GNB,W 31-28,5,45,3,27,8,72,PIT_GNB_2017-11-26
LAC,2017-11-23,5,Thu,11,12,@,DAL,W 28-6,5,56,7,60,12,116,LAC_DAL_2017-11-23
DEN,2017-11-19,5,Sun,10,11,,CIN,L 17-20,5,50,3,14,8,64,DEN_CIN_2017-11-19
CHI,2017-11-19,5,Sun,10,11,,DET,L 24-27,5,64,6,49,11,113,CHI_DET_2017-11-19
NYG,2017-11-19,5,Sun,10,11,,KAN,W 12-9 (OT),5,48,9,87,14,135,NYG_KAN_2017-11-19
GNB,2017-11-19,5,Sun,10,11,,BAL,L 0-23,5,53,3,30,8,83,GNB_BAL_2017-11-19
DAL,2017-11-12,5,Sun,9,10,@,ATL,L 7-27,5,54,5,35,10,89,DAL_ATL_2017-11-12
GNB,2017-11-12,5,Sun,9,10,@,CHI,W 23-16,5,35,8,78,13,113,GNB_CHI_2017-11-12
TEN,2017-11-12,5,Sun,9,10,,CIN,W 24-20,5,55,12,84,17,139,TEN_CIN_2017-11-12
ATL,2017-11-12,5,Sun,9,10,,DAL,W 27-7,5,35,5,54,10,89,ATL_DAL_2017-11-12
DEN,2017-11-12,5,Sun,9,10,,NWE,L 16-41,5,28,1,5,6,33,DEN_NWE_2017-11-12
CAR,2017-11-05,5,Sun,9,9,,ATL,W 20-17,5,29,8,70,13,99,CAR_ATL_2017-11-05
JAX,2017-11-05,5,Sun,8,9,,CIN,W 23-7,5,50,8,77,13,127,JAX_CIN_2017-11-05
PHI,2017-11-05,5,Sun,9,9,,DEN,W 51-23,5,35,14,105,19,140,PHI_DEN_2017-11-05
DAL,2017-11-05,5,Sun,8,9,,KAN,W 28-17,5,65,8,52,13,117,DAL_KAN_2017-11-05
MIN,2017-10-29,5,Sun,8,8,@,CLE,W 33-16,5,58,5,74,10,132,MIN_CLE_2017-10-29
CIN,2017-10-29,5,Sun,7,8,,IND,W 24-23,5,54,7,45,12,99,CIN_IND_2017-10-29
WAS,2017-10-29,5,Sun,7,8,,DAL,L 19-33,5,32,8,89,13,121,WAS_DAL_2017-10-29
PIT,2017-10-29,5,Sun,8,8,@,DET,W 20-15,5,37,6,57,11,94,PIT_DET_2017-10-29
CLE,2017-10-29,5,Sun,8,8,,MIN,L 16-33,5,74,5,58,10,132,CLE_MIN_2017-10-29
CAR,2017-10-29,5,Sun,8,8,@,TAM,W 17-3,5,51,6,55,11,106,CAR_TAM_2017-10-29
BAL,2017-10-26,5,Thu,8,8,,MIA,W 40-0,5,40,7,43,12,83,BAL_MIA_2017-10-26
WAS,2017-10-23,5,Mon,6,7,@,PHI,L 24-34,5,55,9,55,14,110,WAS_PHI_2017-10-23
TAM,2017-10-22,5,Sun,6,7,@,BUF,L 27-30,5,55,4,35,9,90,TAM_BUF_2017-10-22
CHI,2017-10-22,5,Sun,7,7,,CAR,W 17-3,5,40,4,35,9,75,CHI_CAR_2017-10-22
TEN,2017-10-22,5,Sun,7,7,@,CLE,W 12-9 (OT),5,35,12,81,17,116,TEN_CLE_2017-10-22
IND,2017-10-22,5,Sun,7,7,,JAX,L 0-27,5,55,4,34,9,89,IND_JAX_2017-10-22
CIN,2017-10-22,5,Sun,6,7,@,PIT,L 14-29,5,54,1,5,6,59,CIN_PIT_2017-10-22
DAL,2017-10-22,5,Sun,6,7,@,SFO,W 40-10,5,36,2,22,7,58,DAL_SFO_2017-10-22
IND,2017-10-16,5,Mon,6,6,@,TEN,L 22-36,5,51,4,45,9,96,IND_TEN_2017-10-16
NYG,2017-10-15,5,Sun,6,6,@,DEN,W 23-10,5,77,5,46,10,123,NYG_DEN_2017-10-15
DEN,2017-10-15,5,Sun,5,6,,NYG,L 10-23,5,46,5,77,10,123,DEN_NYG_2017-10-15
JAX,2017-10-15,5,Sun,6,6,,LAR,L 17-27,5,40,7,70,12,110,JAX_LAR_2017-10-15
CHI,2017-10-15,5,Sun,6,6,@,BAL,W 27-24 (OT),5,44,8,69,13,113,CHI_BAL_2017-10-15
OAK,2017-10-15,5,Sun,6,6,,LAC,L 16-17,5,40,4,32,9,72,OAK_LAC_2017-10-15
WAS,2017-10-15,5,Sun,5,6,,SFO,W 26-24,5,43,7,40,12,83,WAS_SFO_2017-10-15
PHI,2017-10-08,5,Sun,5,5,,ARI,W 34-7,5,60,7,61,12,121,PHI_ARI_2017-10-08
PIT,2017-10-08,5,Sun,5,5,,JAX,L 9-30,5,37,4,19,9,56,PIT_JAX_2017-10-08
MIA,2017-10-08,5,Sun,4,5,,TEN,W 16-10,5,23,11,77,16,100,MIA_TEN_2017-10-08
LAR,2017-10-08,5,Sun,5,5,,SEA,L 10-16,5,45,7,40,12,85,LAR_SEA_2017-10-08
IND,2017-10-01,5,Sun,4,4,@,SEA,L 18-46,5,31,6,45,11,76,IND_SEA_2017-10-01
NWE,2017-09-24,5,Sun,3,3,,HOU,W 36-33,5,69,10,60,15,129,NWE_HOU_2017-09-24
TEN,2017-09-24,5,Sun,3,3,,SEA,W 33-27,5,45,11,98,16,143,TEN_SEA_2017-09-24
MIN,2017-09-24,5,Sun,3,3,,TAM,W 34-17,5,53,7,37,12,90,MIN_TAM_2017-09-24
BUF,2017-09-17,5,Sun,2,2,@,CAR,L 3-9,5,44,6,40,11,84,BUF_CAR_2017-09-17
NOR,2017-09-17,5,Sun,2,2,,NWE,L 20-36,5,35,9,66,14,101,NOR_NWE_2017-09-17
KAN,2017-09-17,5,Sun,2,2,,PHI,W 27-20,5,40,4,30,9,70,KAN_PHI_2017-09-17
NYJ,2017-09-17,5,Sun,2,2,@,OAK,L 20-45,5,47,9,79,14,126,NYJ_OAK_2017-09-17
MIA,2017-09-17,5,Sun,1,2,@,LAC,W 19-17,5,23,6,56,11,79,MIA_LAC_2017-09-17
MIN,2017-09-11,5,Mon,1,1,,NOR,W 29-19,5,50,6,52,11,102,MIN_NOR_2017-09-11
NYJ,2017-09-10,5,Sun,1,1,@,BUF,L 12-21,5,62,6,50,11,112,NYJ_BUF_2017-09-10
DAL,2017-09-10,5,Sun,1,1,,NYG,W 19-3,5,50,6,55,11,105,DAL_NYG_2017-09-10
OAK,2017-09-10,5,Sun,1,1,@,TEN,W 26-16,5,49,5,49,10,98,OAK_TEN_2017-09-10
TEN,2017-09-10,5,Sun,1,1,,OAK,L 16-26,5,49,5,49,10,98,TEN_OAK_2017-09-10
CAR,2017-09-10,5,Sun,1,1,@,SFO,W 23-3,5,40,10,74,15,114,CAR_SFO_2017-09-10
PIT,2023-01-08,4,Sun,17,18,,CLE,W 28-14,4,20,9,65,13,85,PIT_CLE_2023-01-08
GNB,2023-01-08,4,Sun,17,18,,DET,L 16-20,4,35,5,75,9,110,GNB_DET_2023-01-08
PHI,2023-01-08,4,Sun,17,18,,NYG,W 22-16,4,30,8,66,12,96,PHI_NYG_2023-01-08
SEA,2023-01-08,4,Sun,17,18,,LAR,W 19-16 (OT),4,20,3,35,7,55,SEA_LAR_2023-01-08
JAX,2023-01-07,4,Sat,17,18,,TEN,W 20-16,4,25,6,40,10,65,JAX_TEN_2023-01-07
BAL,2023-01-01,4,Sun,16,17,,PIT,L 13-16,4,30,6,43,10,73,BAL_PIT_2023-01-01
DET,2022-12-24,4,Sat,15,16,@,CAR,L 23-37,4,30,10,74,14,104,DET_CAR_2022-12-24
CLE,2022-12-24,4,Sat,15,16,,NOR,L 10-17,4,45,2,15,6,60,CLE_NOR_2022-12-24
HOU,2022-12-24,4,Sat,15,16,@,TEN,W 19-14,4,35,5,30,9,65,HOU_TEN_2022-12-24
DAL,2022-12-24,4,Sat,15,16,,PHI,W 40-34,4,36,2,10,6,46,DAL_PHI_2022-12-24
SFO,2022-12-24,4,Sat,15,16,,WAS,W 37-20,4,25,6,51,10,76,SFO_WAS_2022-12-24
GNB,2022-12-19,4,Mon,14,15,,LAR,W 24-12,4,80,8,76,12,156,GNB_LAR_2022-12-19
DEN,2022-12-18,4,Sun,14,15,,ARI,W 24-15,4,31,7,46,11,77,DEN_ARI_2022-12-18
JAX,2022-12-18,4,Sun,14,15,,DAL,W 40-34 (OT),4,37,2,18,6,55,JAX_DAL_2022-12-18
HOU,2022-12-18,4,Sun,14,15,,KAN,L 24-30 (OT),4,33,10,102,14,135,HOU_KAN_2022-12-18
CIN,2022-12-18,4,Sun,14,15,@,TAM,W 34-23,4,27,7,58,11,85,CIN_TAM_2022-12-18
CIN,2022-12-11,4,Sun,13,14,,CLE,W 23-10,4,36,9,98,13,134,CIN_CLE_2022-12-11
HOU,2022-12-11,4,Sun,13,14,@,DAL,L 23-27,4,25,3,10,7,35,HOU_DAL_2022-12-11
KAN,2022-12-11,4,Sun,13,14,@,DEN,W 34-28,4,70,6,38,10,108,KAN_DEN_2022-12-11
TAM,2022-12-05,4,Mon,12,13,,NOR,W 17-16,4,39,6,84,10,123,TAM_NOR_2022-12-05
KAN,2022-12-04,4,Sun,12,13,@,CIN,L 24-27,4,35,6,65,10,100,KAN_CIN_2022-12-04
SFO,2022-12-04,4,Sun,12,13,,MIA,W 33-17,4,45,8,68,12,113,SFO_MIA_2022-12-04
LAC,2022-12-04,4,Sun,12,13,@,LVR,L 20-27,4,20,3,15,7,35,LAC_LVR_2022-12-04
DEN,2022-12-04,4,Sun,12,13,@,BAL,L 9-10,4,48,3,15,7,63,DEN_BAL_2022-12-04
LAR,2022-12-04,4,Sun,12,13,,SEA,L 23-27,4,39,6,42,10,81,LAR_SEA_2022-12-04
NYG,2022-12-04,4,Sun,12,13,,WAS,T 20-20 (OT),4,34,7,55,11,89,NYG_WAS_2022-12-04
WAS,2022-11-27,4,Sun,12,12,,ATL,W 19-13,4,28,2,20,6,48,WAS_ATL_2022-11-27
DEN,2022-11-27,4,Sun,11,12,@,CAR,L 10-23,4,44,4,34,8,78,DEN_CAR_2022-11-27
LAC,2022-11-27,4,Sun,11,12,@,ARI,W 25-24,4,30,3,19,7,49,LAC_ARI_2022-11-27
CAR,2022-11-27,4,Sun,12,12,,DEN,W 23-10,4,34,4,44,8,78,CAR_DEN_2022-11-27
MIA,2022-11-27,4,Sun,11,12,,HOU,W 30-15,4,35,5,45,9,80,MIA_HOU_2022-11-27
GNB,2022-11-27,4,Sun,12,12,@,PHI,L 33-40,4,35,3,25,7,60,GNB_PHI_2022-11-27
JAX,2022-11-27,4,Sun,11,12,,BAL,W 28-27,4,19,3,20,7,39,JAX_BAL_2022-11-27
LAC,2022-11-20,4,Sun,10,11,,KAN,L 27-30,4,25,4,54,8,79,LAC_KAN_2022-11-20
KAN,2022-11-20,4,Sun,10,11,@,LAC,W 30-27,4,54,4,25,8,79,KAN_LAC_2022-11-20
IND,2022-11-13,4,Sun,10,10,@,LVR,W 25-20,4,25,10,74,14,99,IND_LVR_2022-11-13
TAM,2022-11-13,4,Sun,10,10,,SEA,W 21-16,4,40,6,46,10,86,TAM_SEA_2022-11-13
ATL,2022-11-10,4,Thu,10,10,@,CAR,L 15-25,4,37,10,89,14,126,ATL_CAR_2022-11-10
NWE,2022-11-06,4,Sun,9,9,,IND,W 26-3,4,35,2,15,6,50,NWE_IND_2022-11-06
CHI,2022-11-06,4,Sun,9,9,,MIA,L 32-35,4,92,3,38,7,130,CHI_MIA_2022-11-06
JAX,2022-11-06,4,Sun,9,9,,LVR,W 27-20,4,30,5,45,9,75,JAX_LVR_2022-11-06
LAR,2022-11-06,4,Sun,8,9,@,TAM,L 13-16,4,53,7,55,11,108,LAR_TAM_2022-11-06
PHI,2022-11-03,4,Thu,8,9,@,HOU,W 29-17,4,31,4,24,8,55,PHI_HOU_2022-11-03
HOU,2022-11-03,4,Thu,8,9,,PHI,L 17-29,4,24,4,31,8,55,HOU_PHI_2022-11-03
BUF,2022-10-30,4,Sun,7,8,,GNB,W 27-17,4,35,8,58,12,93,BUF_GNB_2022-10-30
NYJ,2022-10-30,4,Sun,8,8,,NWE,L 17-22,4,41,6,54,10,95,NYJ_NWE_2022-10-30
LAR,2022-10-30,4,Sun,7,8,,SFO,L 14-31,4,50,3,8,7,58,LAR_SFO_2022-10-30
TAM,2022-10-27,4,Thu,8,8,,BAL,L 22-27,4,35,7,101,11,136,TAM_BAL_2022-10-27
NWE,2022-10-24,4,Mon,7,7,,CHI,L 14-33,4,30,4,35,8,65,NWE_CHI_2022-10-24
CHI,2022-10-24,4,Mon,7,7,@,NWE,W 33-14,4,35,4,30,8,65,CHI_NWE_2022-10-24
TAM,2022-10-23,4,Sun,7,7,@,CAR,L 3-21,4,30,3,15,7,45,TAM_CAR_2022-10-23
DEN,2022-10-23,4,Sun,7,7,,NYJ,L 9-16,4,34,11,85,15,119,DEN_NYJ_2022-10-23
IND,2022-10-23,4,Sun,7,7,@,TEN,L 10-19,4,28,2,15,6,43,IND_TEN_2022-10-23
ARI,2022-10-20,4,Thu,7,7,,NOR,W 42-34,4,20,8,49,12,69,ARI_NOR_2022-10-20
NOR,2022-10-16,4,Sun,6,6,,CIN,L 26-30,4,34,3,30,7,64,NOR_CIN_2022-10-16
JAX,2022-10-16,4,Sun,6,6,@,IND,L 27-34,4,44,7,52,11,96,JAX_IND_2022-10-16
CHI,2022-10-13,4,Thu,6,6,,WAS,L 7-12,4,42,7,36,11,78,CHI_WAS_2022-10-13
LAC,2022-10-09,4,Sun,5,5,@,CLE,W 30-28,4,17,6,65,10,82,LAC_CLE_2022-10-09
HOU,2022-10-09,4,Sun,5,5,@,JAX,W 13-6,4,25,6,48,10,73,HOU_JAX_2022-10-09
CIN,2022-10-09,4,Sun,5,5,@,BAL,L 17-19,4,20,6,48,10,68,CIN_BAL_2022-10-09
SFO,2022-10-03,4,Mon,4,4,,LAR,W 24-9,4,25,1,5,5,30,SFO_LAR_2022-10-03
LVR,2022-10-02,4,Sun,4,4,,DEN,W 32-23,4,25,7,50,11,75,LVR_DEN_2022-10-02
GNB,2022-10-02,4,Sun,4,4,,NWE,W 27-24 (OT),4,40,7,75,11,115,GNB_NWE_2022-10-02
JAX,2022-10-02,4,Sun,4,4,@,PHI,L 21-29,4,38,3,20,7,58,JAX_PHI_2022-10-02
BUF,2022-10-02,4,Sun,4,4,@,BAL,W 23-20,4,31,9,70,13,101,BUF_BAL_2022-10-02
KAN,2022-10-02,4,Sun,4,4,@,TAM,W 41-31,4,32,5,40,9,72,KAN_TAM_2022-10-02
DAL,2022-10-02,4,Sun,4,4,,WAS,W 25-10,4,20,11,136,15,156,DAL_WAS_2022-10-02
MIA,2022-09-25,4,Sun,3,3,,BUF,W 21-19,4,20,7,52,11,72,MIA_BUF_2022-09-25
NYJ,2022-09-25,4,Sun,3,3,,CIN,L 12-27,4,55,5,30,9,85,NYJ_CIN_2022-09-25
IND,2022-09-25,4,Sun,3,3,,KAN,W 20-17,4,34,6,45,10,79,IND_KAN_2022-09-25
CAR,2022-09-25,4,Sun,3,3,,NOR,W 22-14,4,40,7,58,11,98,CAR_NOR_2022-09-25
WAS,2022-09-25,4,Sun,3,3,,PHI,L 8-24,4,48,5,52,9,100,WAS_PHI_2022-09-25
MIA,2022-09-11,4,Sun,1,1,,NWE,W 20-7,4,20,3,15,7,35,MIA_NWE_2022-09-11
CIN,2022-09-11,4,Sun,1,1,,PIT,L 20-23 (OT),4,27,8,59,12,86,CIN_PIT_2022-09-11
LAR,2022-09-08,4,Thu,1,1,,BUF,L 10-31,4,30,5,35,9,65,LAR_BUF_2022-09-08
BUF,2022-01-09,4,Sun,17,18,,NYJ,W 27-10,4,40,4,27,8,67,BUF_NYJ_2022-01-09
HOU,2022-01-09,4,Sun,17,18,,TEN,L 25-28,4,65,5,42,9,107,HOU_TEN_2022-01-09
LVR,2022-01-09,4,Sun,17,18,,LAC,W 35-32 (OT),4,38,10,108,14,146,LVR_LAC_2022-01-09
NOR,2022-01-09,4,Sun,17,18,@,ATL,W 30-20,4,40,5,46,9,86,NOR_ATL_2022-01-09
NYJ,2022-01-09,4,Sun,17,18,@,BUF,L 10-27,4,27,4,40,8,67,NYJ_BUF_2022-01-09
MIN,2022-01-09,4,Sun,17,18,,CHI,W 31-17,4,47,2,10,6,57,MIN_CHI_2022-01-09
CLE,2022-01-09,4,Sun,17,18,,CIN,W 21-16,4,46,4,32,8,78,CLE_CIN_2022-01-09
CIN,2022-01-09,4,Sun,17,18,@,CLE,L 16-21,4,32,4,46,8,78,CIN_CLE_2022-01-09
SEA,2022-01-09,4,Sun,17,18,@,ARI,W 38-30,4,30,6,46,10,76,SEA_ARI_2022-01-09
IND,2022-01-09,4,Sun,17,18,@,JAX,L 11-26,4,52,6,49,10,101,IND_JAX_2022-01-09
ATL,2022-01-02,4,Sun,16,17,@,BUF,L 15-29,4,27,7,47,11,74,ATL_BUF_2022-01-02
TAM,2022-01-02,4,Sun,16,17,@,NYJ,W 28-24,4,39,2,14,6,53,TAM_NYJ_2022-01-02
BAL,2022-01-02,4,Sun,16,17,,LAR,L 19-20,4,24,4,35,8,59,BAL_LAR_2022-01-02
LAR,2022-01-02,4,Sun,16,17,@,BAL,W 20-19,4,35,4,24,8,59,LAR_BAL_2022-01-02
DET,2022-01-02,4,Sun,16,17,@,SEA,L 29-51,4,30,5,31,9,61,DET_SEA_2022-01-02
LAR,2021-12-21,4,Tue,14,15,,SEA,W 20-10,4,34,8,65,12,99,LAR_SEA_2021-12-21
PHI,2021-12-21,4,Tue,14,15,,WAS,W 27-17,4,48,2,25,6,73,PHI_WAS_2021-12-21
ATL,2021-12-19,4,Sun,14,15,@,SFO,L 13-31,4,29,5,35,9,64,ATL_SFO_2021-12-19
JAX,2021-12-19,4,Sun,14,15,,HOU,L 16-30,4,40,9,65,13,105,JAX_HOU_2021-12-19
KAN,2021-12-16,4,Thu,14,15,@,LAC,W 34-28 (OT),4,36,5,60,9,96,KAN_LAC_2021-12-16
NOR,2021-12-12,4,Sun,13,14,@,NYJ,W 30-9,4,42,5,45,9,87,NOR_NYJ_2021-12-12
CLE,2021-12-12,4,Sun,13,14,,BAL,W 24-22,4,42,10,129,14,171,CLE_BAL_2021-12-12
TAM,2021-12-12,4,Sun,13,14,,BUF,W 33-27 (OT),4,24,7,65,11,89,TAM_BUF_2021-12-12
HOU,2021-12-05,4,Sun,12,13,,IND,L 0-31,4,25,5,25,9,50,HOU_IND_2021-12-05
WAS,2021-11-29,4,Mon,11,12,,SEA,W 17-15,4,38,6,51,10,89,WAS_SEA_2021-11-29
HOU,2021-11-28,4,Sun,11,12,,NYJ,L 14-21,4,32,5,40,9,72,HOU_NYJ_2021-11-28
NWE,2021-11-28,4,Sun,12,12,,TEN,W 36-13,4,35,5,50,9,85,NWE_TEN_2021-11-28
PIT,2021-11-28,4,Sun,11,12,@,CIN,L 10-41,4,30,3,18,7,48,PIT_CIN_2021-11-28
TAM,2021-11-28,4,Sun,11,12,@,IND,W 38-31,4,44,6,66,10,110,TAM_IND_2021-11-28
LAR,2021-11-28,4,Sun,11,12,@,GNB,L 28-36,4,30,3,32,7,62,LAR_GNB_2021-11-28
PHI,2021-11-28,4,Sun,12,12,@,NYG,L 7-13,4,26,2,15,6,41,PHI_NYG_2021-11-28
NOR,2021-11-25,4,Thu,11,12,,BUF,L 6-31,4,24,4,35,8,59,NOR_BUF_2021-11-25
BUF,2021-11-25,4,Thu,11,12,@,NOR,W 31-6,4,35,4,24,8,59,BUF_NOR_2021-11-25
NYG,2021-11-22,4,Mon,10,11,@,TAM,L 10-30,4,30,6,39,10,69,NYG_TAM_2021-11-22
DEN,2021-11-14,4,Sun,10,10,,PHI,L 13-30,4,29,7,89,11,118,DEN_PHI_2021-11-14
KAN,2021-11-14,4,Sun,10,10,@,LVR,W 41-14,4,34,9,68,13,102,KAN_LVR_2021-11-14
ARI,2021-11-14,4,Sun,10,10,,CAR,L 10-34,4,58,9,115,13,173,ARI_CAR_2021-11-14
BAL,2021-11-11,4,Thu,9,10,@,MIA,L 10-22,4,20,11,97,15,117,BAL_MIA_2021-11-11
CIN,2021-11-07,4,Sun,9,9,,CLE,L 16-41,4,31,10,84,14,115,CIN_CLE_2021-11-07
GNB,2021-11-07,4,Sun,9,9,@,KAN,L 7-13,4,19,6,33,10,52,GNB_KAN_2021-11-07
LAC,2021-11-07,4,Sun,8,9,@,PHI,W 27-24,4,30,3,25,7,55,LAC_PHI_2021-11-07
NYG,2021-11-07,4,Sun,9,9,,LVR,W 23-16,4,35,6,65,10,100,NYG_LVR_2021-11-07
TEN,2021-11-07,4,Sun,9,9,@,LAR,W 28-16,4,19,12,115,16,134,TEN_LAR_2021-11-07
NWE,2021-10-31,4,Sun,8,8,@,LAC,W 27-24,4,30,5,40,9,70,NWE_LAC_2021-10-31
CHI,2021-10-31,4,Sun,8,8,,SFO,L 22-33,4,30,7,55,11,85,CHI_SFO_2021-10-31
DEN,2021-10-31,4,Sun,8,8,,WAS,W 17-10,4,35,4,29,8,64,DEN_WAS_2021-10-31
WAS,2021-10-31,4,Sun,8,8,@,DEN,L 10-17,4,29,4,35,8,64,WAS_DEN_2021-10-31
LAR,2021-10-24,4,Sun,7,7,,DET,W 28-19,4,35,8,77,12,112,LAR_DET_2021-10-24
WAS,2021-10-24,4,Sun,7,7,@,GNB,L 10-24,4,50,4,36,8,86,WAS_GNB_2021-10-24
PHI,2021-10-24,4,Sun,7,7,@,LVR,L 22-33,4,37,7,65,11,102,PHI_LVR_2021-10-24
CHI,2021-10-24,4,Sun,7,7,@,TAM,L 3-38,4,32,1,10,5,42,CHI_TAM_2021-10-24
GNB,2021-10-24,4,Sun,7,7,,WAS,W 24-10,4,36,4,50,8,86,GNB_WAS_2021-10-24
LAC,2021-10-17,4,Sun,6,6,@,BAL,L 6-34,4,35,2,15,6,50,LAC_BAL_2021-10-17
HOU,2021-10-17,4,Sun,6,6,@,IND,L 3-31,4,25,2,10,6,35,HOU_IND_2021-10-17
CIN,2021-10-17,4,Sun,6,6,@,DET,W 34-11,4,31,9,77,13,108,CIN_DET_2021-10-17
PHI,2021-10-14,4,Thu,6,6,,TAM,L 22-28,4,41,7,120,11,161,PHI_TAM_2021-10-14
JAX,2021-10-10,4,Sun,5,5,,TEN,L 19-37,4,33,7,44,11,77,JAX_TEN_2021-10-10
ATL,2021-10-10,4,Sun,5,5,,NYJ,W 27-20,4,66,7,58,11,124,ATL_NYJ_2021-10-10
DET,2021-10-03,4,Sun,4,4,@,CHI,L 14-24,4,26,7,61,11,87,DET_CHI_2021-10-03
DEN,2021-10-03,4,Sun,4,4,,BAL,L 7-23,4,25,6,55,10,80,DEN_BAL_2021-10-03
DAL,2021-09-27,4,Mon,3,3,,PHI,W 41-21,4,37,13,86,17,123,DAL_PHI_2021-09-27
IND,2021-09-26,4,Sun,3,3,@,TEN,L 16-25,4,66,4,24,8,90,IND_TEN_2021-09-26
MIN,2021-09-26,4,Sun,3,3,,SEA,W 30-17,4,40,4,35,8,75,MIN_SEA_2021-09-26
TEN,2021-09-26,4,Sun,3,3,,IND,W 25-16,4,24,4,66,8,90,TEN_IND_2021-09-26
JAX,2021-09-26,4,Sun,3,3,,ARI,L 19-31,4,40,7,58,11,98,JAX_ARI_2021-09-26
SFO,2021-09-26,4,Sun,3,3,,GNB,L 28-30,4,86,7,87,11,173,SFO_GNB_2021-09-26
SEA,2021-09-26,4,Sun,3,3,@,MIN,L 17-30,4,35,4,40,8,75,SEA_MIN_2021-09-26
NWE,2021-09-26,4,Sun,3,3,,NOR,L 13-28,4,30,2,15,6,45,NWE_NOR_2021-09-26
ATL,2021-09-26,4,Sun,3,3,@,NYG,W 17-14,4,28,8,53,12,81,ATL_NYG_2021-09-26
CIN,2021-09-19,4,Sun,2,2,@,CHI,L 17-20,4,57,8,70,12,127,CIN_CHI_2021-09-19
LAR,2021-09-12,4,Sun,1,1,,CHI,W 34-14,4,36,3,35,7,71,LAR_CHI_2021-09-12
NYG,2021-09-12,4,Sun,1,1,,DEN,L 13-27,4,48,5,51,9,99,NYG_DEN_2021-09-12
NOR,2021-01-03,4,Sun,16,17,@,CAR,W 33-7,4,31,1,5,5,36,NOR_CAR_2021-01-03
GNB,2021-01-03,4,Sun,16,17,@,CHI,W 35-16,4,30,1,16,5,46,GNB_CHI_2021-01-03
MIN,2021-01-03,4,Sun,16,17,@,DET,W 37-35,4,35,7,51,11,86,MIN_DET_2021-01-03
LAC,2021-01-03,4,Sun,16,17,@,KAN,W 38-21,4,23,5,69,9,92,LAC_KAN_2021-01-03
CLE,2021-01-03,4,Sun,16,17,,PIT,W 24-22,4,19,2,15,6,34,CLE_PIT_2021-01-03
DEN,2021-01-03,4,Sun,16,17,,LVR,L 31-32,4,28,14,111,18,139,DEN_LVR_2021-01-03
SEA,2021-01-03,4,Sun,16,17,@,SFO,W 26-23,4,35,2,25,6,60,SEA_SFO_2021-01-03
ATL,2021-01-03,4,Sun,16,17,@,TAM,L 27-44,4,48,3,23,7,71,ATL_TAM_2021-01-03
NWE,2020-12-28,4,Mon,15,16,,BUF,L 9-38,4,25,3,27,7,52,NWE_BUF_2020-12-28
CHI,2020-12-27,4,Sun,15,16,@,JAX,W 41-17,4,40,10,115,14,155,CHI_JAX_2020-12-27
SFO,2020-12-26,4,Sat,15,16,@,ARI,W 20-12,4,27,4,20,8,47,SFO_ARI_2020-12-26
LVR,2020-12-26,4,Sat,15,16,,MIA,L 25-26,4,40,5,76,9,116,LVR_MIA_2020-12-26
ARI,2020-12-26,4,Sat,15,16,,SFO,L 12-20,4,20,4,27,8,47,ARI_SFO_2020-12-26
NOR,2020-12-25,4,Fri,15,16,,MIN,W 52-33,4,38,3,20,7,58,NOR_MIN_2020-12-25
PIT,2020-12-21,4,Mon,14,15,@,CIN,L 17-27,4,30,2,16,6,46,PIT_CIN_2020-12-21
SFO,2020-12-20,4,Sun,14,15,@,DAL,L 33-41,4,39,5,58,9,97,SFO_DAL_2020-12-20
IND,2020-12-20,4,Sun,14,15,,HOU,W 27-20,4,35,5,24,9,59,IND_HOU_2020-12-20
BAL,2020-12-20,4,Sun,14,15,,JAX,W 40-14,4,40,7,67,11,107,BAL_JAX_2020-12-20
CHI,2020-12-20,4,Sun,14,15,@,MIN,W 33-27,4,36,1,5,5,41,CHI_MIN_2020-12-20
SEA,2020-12-20,4,Sun,14,15,@,WAS,W 20-15,4,45,6,41,10,86,SEA_WAS_2020-12-20
DET,2020-12-13,4,Sun,13,14,,GNB,L 24-31,4,30,12,68,16,98,DET_GNB_2020-12-13
ARI,2020-12-13,4,Sun,13,14,@,NYG,W 26-7,4,22,2,10,6,32,ARI_NYG_2020-12-13
SEA,2020-12-13,4,Sun,13,14,,NYJ,W 40-3,4,35,7,50,11,85,SEA_NYJ_2020-12-13
ATL,2020-12-13,4,Sun,13,14,@,LAC,L 17-20,4,35,6,40,10,75,ATL_LAC_2020-12-13
BAL,2020-12-08,4,Tue,12,13,,DAL,W 34-17,4,23,7,58,11,81,BAL_DAL_2020-12-08
BUF,2020-12-07,4,Mon,12,13,@,SFO,W 34-24,4,50,7,43,11,93,BUF_SFO_2020-12-07
PHI,2020-12-06,4,Sun,12,13,@,GNB,L 16-30,4,40,5,30,9,70,PHI_GNB_2020-12-06
DEN,2020-12-06,4,Sun,12,13,@,KAN,L 16-22,4,31,5,44,9,75,DEN_KAN_2020-12-06
DET,2020-11-26,4,Thu,11,12,,HOU,L 25-41,4,44,10,74,14,118,DET_HOU_2020-11-26
DET,2020-11-22,4,Sun,10,11,@,CAR,L 0-20,4,20,7,45,11,65,DET_CAR_2020-11-22
DAL,2020-11-22,4,Sun,10,11,@,MIN,W 31-28,4,30,8,80,12,110,DAL_MIN_2020-11-22
TEN,2020-11-22,4,Sun,10,11,@,BAL,W 30-24 (OT),4,44,6,81,10,125,TEN_BAL_2020-11-22
MIN,2020-11-16,4,Mon,9,10,@,CHI,W 19-13,4,35,1,5,5,40,MIN_CHI_2020-11-16
GNB,2020-11-15,4,Sun,9,10,,JAX,W 24-20,4,35,7,86,11,121,GNB_JAX_2020-11-15
SEA,2020-11-15,4,Sun,9,10,@,LAR,L 16-23,4,23,4,49,8,72,SEA_LAR_2020-11-15
LAR,2020-11-15,4,Sun,9,10,,SEA,W 23-16,4,49,4,23,8,72,LAR_SEA_2020-11-15
NYJ,2020-11-09,4,Mon,9,9,,NWE,L 27-30,4,32,6,81,10,113,NYJ_NWE_2020-11-09
SEA,2020-11-08,4,Sun,8,9,@,BUF,L 34-44,4,13,6,70,10,83,SEA_BUF_2020-11-08
JAX,2020-11-08,4,Sun,8,9,,HOU,L 25-27,4,78,3,18,7,96,JAX_HOU_2020-11-08
IND,2020-11-08,4,Sun,8,9,,BAL,L 10-24,4,30,5,55,9,85,IND_BAL_2020-11-08
NYG,2020-11-08,4,Sun,9,9,@,WAS,W 23-20,4,40,6,45,10,85,NYG_WAS_2020-11-08
SFO,2020-11-05,4,Thu,9,9,,GNB,L 17-34,4,33,5,45,9,78,SFO_GNB_2020-11-05
DET,2020-11-01,4,Sun,7,8,,IND,L 21-41,4,76,3,19,7,95,DET_IND_2020-11-01
PHI,2020-11-01,4,Sun,8,8,,DAL,W 23-9,4,28,7,68,11,96,PHI_DAL_2020-11-01
LAR,2020-10-26,4,Mon,7,7,,CHI,W 24-10,4,46,6,46,10,92,LAR_CHI_2020-10-26
WAS,2020-10-25,4,Sun,7,7,,DAL,W 25-3,4,30,6,49,10,79,WAS_DAL_2020-10-25
TAM,2020-10-25,4,Sun,7,7,@,LVR,W 45-20,4,20,4,35,8,55,TAM_LVR_2020-10-25
LVR,2020-10-25,4,Sun,6,7,,TAM,L 20-45,4,35,4,20,8,55,LVR_TAM_2020-10-25
BUF,2020-10-19,4,Mon,6,6,,KAN,L 17-26,4,39,8,68,12,107,BUF_KAN_2020-10-19
HOU,2020-10-18,4,Sun,6,6,@,TEN,L 36-42 (OT),4,46,7,73,11,119,HOU_TEN_2020-10-18
NYG,2020-10-18,4,Sun,6,6,,WAS,W 20-19,4,30,8,50,12,80,NYG_WAS_2020-10-18
CAR,2020-10-11,4,Sun,5,5,@,ATL,W 23-16,4,25,3,40,7,65,CAR_ATL_2020-10-11
BAL,2020-10-11,4,Sun,5,5,,CIN,W 27-3,4,25,5,40,9,65,BAL_CIN_2020-10-11
JAX,2020-10-11,4,Sun,5,5,@,HOU,L 14-30,4,35,5,25,9,60,JAX_HOU_2020-10-11
NWE,2020-10-05,4,Mon,4,4,@,KAN,L 10-26,4,43,4,38,8,81,NWE_KAN_2020-10-05
KAN,2020-10-05,4,Mon,4,4,,NWE,W 26-10,4,38,4,43,8,81,KAN_NWE_2020-10-05
NOR,2020-10-04,4,Sun,4,4,@,DET,W 35-29,4,67,5,49,9,116,NOR_DET_2020-10-04
MIN,2020-10-04,4,Sun,4,4,@,HOU,W 31-23,4,36,2,15,6,51,MIN_HOU_2020-10-04
NYG,2020-10-04,4,Sun,4,4,@,LAR,L 9-17,4,20,1,5,5,25,NYG_LAR_2020-10-04
WAS,2020-09-27,4,Sun,3,3,@,CLE,L 20-34,4,40,6,50,10,90,WAS_CLE_2020-09-27
TEN,2020-09-27,4,Sun,3,3,@,MIN,W 31-30,4,45,3,20,7,65,TEN_MIN_2020-09-27
IND,2020-09-27,4,Sun,3,3,,NYJ,W 36-7,4,40,7,57,11,97,IND_NYJ_2020-09-27
HOU,2020-09-27,4,Sun,3,3,@,PIT,L 21-28,4,49,2,14,6,63,HOU_PIT_2020-09-27
DEN,2020-09-27,4,Sun,3,3,,TAM,L 10-28,4,30,9,71,13,101,DEN_TAM_2020-09-27
TEN,2020-09-20,4,Sun,2,2,,JAX,W 33-30,4,30,8,60,12,90,TEN_JAX_2020-09-20
LAR,2020-09-20,4,Sun,2,2,@,PHI,W 37-19,4,24,5,30,9,54,LAR_PHI_2020-09-20
DEN,2020-09-20,4,Sun,2,2,@,PIT,L 21-26,4,30,10,89,14,119,DEN_PIT_2020-09-20
HOU,2020-09-20,4,Sun,2,2,,BAL,L 16-33,4,22,3,21,7,43,HOU_BAL_2020-09-20
CIN,2020-09-17,4,Thu,2,2,@,CLE,L 30-35,4,45,8,76,12,121,CIN_CLE_2020-09-17
NYG,2020-09-14,4,Mon,1,1,,PIT,L 16-26,4,25,3,21,7,46,NYG_PIT_2020-09-14
MIA,2020-09-13,4,Sun,1,1,@,NWE,L 11-21,4,35,3,47,7,82,MIA_NWE_2020-09-13
IND,2019-12-29,4,Sun,16,17,@,JAX,L 20-38,4,36,3,27,7,63,IND_JAX_2019-12-29
MIA,2019-12-29,4,Sun,16,17,@,NWE,W 27-24,4,35,6,54,10,89,MIA_NWE_2019-12-29
NYG,2019-12-29,4,Sun,16,17,,PHI,L 17-34,4,48,7,55,11,103,NYG_PHI_2019-12-29
CLE,2019-12-29,4,Sun,16,17,@,CIN,L 23-33,4,33,3,20,7,53,CLE_CIN_2019-12-29
DET,2019-12-29,4,Sun,16,17,,GNB,L 20-23,4,50,9,97,13,147,DET_GNB_2019-12-29
PHI,2019-12-22,4,Sun,15,16,,DAL,W 17-9,4,30,2,20,6,50,PHI_DAL_2019-12-22
PIT,2019-12-22,4,Sun,15,16,@,NYJ,L 10-16,4,34,3,30,7,64,PIT_NYJ_2019-12-22
NYG,2019-12-22,4,Sun,15,16,@,WAS,W 41-35 (OT),4,33,6,51,10,84,NYG_WAS_2019-12-22
HOU,2019-12-21,4,Sat,15,16,@,TAM,W 23-20,4,35,6,45,10,80,HOU_TAM_2019-12-21
TEN,2019-12-15,4,Sun,14,15,,HOU,L 21-24,4,30,5,27,9,57,TEN_HOU_2019-12-15
NYG,2019-12-15,4,Sun,14,15,,MIA,W 36-20,4,32,7,42,11,74,NYG_MIA_2019-12-15
DAL,2019-12-15,4,Sun,14,15,,LAR,W 44-21,4,16,5,29,9,45,DAL_LAR_2019-12-15
GNB,2019-12-15,4,Sun,14,15,,CHI,W 21-13,4,30,4,35,8,65,GNB_CHI_2019-12-15
NWE,2019-12-15,4,Sun,14,15,@,CIN,W 34-13,4,30,5,25,9,55,NWE_CIN_2019-12-15
CHI,2019-12-15,4,Sun,14,15,@,GNB,L 13-21,4,35,4,30,8,65,CHI_GNB_2019-12-15
PHI,2019-12-09,4,Mon,13,14,,NYG,W 23-17 (OT),4,30,7,54,11,84,PHI_NYG_2019-12-09
DET,2019-12-08,4,Sun,13,14,@,MIN,L 7-20,4,28,8,55,12,83,DET_MIN_2019-12-08
TEN,2019-12-08,4,Sun,13,14,@,OAK,W 42-21,4,21,3,20,7,41,TEN_OAK_2019-12-08
PIT,2019-12-08,4,Sun,13,14,@,ARI,W 23-17,4,20,7,75,11,95,PIT_ARI_2019-12-08
CHI,2019-12-05,4,Thu,13,14,,DAL,W 31-24,4,30,6,52,10,82,CHI_DAL_2019-12-05
NYG,2019-12-01,4,Sun,12,13,,GNB,L 13-31,4,31,7,54,11,85,NYG_GNB_2019-12-01
ATL,2019-11-28,4,Thu,12,13,,NOR,L 18-26,4,18,9,121,13,139,ATL_NOR_2019-11-28
OAK,2019-11-24,4,Sun,11,12,@,NYJ,L 3-34,4,35,4,37,8,72,OAK_NYJ_2019-11-24
NYJ,2019-11-24,4,Sun,11,12,,OAK,W 34-3,4,37,4,35,8,72,NYJ_OAK_2019-11-24
HOU,2019-11-21,4,Thu,11,12,,IND,W 20-17,4,27,3,29,7,56,HOU_IND_2019-11-21
CIN,2019-11-17,4,Sun,10,11,@,OAK,L 10-17,4,40,7,42,11,82,CIN_OAK_2019-11-17
CLE,2019-11-10,4,Sun,9,10,,BUF,W 19-16,4,70,7,40,11,110,CLE_BUF_2019-11-10
MIA,2019-11-10,4,Sun,9,10,@,IND,W 16-12,4,30,3,25,7,55,MIA_IND_2019-11-10
JAX,2019-11-03,4,Sun,9,9,,HOU,L 3-26,4,34,7,60,11,94,JAX_HOU_2019-11-03
KAN,2019-11-03,4,Sun,9,9,,MIN,W 26-23,4,25,3,25,7,50,KAN_MIN_2019-11-03
BAL,2019-11-03,4,Sun,8,9,,NWE,W 37-20,4,34,7,48,11,82,BAL_NWE_2019-11-03
SEA,2019-11-03,4,Sun,9,9,,TAM,W 40-34 (OT),4,45,10,82,14,127,SEA_TAM_2019-11-03
GNB,2019-10-27,4,Sun,8,8,@,KAN,W 31-24,4,25,3,30,7,55,GNB_KAN_2019-10-27
PHI,2019-10-27,4,Sun,8,8,@,BUF,W 31-13,4,44,8,57,12,101,PHI_BUF_2019-10-27
SFO,2019-10-27,4,Sun,7,8,,CAR,W 51-13,4,31,9,70,13,101,SFO_CAR_2019-10-27
NWE,2019-10-27,4,Sun,8,8,,CLE,W 27-13,4,32,13,85,17,117,NWE_CLE_2019-10-27
WAS,2019-10-24,4,Thu,8,8,@,MIN,L 9-19,4,46,7,74,11,120,WAS_MIN_2019-10-24
LAC,2019-10-20,4,Sun,7,7,@,TEN,L 20-23,4,29,7,54,11,83,LAC_TEN_2019-10-20
NOR,2019-10-20,4,Sun,7,7,@,CHI,W 36-25,4,35,3,10,7,45,NOR_CHI_2019-10-20
DEN,2019-10-17,4,Thu,7,7,,KAN,L 6-30,4,33,6,46,10,79,DEN_KAN_2019-10-17
MIN,2019-10-13,4,Sun,6,6,,PHI,W 38-20,4,30,7,49,11,79,MIN_PHI_2019-10-13
SFO,2019-10-13,4,Sun,5,6,@,LAR,W 20-7,4,30,8,59,12,89,SFO_LAR_2019-10-13
CIN,2019-10-13,4,Sun,6,6,@,BAL,L 17-23,4,20,10,81,14,101,CIN_BAL_2019-10-13
SFO,2019-10-07,4,Mon,4,5,,CLE,W 31-3,4,34,7,55,11,89,SFO_CLE_2019-10-07
LAC,2019-10-06,4,Sun,5,5,,DEN,L 13-20,4,43,12,122,16,165,LAC_DEN_2019-10-06
TAM,2019-10-06,4,Sun,5,5,@,NOR,L 24-31,4,30,6,40,10,70,TAM_NOR_2019-10-06
PIT,2019-09-30,4,Mon,4,4,,CIN,W 27-3,4,37,8,60,12,97,PIT_CIN_2019-09-30
IND,2019-09-22,4,Sun,3,3,,ATL,W 27-24,4,39,16,128,20,167,IND_ATL_2019-09-22
PHI,2019-09-22,4,Sun,3,3,,DET,L 24-27,4,30,9,61,13,91,PHI_DET_2019-09-22
TAM,2019-09-22,4,Sun,3,3,,NYG,L 31-32,4,30,6,59,10,89,TAM_NYG_2019-09-22
KAN,2019-09-22,4,Sun,3,3,,BAL,W 33-28,4,31,7,60,11,91,KAN_BAL_2019-09-22
JAX,2019-09-19,4,Thu,3,3,,TEN,W 20-7,4,30,9,101,13,131,JAX_TEN_2019-09-19
MIA,2019-09-15,4,Sun,2,2,,NWE,L 0-43,4,22,5,54,9,76,MIA_NWE_2019-09-15
BAL,2019-09-08,4,Sun,1,1,@,MIA,W 59-10,4,40,9,64,13,104,BAL_MIA_2019-09-08
MIA,2018-12-30,4,Sun,16,17,@,BUF,L 17-42,4,35,3,24,7,59,MIA_BUF_2018-12-30
OAK,2018-12-30,4,Sun,16,17,@,KAN,L 3-35,4,22,4,50,8,72,OAK_KAN_2018-12-30
NYJ,2018-12-30,4,Sun,16,17,@,NWE,L 3-38,4,30,4,30,8,60,NYJ_NWE_2018-12-30
NWE,2018-12-30,4,Sun,16,17,,NYJ,W 38-3,4,30,4,30,8,60,NWE_NYJ_2018-12-30
KAN,2018-12-30,4,Sun,16,17,,OAK,W 35-3,4,50,4,22,8,72,KAN_OAK_2018-12-30
CLE,2018-12-30,4,Sun,16,17,@,BAL,L 24-26,4,35,10,65,14,100,CLE_BAL_2018-12-30
ATL,2018-12-23,4,Sun,15,16,@,CAR,W 24-10,4,41,10,86,14,127,ATL_CAR_2018-12-23
CHI,2018-12-23,4,Sun,15,16,@,SFO,W 14-9,4,30,6,45,10,75,CHI_SFO_2018-12-23
BAL,2018-12-22,4,Sat,15,16,@,LAC,W 22-10,4,40,8,69,12,109,BAL_LAC_2018-12-22
CAR,2018-12-17,4,Mon,14,15,,NOR,L 9-12,4,48,9,80,13,128,CAR_NOR_2018-12-17
DET,2018-12-16,4,Sun,14,15,@,BUF,L 13-14,4,81,3,20,7,101,DET_BUF_2018-12-16
CHI,2018-12-16,4,Sun,14,15,,GNB,W 24-17,4,24,7,48,11,72,CHI_GNB_2018-12-16
PIT,2018-12-16,4,Sun,14,15,,NWE,W 17-10,4,40,14,106,18,146,PIT_NWE_2018-12-16
TEN,2018-12-16,4,Sun,14,15,@,NYG,W 17-0,4,35,10,58,14,93,TEN_NYG_2018-12-16
SEA,2018-12-10,4,Mon,13,14,,MIN,W 21-7,4,45,4,51,8,96,SEA_MIN_2018-12-10
MIN,2018-12-10,4,Mon,13,14,@,SEA,L 7-21,4,51,4,45,8,96,MIN_SEA_2018-12-10
SEA,2018-11-25,4,Sun,11,12,@,CAR,W 30-27,4,36,3,30,7,66,SEA_CAR_2018-11-25
LAC,2018-11-25,4,Sun,11,12,,ARI,W 45-10,4,30,3,35,7,65,LAC_ARI_2018-11-25
GNB,2018-11-25,4,Sun,11,12,@,MIN,L 17-24,4,20,6,55,10,75,GNB_MIN_2018-11-25
OAK,2018-11-25,4,Sun,11,12,@,BAL,L 17-34,4,24,6,45,10,69,OAK_BAL_2018-11-25
WAS,2018-11-22,4,Thu,11,12,@,DAL,L 23-31,4,25,4,30,8,55,WAS_DAL_2018-11-22
DAL,2018-11-22,4,Thu,11,12,,WAS,W 31-23,4,30,4,25,8,55,DAL_WAS_2018-11-22
MIN,2018-11-18,4,Sun,10,11,@,CHI,L 20-25,4,50,5,46,9,96,MIN_CHI_2018-11-18
OAK,2018-11-18,4,Sun,10,11,@,ARI,W 23-21,4,20,7,62,11,82,OAK_ARI_2018-11-18
TAM,2018-11-18,4,Sun,10,11,@,NYG,L 35-38,4,40,8,60,12,100,TAM_NYG_2018-11-18
CIN,2018-11-11,4,Sun,9,10,,NOR,L 14-51,4,26,1,5,5,31,CIN_NOR_2018-11-11
TEN,2018-11-11,4,Sun,9,10,,NWE,W 34-10,4,35,4,31,8,66,TEN_NWE_2018-11-11
BUF,2018-11-11,4,Sun,10,10,@,NYJ,W 41-10,4,30,1,10,5,40,BUF_NYJ_2018-11-11
NWE,2018-11-11,4,Sun,10,10,@,TEN,L 10-34,4,31,4,35,8,66,NWE_TEN_2018-11-11
CLE,2018-11-04,4,Sun,9,9,,KAN,L 21-37,4,20,11,86,15,106,CLE_KAN_2018-11-04
LAR,2018-11-04,4,Sun,9,9,@,NOR,L 35-45,4,32,2,20,6,52,LAR_NOR_2018-11-04
PHI,2018-10-28,4,Sun,8,8,@,JAX,W 24-18,4,36,5,45,9,81,PHI_JAX_2018-10-28
CAR,2018-10-28,4,Sun,7,8,,BAL,W 36-21,4,30,9,68,13,98,CAR_BAL_2018-10-28
DET,2018-10-28,4,Sun,7,8,,SEA,L 14-28,4,32,7,111,11,143,DET_SEA_2018-10-28
CIN,2018-10-28,4,Sun,8,8,,TAM,W 37-34,4,46,11,75,15,121,CIN_TAM_2018-10-28
NYG,2018-10-22,4,Mon,7,7,@,ATL,L 20-23,4,58,5,29,9,87,NYG_ATL_2018-10-22
IND,2018-10-21,4,Sun,7,7,,BUF,W 37-5,4,35,7,59,11,94,IND_BUF_2018-10-21
PHI,2018-10-21,4,Sun,7,7,,CAR,L 17-21,4,35,5,78,9,113,PHI_CAR_2018-10-21
MIA,2018-10-21,4,Sun,7,7,,DET,L 21-32,4,50,6,43,10,93,MIA_DET_2018-10-21
LAC,2018-10-21,4,Sun,7,7,,TEN,W 20-19,4,31,4,32,8,63,LAC_TEN_2018-10-21
TEN,2018-10-21,4,Sun,7,7,@,LAC,L 19-20,4,32,4,31,8,63,TEN_LAC_2018-10-21
TAM,2018-10-14,4,Sun,5,6,@,ATL,L 29-34,4,20,5,30,9,50,TAM_ATL_2018-10-14
JAX,2018-10-14,4,Sun,6,6,@,DAL,L 7-40,4,30,3,25,7,55,JAX_DAL_2018-10-14
TEN,2018-10-14,4,Sun,6,6,,BAL,L 0-21,4,35,10,70,14,105,TEN_BAL_2018-10-14
PHI,2018-10-11,4,Thu,6,6,@,NYG,W 34-13,4,25,5,61,9,86,PHI_NYG_2018-10-11
NOR,2018-10-08,4,Mon,5,5,,WAS,W 43-19,4,45,6,38,10,83,NOR_WAS_2018-10-08
BAL,2018-10-07,4,Sun,5,5,@,CLE,L 9-12 (OT),4,41,10,66,14,107,BAL_CLE_2018-10-07
NYJ,2018-10-07,4,Sun,5,5,,DEN,W 34-16,4,33,6,45,10,78,NYJ_DEN_2018-10-07
CAR,2018-10-07,4,Sun,4,5,,NYG,W 33-31,4,22,8,62,12,84,CAR_NYG_2018-10-07
BUF,2018-10-07,4,Sun,5,5,,TEN,W 13-12,4,30,5,40,9,70,BUF_TEN_2018-10-07
MIN,2018-10-07,4,Sun,5,5,@,PHI,W 23-21,4,23,8,52,12,75,MIN_PHI_2018-10-07
IND,2018-10-04,4,Thu,5,5,@,NWE,L 24-38,4,35,7,50,11,85,IND_NWE_2018-10-04
TEN,2018-09-30,4,Sun,4,4,,PHI,W 26-23 (OT),4,30,8,77,12,107,TEN_PHI_2018-09-30
SFO,2018-09-30,4,Sun,4,4,@,LAC,L 27-29,4,29,5,49,9,78,SFO_LAC_2018-09-30
CHI,2018-09-30,4,Sun,4,4,,TAM,W 48-10,4,38,11,99,15,137,CHI_TAM_2018-09-30
MIN,2018-09-27,4,Thu,4,4,@,LAR,L 31-38,4,35,2,15,6,50,MIN_LAR_2018-09-27
CIN,2018-09-23,4,Sun,3,3,@,CAR,L 21-31,4,36,3,17,7,53,CIN_CAR_2018-09-23
TEN,2018-09-23,4,Sun,3,3,@,JAX,W 9-6,4,30,8,75,12,105,TEN_JAX_2018-09-23
