Team,Date,Pts,Day,G#,Week,,Opp,Result,Pts,PtsO,PtDif,PC,game_id
BAL,2019-09-08,59,Sun,1,1,@,MIA,W 59-10,59,10,49,69,BAL_MIA_2019-09-08
HOU,2017-10-01,57,Sun,4,4,,TEN,W 57-14,57,14,43,71,HOU_TEN_2017-10-01
DAL,2021-12-26,56,Sun,15,16,,WAS,W 56-14,56,14,42,70,DAL_WAS_2021-12-26
BUF,2021-01-03,56,Sun,16,17,,MIA,W 56-26,56,26,30,82,BUF_MIA_2021-01-03
TAM,2019-09-29,55,Sun,4,4,@,LAR,W 55-40,55,40,15,95,TAM_LAR_2019-09-29
DAL,2022-12-04,54,Sun,12,13,,IND,W 54-19,54,19,35,73,DAL_IND_2022-12-04
NWE,2021-10-24,54,Sun,7,7,,NYJ,W 54-13,54,13,41,67,NWE_NYJ_2021-10-24
LAR,2018-11-19,54,Mon,11,11,,KAN,W 54-51,54,51,3,105,LAR_KAN_2018-11-19
LAC,2017-11-19,54,Sun,10,11,,BUF,W 54-24,54,24,30,78,LAC_BUF_2017-11-19
HOU,2019-10-06,53,Sun,5,5,,ATL,W 53-32,53,32,21,85,HOU_ATL_2019-10-06
NOR,2020-12-25,52,Fri,15,16,,MIN,W 52-33,52,33,19,85,NOR_MIN_2020-12-25
PIT,2018-11-08,52,Thu,9,10,,CAR,W 52-21,52,21,31,73,PIT_CAR_2018-11-08
NOR,2017-10-15,52,Sun,5,6,,DET,W 52-38,52,38,14,90,NOR_DET_2017-10-15
LAR,2022-12-25,51,Sun,15,16,,DEN,W 51-14,51,14,37,65,LAR_DEN_2022-12-25
DAL,2022-01-08,51,Sat,17,18,@,PHI,W 51-26,51,26,25,77,DAL_PHI_2022-01-08
SEA,2022-01-02,51,Sun,16,17,,DET,W 51-29,51,29,22,80,SEA_DET_2022-01-02
SFO,2019-10-27,51,Sun,7,8,,CAR,W 51-13,51,13,38,64,SFO_CAR_2019-10-27
KAN,2018-11-19,51,Mon,11,11,@,LAR,L 51-54,51,54,-3,105,KAN_LAR_2018-11-19
NOR,2018-11-11,51,Sun,9,10,@,CIN,W 51-14,51,14,37,65,NOR_CIN_2018-11-11
LAR,2017-11-05,51,Sun,8,9,@,NYG,W 51-17,51,17,34,68,LAR_NYG_2017-11-05
PHI,2017-11-05,51,Sun,9,9,,DEN,W 51-23,51,23,28,74,PHI_DEN_2017-11-05
NWE,2022-01-02,50,Sun,16,17,,JAX,W 50-10,50,10,40,60,NWE_JAX_2022-01-02
DAL,2022-10-30,49,Sun,8,8,,CHI,W 49-29,49,29,20,78,DAL_CHI_2022-10-30
CLE,2020-10-04,49,Sun,4,4,@,DAL,W 49-38,49,38,11,87,CLE_DAL_2020-10-04
BAL,2019-11-10,49,Sun,9,10,@,CIN,W 49-13,49,13,36,62,BAL_CIN_2019-11-10
PHI,2022-12-11,48,Sun,13,14,@,NYG,W 48-22,48,22,26,70,PHI_NYG_2022-12-11
SEA,2022-10-02,48,Sun,4,4,@,DET,W 48-45,48,45,3,93,SEA_DET_2022-10-02
KAN,2021-12-12,48,Sun,13,14,,LVR,W 48-9,48,9,39,57,KAN_LVR_2021-12-12
TAM,2021-09-19,48,Sun,2,2,,ATL,W 48-25,48,25,23,73,TAM_ATL_2021-09-19
BUF,2020-12-19,48,Sat,14,15,@,DEN,W 48-19,48,19,29,67,BUF_DEN_2020-12-19
SFO,2019-12-08,48,Sun,13,14,@,NOR,W 48-46,48,46,2,94,SFO_NOR_2019-12-08
LAR,2018-12-30,48,Sun,16,17,,SFO,W 48-32,48,32,16,80,LAR_SFO_2018-12-30
NOR,2018-11-18,48,Sun,10,11,,PHI,W 48-7,48,7,41,55,NOR_PHI_2018-11-18
CHI,2018-09-30,48,Sun,4,4,,TAM,W 48-10,48,10,38,58,CHI_TAM_2018-09-30
NYJ,2018-09-10,48,Mon,1,1,@,DET,W 48-17,48,17,31,65,NYJ_DET_2018-09-10
TAM,2018-09-09,48,Sun,1,1,@,NOR,W 48-40,48,40,8,88,TAM_NOR_2018-09-09
LAC,2021-10-10,47,Sun,5,5,,CLE,W 47-42,47,42,5,89,LAC_CLE_2021-10-10
TAM,2020-12-26,47,Sat,15,16,@,DET,W 47-7,47,7,40,54,TAM_DET_2020-12-26
BAL,2020-12-14,47,Mon,13,14,@,CLE,W 47-42,47,42,5,89,BAL_CLE_2020-12-14
DAL,2019-12-29,47,Sun,16,17,,WAS,W 47-16,47,16,31,63,DAL_WAS_2019-12-29
BAL,2018-09-09,47,Sun,1,1,,BUF,W 47-3,47,3,44,50,BAL_BUF_2018-09-09
NOR,2017-11-12,47,Sun,9,10,@,BUF,W 47-10,47,10,37,57,NOR_BUF_2017-11-12
TEN,2020-12-20,46,Sun,14,15,,DET,W 46-25,46,25,21,71,TEN_DET_2020-12-20
TAM,2020-11-15,46,Sun,10,10,@,CAR,W 46-23,46,23,23,69,TAM_CAR_2020-11-15
NOR,2019-12-08,46,Sun,13,14,,SFO,L 46-48,46,48,-2,94,NOR_SFO_2019-12-08
SEA,2017-10-01,46,Sun,4,4,,IND,W 46-18,46,18,28,64,SEA_IND_2017-10-01
LAR,2017-09-10,46,Sun,1,1,,IND,W 46-9,46,9,37,55,LAR_IND_2017-09-10
DET,2022-10-02,45,Sun,4,4,,SEA,L 45-48,45,48,-3,93,DET_SEA_2022-10-02
GNB,2021-12-12,45,Sun,13,14,,CHI,W 45-30,45,30,15,75,GNB_CHI_2021-12-12
NWE,2021-11-14,45,Sun,10,10,,CLE,W 45-7,45,7,38,52,NWE_CLE_2021-11-14
BUF,2021-11-14,45,Sun,9,10,@,NYJ,W 45-17,45,17,28,62,BUF_NYJ_2021-11-14
IND,2021-11-04,45,Thu,9,9,,NYJ,W 45-30,45,30,15,75,IND_NYJ_2021-11-04
TAM,2021-10-10,45,Sun,5,5,,MIA,W 45-17,45,17,28,62,TAM_MIA_2021-10-10
NWE,2020-12-06,45,Sun,12,13,@,LAC,W 45-0,45,0,45,45,NWE_LAC_2020-12-06
TEN,2020-11-29,45,Sun,11,12,@,IND,W 45-26,45,26,19,71,TEN_IND_2020-11-29
TAM,2020-10-25,45,Sun,7,7,@,LVR,W 45-20,45,20,25,65,TAM_LVR_2020-10-25
LAC,2019-12-08,45,Sun,13,14,@,JAX,W 45-10,45,10,35,55,LAC_JAX_2019-12-08
BAL,2019-11-25,45,Mon,11,12,@,LAR,W 45-6,45,6,39,51,BAL_LAR_2019-11-25
LAC,2018-11-25,45,Sun,11,12,,ARI,W 45-10,45,10,35,55,LAC_ARI_2018-11-25
NOR,2018-11-04,45,Sun,8,9,,LAR,W 45-35,45,35,10,80,NOR_LAR_2018-11-04
KAN,2018-10-21,45,Sun,7,7,,CIN,W 45-10,45,10,35,55,KAN_CIN_2018-10-21
DEN,2018-10-18,45,Thu,7,7,@,ARI,W 45-10,45,10,35,55,DEN_ARI_2018-10-18
OAK,2018-09-30,45,Sun,4,4,,CLE,W 45-42 (OT),45,42,3,87,OAK_CLE_2018-09-30
JAX,2017-12-17,45,Sun,14,15,,HOU,W 45-7,45,7,38,52,JAX_HOU_2017-12-17
CAR,2017-11-13,45,Mon,10,10,,MIA,W 45-21,45,21,24,66,CAR_MIA_2017-11-13
OAK,2017-09-17,45,Sun,2,2,,NYJ,W 45-20,45,20,25,65,OAK_NYJ_2017-09-17
KAN,2022-10-23,44,Sun,7,7,@,SFO,W 44-23,44,23,21,67,KAN_SFO_2022-10-23
KAN,2022-09-11,44,Sun,1,1,@,ARI,W 44-21,44,21,23,65,KAN_ARI_2022-09-11
PHI,2021-10-31,44,Sun,8,8,@,DET,W 44-6,44,6,38,50,PHI_DET_2021-10-31
DAL,2021-10-10,44,Sun,5,5,,NYG,W 44-20,44,20,24,64,DAL_NYG_2021-10-10
TAM,2021-01-03,44,Sun,16,17,,ATL,W 44-27,44,27,17,71,TAM_ATL_2021-01-03
IND,2020-12-13,44,Sun,13,14,@,LVR,W 44-27,44,27,17,71,IND_LVR_2020-12-13
BUF,2020-11-08,44,Sun,9,9,,SEA,W 44-34,44,34,10,78,BUF_SEA_2020-11-08
DAL,2019-12-15,44,Sun,14,15,,LAR,W 44-21,44,21,23,65,DAL_LAR_2019-12-15
GNB,2018-12-23,44,Sun,15,16,@,NYJ,W 44-38 (OT),44,38,6,82,GNB_NYJ_2018-12-23
SFO,2017-12-24,44,Sun,15,16,,JAX,W 44-33,44,33,11,77,SFO_JAX_2017-12-24
BAL,2017-12-03,44,Sun,12,13,,DET,W 44-20,44,20,24,64,BAL_DET_2017-12-03
JAX,2017-09-24,44,Sun,3,3,,BAL,W 44-7,44,7,37,51,JAX_BAL_2017-09-24
DAL,2021-11-14,43,Sun,9,10,,ATL,W 43-3,43,3,40,46,DAL_ATL_2021-11-14
BUF,2021-09-26,43,Sun,3,3,,WAS,W 43-21,43,21,22,64,BUF_WAS_2021-09-26
ATL,2020-11-29,43,Sun,11,12,,LVR,W 43-6,43,6,37,49,ATL_LVR_2020-11-29
KAN,2020-10-25,43,Sun,7,7,@,DEN,W 43-16,43,16,27,59,KAN_DEN_2020-10-25
MIA,2020-10-11,43,Sun,5,5,@,SFO,W 43-17,43,17,26,60,MIA_SFO_2020-10-11
GNB,2020-09-13,43,Sun,1,1,@,MIN,W 43-34,43,34,9,77,GNB_MIN_2020-09-13
NWE,2019-09-15,43,Sun,2,2,@,MIA,W 43-0,43,0,43,43,NWE_MIA_2019-09-15
TEN,2019-09-08,43,Sun,1,1,@,CLE,W 43-13,43,13,30,56,TEN_CLE_2019-09-08
SEA,2018-12-02,43,Sun,12,13,,SFO,W 43-16,43,16,27,59,SEA_SFO_2018-12-02
NWE,2018-10-14,43,Sun,6,6,,KAN,W 43-40,43,40,3,83,NWE_KAN_2018-10-14
NOR,2018-10-08,43,Mon,5,5,,WAS,W 43-19,43,19,24,62,NOR_WAS_2018-10-08
NOR,2018-09-23,43,Sun,3,3,@,ATL,W 43-37 (OT),43,37,6,80,NOR_ATL_2018-09-23
PHI,2017-12-10,43,Sun,13,14,@,LAR,W 43-35,43,35,8,78,PHI_LAR_2017-12-10
CIN,2022-11-06,42,Sun,9,9,,CAR,W 42-21,42,21,21,63,CIN_CAR_2022-11-06
ARI,2022-10-20,42,Thu,7,7,,NOR,W 42-34,42,34,8,76,ARI_NOR_2022-10-20
MIA,2022-09-18,42,Sun,2,2,@,BAL,W 42-38,42,38,4,80,MIA_BAL_2022-09-18
CLE,2021-10-10,42,Sun,5,5,@,LAC,L 42-47,42,47,-5,89,CLE_LAC_2021-10-10
KAN,2021-10-03,42,Sun,4,4,@,PHI,W 42-30,42,30,12,72,KAN_PHI_2021-10-03
CLE,2020-12-14,42,Mon,13,14,,BAL,L 42-47,42,47,-5,89,CLE_BAL_2020-12-14
TEN,2020-10-18,42,Sun,5,6,,HOU,W 42-36 (OT),42,36,6,78,TEN_HOU_2020-10-18
TEN,2020-10-13,42,Tue,4,5,,BUF,W 42-16,42,16,26,58,TEN_BUF_2020-10-13
GNB,2020-09-20,42,Sun,2,2,,DET,W 42-21,42,21,21,63,GNB_DET_2020-09-20
NOR,2019-12-29,42,Sun,16,17,@,CAR,W 42-10,42,10,32,52,NOR_CAR_2019-12-29
BAL,2019-12-12,42,Thu,14,15,,NYJ,W 42-21,42,21,21,63,BAL_NYJ_2019-12-12
TEN,2019-12-08,42,Sun,13,14,@,OAK,W 42-21,42,21,21,63,TEN_OAK_2019-12-08
TEN,2019-11-24,42,Sun,11,12,,JAX,W 42-20,42,20,22,62,TEN_JAX_2019-11-24
MIN,2019-10-20,42,Sun,7,7,@,DET,W 42-30,42,30,12,72,MIN_DET_2019-10-20
GNB,2019-10-20,42,Sun,7,7,,OAK,W 42-24,42,24,18,66,GNB_OAK_2019-10-20
BUF,2018-12-30,42,Sun,16,17,,MIA,W 42-17,42,17,25,59,BUF_MIA_2018-12-30
CAR,2018-11-04,42,Sun,8,9,,TAM,W 42-28,42,28,14,70,CAR_TAM_2018-11-04
IND,2018-10-28,42,Sun,8,8,@,OAK,W 42-28,42,28,14,70,IND_OAK_2018-10-28
HOU,2018-10-25,42,Thu,8,8,,MIA,W 42-23,42,23,19,65,HOU_MIA_2018-10-25
NYJ,2018-10-14,42,Sun,6,6,,IND,W 42-34,42,34,8,76,NYJ_IND_2018-10-14
CLE,2018-09-30,42,Sun,4,4,@,OAK,L 42-45 (OT),42,45,-3,87,CLE_OAK_2018-09-30
KAN,2018-09-16,42,Sun,2,2,@,PIT,W 42-37,42,37,5,79,KAN_PIT_2018-09-16
LAR,2017-12-17,42,Sun,14,15,@,SEA,W 42-7,42,7,35,49,LAR_SEA_2017-12-17
KAN,2017-10-08,42,Sun,5,5,@,HOU,W 42-34,42,34,8,76,KAN_HOU_2017-10-08
DEN,2017-09-17,42,Sun,2,2,,DAL,W 42-17,42,17,25,59,DEN_DAL_2017-09-17
KAN,2017-09-07,42,Thu,1,1,@,NWE,W 42-27,42,27,15,69,KAN_NWE_2017-09-07
DET,2023-01-01,41,Sun,16,17,,CHI,W 41-10,41,10,31,51,DET_CHI_2023-01-01
GNB,2023-01-01,41,Sun,16,17,,MIN,W 41-17,41,17,24,58,GNB_MIN_2023-01-01
KAN,2022-10-02,41,Sun,4,4,@,TAM,W 41-31,41,31,10,72,KAN_TAM_2022-10-02
BUF,2022-09-19,41,Mon,2,2,,TEN,W 41-7,41,7,34,48,BUF_TEN_2022-09-19
TAM,2022-01-09,41,Sun,17,18,,CAR,W 41-17,41,17,24,58,TAM_CAR_2022-01-09
HOU,2021-12-26,41,Sun,15,16,,LAC,W 41-29,41,29,12,70,HOU_LAC_2021-12-26
CIN,2021-12-26,41,Sun,15,16,,BAL,W 41-21,41,21,20,62,CIN_BAL_2021-12-26
LAC,2021-12-05,41,Sun,12,13,@,CIN,W 41-22,41,22,19,63,LAC_CIN_2021-12-05
CIN,2021-11-28,41,Sun,11,12,,PIT,W 41-10,41,10,31,51,CIN_PIT_2021-11-28
IND,2021-11-21,41,Sun,11,11,@,BUF,W 41-15,41,15,26,56,IND_BUF_2021-11-21
LAC,2021-11-21,41,Sun,10,11,,PIT,W 41-37,41,37,4,78,LAC_PIT_2021-11-21
KAN,2021-11-14,41,Sun,10,10,@,LVR,W 41-14,41,14,27,55,KAN_LVR_2021-11-14
CLE,2021-11-07,41,Sun,9,9,@,CIN,W 41-16,41,16,25,57,CLE_CIN_2021-11-07
CIN,2021-10-24,41,Sun,7,7,@,BAL,W 41-17,41,17,24,58,CIN_BAL_2021-10-24
DAL,2021-09-27,41,Mon,3,3,,PHI,W 41-21,41,21,20,62,DAL_PHI_2021-09-27
SFO,2021-09-12,41,Sun,1,1,@,DET,W 41-33,41,33,8,74,SFO_DET_2021-09-12
TEN,2021-01-03,41,Sun,16,17,@,HOU,W 41-38,41,38,3,79,TEN_HOU_2021-01-03
CHI,2020-12-27,41,Sun,15,16,@,JAX,W 41-17,41,17,24,58,CHI_JAX_2020-12-27
DAL,2020-12-20,41,Sun,14,15,,SFO,W 41-33,41,33,8,74,DAL_SFO_2020-12-20
CLE,2020-12-06,41,Sun,12,13,@,TEN,W 41-35,41,35,6,76,CLE_TEN_2020-12-06
GNB,2020-11-29,41,Sun,11,12,,CHI,W 41-25,41,25,16,66,GNB_CHI_2020-11-29
HOU,2020-11-26,41,Thu,11,12,@,DET,W 41-25,41,25,16,66,HOU_DET_2020-11-26
WAS,2020-11-26,41,Thu,11,12,@,DAL,W 41-16,41,16,25,57,WAS_DAL_2020-11-26
IND,2020-11-01,41,Sun,7,8,@,DET,W 41-21,41,21,20,62,IND_DET_2020-11-01
NYG,2019-12-22,41,Sun,15,16,@,WAS,W 41-35 (OT),41,35,6,76,NYG_WAS_2019-12-22
CLE,2019-11-24,41,Sun,11,12,,MIA,W 41-24,41,24,17,65,CLE_MIA_2019-11-24
BAL,2019-11-17,41,Sun,10,11,,HOU,W 41-7,41,7,34,48,BAL_HOU_2019-11-17
SFO,2019-09-15,41,Sun,2,2,@,CIN,W 41-17,41,17,24,58,SFO_CIN_2019-09-15
MIN,2018-12-16,41,Sun,14,15,,MIA,W 41-17,41,17,24,58,MIN_MIA_2018-12-16
BUF,2018-11-11,41,Sun,10,10,@,NYJ,W 41-10,41,10,31,51,BUF_NYJ_2018-11-11
CHI,2018-11-04,41,Sun,8,9,@,BUF,W 41-9,41,9,32,50,CHI_BUF_2018-11-04
PIT,2018-10-07,41,Sun,5,5,,ATL,W 41-17,41,17,24,58,PIT_ATL_2018-10-07
NWE,2017-11-12,41,Sun,9,10,@,DEN,W 41-16,41,16,25,57,NWE_DEN_2017-11-12
SEA,2017-10-29,41,Sun,7,8,,HOU,W 41-38,41,38,3,79,SEA_HOU_2017-10-29
LAR,2017-09-21,41,Thu,3,3,@,SFO,W 41-39,41,39,2,80,LAR_SFO_2017-09-21
DAL,2022-12-24,40,Sat,15,16,,PHI,W 40-34,40,34,6,74,DAL_PHI_2022-12-24
JAX,2022-12-18,40,Sun,14,15,,DAL,W 40-34 (OT),40,34,6,74,JAX_DAL_2022-12-18
DET,2022-12-04,40,Sun,12,13,,JAX,W 40-14,40,14,26,54,DET_JAX_2022-12-04
LVR,2022-11-27,40,Sun,11,12,@,SEA,W 40-34 (OT),40,34,6,74,LVR_SEA_2022-11-27
PHI,2022-11-27,40,Sun,11,12,,GNB,W 40-33,40,33,7,73,PHI_GNB_2022-11-27
DAL,2022-11-20,40,Sun,10,11,@,MIN,W 40-3,40,3,37,43,DAL_MIN_2022-11-20
NYJ,2022-10-09,40,Sun,5,5,,MIA,W 40-17,40,17,23,57,NYJ_MIA_2022-10-09
PHI,2021-11-21,40,Sun,11,11,,NOR,W 40-29,40,29,11,69,PHI_NOR_2021-11-21
BUF,2021-10-03,40,Sun,4,4,,HOU,W 40-0,40,0,40,40,BUF_HOU_2021-10-03
GNB,2020-12-27,40,Sun,15,16,,TEN,W 40-14,40,14,26,54,GNB_TEN_2020-12-27
BAL,2020-12-20,40,Sun,14,15,,JAX,W 40-14,40,14,26,54,BAL_JAX_2020-12-20
SEA,2020-12-13,40,Sun,13,14,,NYJ,W 40-3,40,3,37,43,SEA_NYJ_2020-12-13
ATL,2020-10-18,40,Sun,6,6,@,MIN,W 40-23,40,23,17,63,ATL_MIN_2020-10-18
LVR,2020-10-11,40,Sun,5,5,@,KAN,W 40-32,40,32,8,72,LVR_KAN_2020-10-11
DAL,2020-09-20,40,Sun,2,2,,ATL,W 40-39,40,39,1,79,DAL_ATL_2020-09-20
ATL,2019-12-08,40,Sun,13,14,,CAR,W 40-20,40,20,20,60,ATL_CAR_2019-12-08
KAN,2019-12-01,40,Sun,12,13,,OAK,W 40-9,40,9,31,49,KAN_OAK_2019-12-01
SEA,2019-11-03,40,Sun,9,9,,TAM,W 40-34 (OT),40,34,6,74,SEA_TAM_2019-11-03
CLE,2019-09-29,40,Sun,4,4,@,BAL,W 40-25,40,25,15,65,CLE_BAL_2019-09-29
LAR,2019-09-29,40,Sun,4,4,,TAM,L 40-55,40,55,-15,95,LAR_TAM_2019-09-29
KAN,2019-09-08,40,Sun,1,1,@,JAX,W 40-26,40,26,14,66,KAN_JAX_2019-09-08
ATL,2018-12-16,40,Sun,14,15,,ARI,W 40-14,40,14,26,54,ATL_ARI_2018-12-16
NYG,2018-12-09,40,Sun,13,14,@,WAS,W 40-16,40,16,24,56,NYG_WAS_2018-12-09
KAN,2018-12-02,40,Sun,12,13,@,OAK,W 40-33,40,33,7,73,KAN_OAK_2018-12-02
KAN,2018-10-14,40,Sun,6,6,@,NWE,L 40-43,40,43,-3,83,KAN_NWE_2018-10-14
DAL,2018-10-14,40,Sun,6,6,,JAX,W 40-7,40,7,33,47,DAL_JAX_2018-10-14
NOR,2018-09-09,40,Sun,1,1,,TAM,L 40-48,40,48,-8,88,NOR_TAM_2018-09-09
PIT,2017-11-16,40,Thu,10,11,,TEN,W 40-17,40,17,23,57,PIT_TEN_2017-11-16
BAL,2017-10-26,40,Thu,8,8,,MIA,W 40-0,40,0,40,40,BAL_MIA_2017-10-26
DAL,2017-10-22,40,Sun,6,7,@,SFO,W 40-10,40,10,30,50,DAL_SFO_2017-10-22
MIN,2022-12-17,39,Sat,14,15,,IND,W 39-36 (OT),39,36,3,75,MIN_IND_2022-12-17
MIA,2022-11-13,39,Sun,10,10,,CLE,W 39-17,39,17,22,56,MIA_CLE_2022-11-13
NOR,2022-10-09,39,Sun,5,5,,SEA,W 39-32,39,32,7,71,NOR_SEA_2022-10-09
LAC,2020-10-25,39,Sun,6,7,,JAX,W 39-29,39,29,10,68,LAC_JAX_2020-10-25
ATL,2020-09-20,39,Sun,2,2,@,DAL,L 39-40,39,40,-1,79,ATL_DAL_2020-09-20
MIN,2019-12-15,39,Sun,14,15,@,LAC,W 39-10,39,10,29,49,MIN_LAC_2019-12-15
LAR,2018-10-21,39,Sun,7,7,@,SFO,W 39-10,39,10,29,49,LAR_SFO_2018-10-21
PIT,2017-12-10,39,Sun,13,14,,BAL,W 39-38,39,38,1,77,PIT_BAL_2017-12-10
SFO,2017-09-21,39,Thu,3,3,,LAR,L 39-41,39,41,-2,80,SFO_LAR_2017-09-21
SFO,2023-01-08,38,Sun,17,18,,ARI,W 38-13,38,13,25,51,SFO_ARI_2023-01-08
NYG,2023-01-01,38,Sun,16,17,,IND,W 38-10,38,10,28,48,NYG_IND_2023-01-01
SFO,2022-11-21,38,Mon,10,11,@,ARI,W 38-10,38,10,28,48,SFO_ARI_2022-11-21
LVR,2022-10-23,38,Sun,6,7,,HOU,W 38-20,38,20,18,58,LVR_HOU_2022-10-23
NWE,2022-10-16,38,Sun,6,6,@,CLE,W 38-15,38,15,23,53,NWE_CLE_2022-10-16
BUF,2022-10-09,38,Sun,5,5,,PIT,W 38-3,38,3,35,41,BUF_PIT_2022-10-09
JAX,2022-09-25,38,Sun,3,3,@,LAC,W 38-10,38,10,28,48,JAX_LAC_2022-09-25
BAL,2022-09-18,38,Sun,2,2,,MIA,L 38-42,38,42,-4,80,BAL_MIA_2022-09-18
PHI,2022-09-11,38,Sun,1,1,@,DET,W 38-35,38,35,3,73,PHI_DET_2022-09-11
SEA,2022-01-09,38,Sun,17,18,@,ARI,W 38-30,38,30,8,68,SEA_ARI_2022-01-09
DEN,2021-12-12,38,Sun,13,14,,DET,W 38-10,38,10,28,48,DEN_DET_2021-12-12
TAM,2021-11-28,38,Sun,11,12,@,IND,W 38-31,38,31,7,69,TAM_IND_2021-11-28
LAR,2021-10-31,38,Sun,8,8,@,HOU,W 38-22,38,22,16,60,LAR_HOU_2021-10-31
TAM,2021-10-24,38,Sun,7,7,,CHI,W 38-3,38,3,35,41,TAM_CHI_2021-10-24
LAR,2021-10-17,38,Sun,6,6,@,NYG,W 38-11,38,11,27,49,LAR_NYG_2021-10-17
BUF,2021-10-10,38,Sun,5,5,@,KAN,W 38-20,38,20,18,58,BUF_KAN_2021-10-10
ARI,2021-09-12,38,Sun,1,1,@,TEN,W 38-13,38,13,25,51,ARI_TEN_2021-09-12
NOR,2021-09-12,38,Sun,1,1,,GNB,W 38-3,38,3,35,41,NOR_GNB_2021-09-12
HOU,2021-01-03,38,Sun,16,17,,TEN,L 38-41,38,41,-3,79,HOU_TEN_2021-01-03
BAL,2021-01-03,38,Sun,16,17,@,CIN,W 38-3,38,3,35,41,BAL_CIN_2021-01-03
LAC,2021-01-03,38,Sun,16,17,@,KAN,W 38-21,38,21,17,59,LAC_KAN_2021-01-03
BUF,2020-12-28,38,Mon,15,16,@,NWE,W 38-9,38,9,29,47,BUF_NWE_2020-12-28
LAR,2020-12-06,38,Sun,12,13,@,ARI,W 38-28,38,28,10,66,LAR_ARI_2020-12-06
NOR,2020-11-08,38,Sun,8,9,@,TAM,W 38-3,38,3,35,41,NOR_TAM_2020-11-08
ARI,2020-10-19,38,Mon,6,6,@,DAL,W 38-10,38,10,28,48,ARI_DAL_2020-10-19
PIT,2020-10-18,38,Sun,5,6,,CLE,W 38-7,38,7,31,45,PIT_CLE_2020-10-18
TAM,2020-10-18,38,Sun,6,6,,GNB,W 38-10,38,10,28,48,TAM_GNB_2020-10-18
PIT,2020-10-11,38,Sun,4,5,,PHI,W 38-29,38,29,9,67,PIT_PHI_2020-10-11
TAM,2020-10-04,38,Sun,4,4,,LAC,W 38-31,38,31,7,69,TAM_LAC_2020-10-04
DAL,2020-10-04,38,Sun,4,4,,CLE,L 38-49,38,49,-11,87,DAL_CLE_2020-10-04
SEA,2020-09-27,38,Sun,3,3,,DAL,W 38-31,38,31,7,69,SEA_DAL_2020-09-27
SEA,2020-09-13,38,Sun,1,1,@,ATL,W 38-25,38,25,13,63,SEA_ATL_2020-09-13
BAL,2020-09-13,38,Sun,1,1,,CLE,W 38-6,38,6,32,44,BAL_CLE_2020-09-13
JAX,2019-12-29,38,Sun,16,17,,IND,W 38-20,38,20,18,58,JAX_IND_2019-12-29
IND,2019-12-22,38,Sun,15,16,,CAR,W 38-6,38,6,32,44,IND_CAR_2019-12-22
NOR,2019-12-22,38,Sun,15,16,@,TEN,W 38-28,38,28,10,66,NOR_TEN_2019-12-22
MIA,2019-12-22,38,Sun,15,16,,CIN,W 38-35 (OT),38,35,3,73,MIA_CIN_2019-12-22
TAM,2019-12-15,38,Sun,14,15,@,DET,W 38-17,38,17,21,55,TAM_DET_2019-12-15
ARI,2019-12-15,38,Sun,14,15,,CLE,W 38-24,38,24,14,62,ARI_CLE_2019-12-15
TAM,2019-12-08,38,Sun,13,14,,IND,W 38-35,38,35,3,73,TAM_IND_2019-12-08
DEN,2019-12-08,38,Sun,13,14,@,HOU,W 38-24,38,24,14,62,DEN_HOU_2019-12-08
MIN,2019-10-13,38,Sun,6,6,,PHI,W 38-20,38,20,18,58,MIN_PHI_2019-10-13
CAR,2019-09-22,38,Sun,3,3,@,ARI,W 38-20,38,20,18,58,CAR_ARI_2019-09-22
NWE,2018-12-30,38,Sun,16,17,,NYJ,W 38-3,38,3,35,41,NWE_NYJ_2018-12-30
NYJ,2018-12-23,38,Sun,15,16,,GNB,L 38-44 (OT),38,44,-6,82,NYJ_GNB_2018-12-23
SEA,2018-12-23,38,Sun,15,16,,KAN,W 38-31,38,31,7,69,SEA_KAN_2018-12-23
NYG,2018-11-18,38,Sun,10,11,,TAM,W 38-35,38,35,3,73,NYG_TAM_2018-11-18
IND,2018-11-18,38,Sun,10,11,,TEN,W 38-10,38,10,28,48,IND_TEN_2018-11-18
ATL,2018-11-04,38,Sun,8,9,@,WAS,W 38-14,38,14,24,52,ATL_WAS_2018-11-04
NWE,2018-10-21,38,Sun,7,7,@,CHI,W 38-31,38,31,7,69,NWE_CHI_2018-10-21
LAC,2018-10-14,38,Sun,6,6,@,CLE,W 38-14,38,14,24,52,LAC_CLE_2018-10-14
NWE,2018-10-04,38,Thu,5,5,,IND,W 38-24,38,24,14,62,NWE_IND_2018-10-04
NWE,2018-09-30,38,Sun,4,4,,MIA,W 38-7,38,7,31,45,NWE_MIA_2018-09-30
LAR,2018-09-27,38,Thu,4,4,,MIN,W 38-31,38,31,7,69,LAR_MIN_2018-09-27
KAN,2018-09-23,38,Sun,3,3,,SFO,W 38-27,38,27,11,65,KAN_SFO_2018-09-23
KAN,2018-09-09,38,Sun,1,1,@,LAC,W 38-28,38,28,10,66,KAN_LAC_2018-09-09
BAL,2017-12-10,38,Sun,13,14,@,PIT,L 38-39,38,39,-1,77,BAL_PIT_2017-12-10
NYJ,2017-12-03,38,Sun,12,13,,KAN,W 38-31,38,31,7,69,NYJ_KAN_2017-12-03
DAL,2017-11-30,38,Thu,12,13,,WAS,W 38-14,38,14,24,52,DAL_WAS_2017-11-30
DET,2017-11-12,38,Sun,9,10,,CLE,W 38-24,38,24,14,62,DET_CLE_2017-11-12
MIN,2017-11-12,38,Sun,9,10,@,WAS,W 38-30,38,30,8,68,MIN_WAS_2017-11-12
HOU,2017-10-29,38,Sun,7,8,@,SEA,L 38-41,38,41,-3,79,HOU_SEA_2017-10-29
DET,2017-10-15,38,Sun,6,6,@,NOR,L 38-52,38,52,-14,90,DET_NOR_2017-10-15
ARI,2017-10-15,38,Sun,6,6,,TAM,W 38-33,38,33,5,71,ARI_TAM_2017-10-15
SFO,2023-01-01,37,Sun,16,17,@,LVR,W 37-34 (OT),37,34,3,71,SFO_LVR_2023-01-01
SFO,2022-12-24,37,Sat,15,16,,WAS,W 37-20,37,20,17,57,SFO_WAS_2022-12-24
CAR,2022-12-24,37,Sat,15,16,,DET,W 37-23,37,23,14,60,CAR_DET_2022-12-24
CIN,2022-11-20,37,Sun,10,11,@,PIT,W 37-30,37,30,7,67,CIN_PIT_2022-11-20
ATL,2022-10-30,37,Sun,8,8,,CAR,W 37-34 (OT),37,34,3,71,ATL_CAR_2022-10-30
SEA,2022-10-23,37,Sun,7,7,@,LAC,W 37-23,37,23,14,60,SEA_LAC_2022-10-23
SFO,2022-10-09,37,Sun,5,5,@,CAR,W 37-15,37,15,22,52,SFO_CAR_2022-10-09
BAL,2022-09-25,37,Sun,3,3,@,NWE,W 37-26,37,26,11,63,BAL_NWE_2022-09-25
DET,2022-01-09,37,Sun,17,18,,GNB,W 37-30,37,30,7,67,DET_GNB_2022-01-09
GNB,2022-01-02,37,Sun,16,17,,MIN,W 37-10,37,10,27,47,GNB_MIN_2022-01-02
LAC,2021-12-12,37,Sun,13,14,,NYG,W 37-21,37,21,16,58,LAC_NYG_2021-12-12
LAR,2021-12-05,37,Sun,12,13,,JAX,W 37-7,37,7,30,44,LAR_JAX_2021-12-05
PIT,2021-11-21,37,Sun,10,11,@,LAC,L 37-41,37,41,-4,78,PIT_LAC_2021-11-21
ARI,2021-10-17,37,Sun,6,6,@,CLE,W 37-14,37,14,23,51,ARI_CLE_2021-10-17
TEN,2021-10-10,37,Sun,5,5,@,JAX,W 37-19,37,19,18,56,TEN_JAX_2021-10-10
ARI,2021-10-03,37,Sun,4,4,@,LAR,W 37-20,37,20,17,57,ARI_LAR_2021-10-03
HOU,2021-09-12,37,Sun,1,1,,JAX,W 37-21,37,21,16,58,HOU_JAX_2021-09-12
MIN,2021-01-03,37,Sun,16,17,@,DET,W 37-35,37,35,2,72,MIN_DET_2021-01-03
DAL,2020-12-27,37,Sun,15,16,,PHI,W 37-17,37,17,20,54,DAL_PHI_2020-12-27
CIN,2020-12-27,37,Sun,15,16,@,HOU,W 37-31,37,31,6,68,CIN_HOU_2020-12-27
LVR,2020-11-15,37,Sun,9,10,,DEN,W 37-12,37,12,25,49,LVR_DEN_2020-11-15
SEA,2020-11-01,37,Sun,7,8,,SFO,W 37-27,37,27,10,64,SEA_SFO_2020-11-01
ARI,2020-10-25,37,Sun,7,7,,SEA,W 37-34 (OT),37,34,3,71,ARI_SEA_2020-10-25
CLE,2020-10-25,37,Sun,7,7,@,CIN,W 37-34,37,34,3,71,CLE_CIN_2020-10-25
DAL,2020-10-11,37,Sun,5,5,,NYG,W 37-34,37,34,3,71,DAL_NYG_2020-10-11
DEN,2020-10-01,37,Thu,4,4,@,NYJ,W 37-28,37,28,9,65,DEN_NYJ_2020-10-01
GNB,2020-09-27,37,Sun,3,3,@,NOR,W 37-30,37,30,7,67,GNB_NOR_2020-09-27
LAR,2020-09-20,37,Sun,2,2,@,PHI,W 37-19,37,19,18,56,LAR_PHI_2020-09-20
PHI,2019-12-15,37,Sun,14,15,@,WAS,W 37-27,37,27,10,64,PHI_WAS_2019-12-15
SEA,2019-12-02,37,Mon,12,13,,MIN,W 37-30,37,30,7,67,SEA_MIN_2019-12-02
MIA,2019-12-01,37,Sun,12,13,,PHI,W 37-31,37,31,6,68,MIA_PHI_2019-12-01
SFO,2019-11-24,37,Sun,11,12,,GNB,W 37-8,37,8,29,45,SFO_GNB_2019-11-24
BUF,2019-11-17,37,Sun,10,11,@,MIA,W 37-20,37,20,17,57,BUF_MIA_2019-11-17
DAL,2019-11-04,37,Mon,8,9,@,NYG,W 37-18,37,18,19,55,DAL_NYG_2019-11-04
BAL,2019-11-03,37,Sun,8,9,,NWE,W 37-20,37,20,17,57,BAL_NWE_2019-11-03
DAL,2019-10-20,37,Sun,7,7,,PHI,W 37-10,37,10,27,47,DAL_PHI_2019-10-20
LAR,2019-10-20,37,Sun,7,7,@,ATL,W 37-10,37,10,27,47,LAR_ATL_2019-10-20
CAR,2019-10-13,37,Sun,6,6,@,TAM,W 37-26,37,26,11,63,CAR_TAM_2019-10-13
KAN,2018-11-04,37,Sun,9,9,@,CLE,W 37-21,37,21,16,58,KAN_CLE_2018-11-04
CIN,2018-10-28,37,Sun,8,8,,TAM,W 37-34,37,34,3,71,CIN_TAM_2018-10-28
IND,2018-10-21,37,Sun,7,7,,BUF,W 37-5,37,5,32,42,IND_BUF_2018-10-21
MIN,2018-10-21,37,Sun,7,7,@,NYJ,W 37-17,37,17,20,54,MIN_NYJ_2018-10-21
CIN,2018-09-30,37,Sun,4,4,@,ATL,W 37-36,37,36,1,73,CIN_ATL_2018-09-30
HOU,2018-09-30,37,Sun,4,4,@,IND,W 37-34 (OT),37,34,3,71,HOU_IND_2018-09-30
ATL,2018-09-23,37,Sun,3,3,,NOR,L 37-43 (OT),37,43,-6,80,ATL_NOR_2018-09-23
PIT,2018-09-16,37,Sun,2,2,,KAN,L 37-42,37,42,-5,79,PIT_KAN_2018-09-16
NWE,2017-12-24,37,Sun,15,16,,BUF,W 37-16,37,16,21,53,NWE_BUF_2017-12-24
PHI,2017-11-19,37,Sun,10,11,@,DAL,W 37-9,37,9,28,46,PHI_DAL_2017-11-19
TEN,2017-09-17,37,Sun,2,2,@,JAX,W 37-16,37,16,21,53,TEN_JAX_2017-09-17
IND,2022-12-17,36,Sat,14,15,@,MIN,L 36-39 (OT),36,39,-3,75,IND_MIN_2022-12-17
JAX,2022-12-11,36,Sun,13,14,@,TEN,W 36-22,36,22,14,58,JAX_TEN_2022-12-11
DET,2022-09-18,36,Sun,2,2,,WAS,W 36-27,36,27,9,63,DET_WAS_2022-09-18
KAN,2021-12-26,36,Sun,15,16,,PIT,W 36-10,36,10,26,46,KAN_PIT_2021-12-26
MIN,2021-12-09,36,Thu,13,14,,PIT,W 36-28,36,28,8,64,MIN_PIT_2021-12-09
GNB,2021-11-28,36,Sun,12,12,,LAR,W 36-28,36,28,8,64,GNB_LAR_2021-11-28
NWE,2021-11-28,36,Sun,12,12,,TEN,W 36-13,36,13,23,49,NWE_TEN_2021-11-28
LVR,2021-11-25,36,Thu,11,12,@,DAL,W 36-33 (OT),36,33,3,69,LVR_DAL_2021-11-25
NOR,2021-10-31,36,Sun,7,8,,TAM,W 36-27,36,27,9,63,NOR_TAM_2021-10-31
DAL,2021-10-03,36,Sun,4,4,,CAR,W 36-28,36,28,8,64,DAL_CAR_2021-10-03
BAL,2021-09-19,36,Sun,2,2,,KAN,W 36-35,36,35,1,71,BAL_KAN_2021-09-19
CHI,2020-12-13,36,Sun,13,14,,HOU,W 36-7,36,7,29,43,CHI_HOU_2020-12-13
PIT,2020-11-15,36,Sun,9,10,,CIN,W 36-10,36,10,26,46,PIT_CIN_2020-11-15
HOU,2020-10-18,36,Sun,6,6,@,TEN,L 36-42 (OT),36,42,-6,78,HOU_TEN_2020-10-18
SFO,2020-09-27,36,Sun,3,3,@,NYG,W 36-9,36,9,27,45,SFO_NYG_2020-09-27
NWE,2020-09-27,36,Sun,3,3,,LVR,W 36-20,36,20,16,56,NWE_LVR_2020-09-27
IND,2020-09-27,36,Sun,3,3,,NYJ,W 36-7,36,7,29,43,IND_NYJ_2020-09-27
NYG,2019-12-15,36,Sun,14,15,,MIA,W 36-20,36,20,16,56,NYG_MIA_2019-12-15
SFO,2019-11-17,36,Sun,10,11,,ARI,W 36-26,36,26,10,62,SFO_ARI_2019-11-17
NOR,2019-10-20,36,Sun,7,7,@,CHI,W 36-25,36,25,11,61,NOR_CHI_2019-10-20
DAL,2018-12-30,36,Sun,16,17,@,NYG,W 36-35,36,35,1,71,DAL_NYG_2018-12-30
LAR,2018-11-11,36,Sun,10,10,,SEA,W 36-31,36,31,5,67,LAR_SEA_2018-11-11
CAR,2018-10-28,36,Sun,7,8,,BAL,W 36-21,36,21,15,57,CAR_BAL_2018-10-28
ATL,2018-09-30,36,Sun,4,4,,CIN,L 36-37,36,37,-1,73,ATL_CIN_2018-09-30
TEN,2017-10-16,36,Mon,6,6,,IND,W 36-22,36,22,14,58,TEN_IND_2017-10-16
NWE,2017-09-24,36,Sun,3,3,,HOU,W 36-33,36,33,3,69,NWE_HOU_2017-09-24
NWE,2017-09-17,36,Sun,2,2,@,NOR,W 36-20,36,20,16,56,NWE_NOR_2017-09-17
BUF,2023-01-08,35,Sun,16,18,,NWE,W 35-23,35,23,12,58,BUF_NWE_2023-01-08
BUF,2022-12-24,35,Sat,15,16,@,CHI,W 35-13,35,13,22,48,BUF_CHI_2022-12-24
SFO,2022-12-11,35,Sun,13,14,,TAM,W 35-7,35,7,28,42,SFO_TAM_2022-12-11
PHI,2022-12-04,35,Sun,12,13,,TEN,W 35-10,35,10,25,45,PHI_TEN_2022-12-04
MIA,2022-11-06,35,Sun,9,9,@,CHI,W 35-32,35,32,3,67,MIA_CHI_2022-11-06
PHI,2022-10-30,35,Sun,7,8,,PIT,W 35-13,35,13,22,48,PHI_PIT_2022-10-30
CIN,2022-10-23,35,Sun,7,7,,ATL,W 35-17,35,17,18,52,CIN_ATL_2022-10-23
DET,2022-09-11,35,Sun,1,1,,PHI,L 35-38,35,38,-3,73,DET_PHI_2022-09-11
LVR,2022-01-09,35,Sun,17,18,,LAC,W 35-32 (OT),35,32,3,67,LVR_LAC_2022-01-09
DAL,2021-10-17,35,Sun,6,6,@,NWE,W 35-29 (OT),35,29,6,64,DAL_NWE_2021-10-17
GNB,2021-09-20,35,Mon,2,2,,DET,W 35-17,35,17,18,52,GNB_DET_2021-09-20
KAN,2021-09-19,35,Sun,2,2,@,BAL,L 35-36,35,36,-1,71,KAN_BAL_2021-09-19
BUF,2021-09-19,35,Sun,2,2,@,MIA,W 35-0,35,0,35,35,BUF_MIA_2021-09-19
GNB,2021-01-03,35,Sun,16,17,@,CHI,W 35-16,35,16,19,51,GNB_CHI_2021-01-03
DET,2021-01-03,35,Sun,16,17,,MIN,L 35-37,35,37,-2,72,DET_MIN_2021-01-03
TEN,2020-12-06,35,Sun,12,13,,CLE,L 35-41,35,41,-6,76,TEN_CLE_2020-12-06
KAN,2020-11-22,35,Sun,10,11,@,LVR,W 35-31,35,31,4,66,KAN_LVR_2020-11-22
KAN,2020-11-01,35,Sun,8,8,,NYJ,W 35-9,35,9,26,44,KAN_NYJ_2020-11-01
GNB,2020-10-25,35,Sun,6,7,@,HOU,W 35-20,35,20,15,55,GNB_HOU_2020-10-25
NOR,2020-10-04,35,Sun,4,4,@,DET,W 35-29,35,29,6,64,NOR_DET_2020-10-04
BUF,2020-09-27,35,Sun,3,3,,LAR,W 35-32,35,32,3,67,BUF_LAR_2020-09-27
SEA,2020-09-20,35,Sun,2,2,,NWE,W 35-30,35,30,5,65,SEA_NWE_2020-09-20
CLE,2020-09-17,35,Thu,2,2,,CIN,W 35-30,35,30,5,65,CLE_CIN_2020-09-17
TEN,2019-12-29,35,Sun,16,17,@,HOU,W 35-14,35,14,21,49,TEN_HOU_2019-12-29
WAS,2019-12-22,35,Sun,15,16,,NYG,L 35-41 (OT),35,41,-6,76,WAS_NYG_2019-12-22
CIN,2019-12-22,35,Sun,15,16,@,MIA,L 35-38 (OT),35,38,-3,73,CIN_MIA_2019-12-22
IND,2019-12-08,35,Sun,13,14,@,TAM,L 35-38,35,38,-3,73,IND_TAM_2019-12-08
TAM,2019-11-24,35,Sun,11,12,@,ATL,W 35-22,35,22,13,57,TAM_ATL_2019-11-24
DAL,2019-11-17,35,Sun,10,11,@,DET,W 35-27,35,27,8,62,DAL_DET_2019-11-17
TEN,2019-11-10,35,Sun,10,10,,KAN,W 35-32,35,32,3,67,TEN_KAN_2019-11-10
NWE,2019-10-10,35,Thu,6,6,,NYG,W 35-14,35,14,21,49,NWE_NYG_2019-10-10
DAL,2019-09-08,35,Sun,1,1,,NYG,W 35-17,35,17,18,52,DAL_NYG_2019-09-08
NYG,2018-12-30,35,Sun,16,17,,DAL,L 35-36,35,36,-1,71,NYG_DAL_2018-12-30
KAN,2018-12-30,35,Sun,16,17,,OAK,W 35-3,35,3,32,38,KAN_OAK_2018-12-30
CLE,2018-11-25,35,Sun,11,12,@,CIN,W 35-20,35,20,15,55,CLE_CIN_2018-11-25
TAM,2018-11-18,35,Sun,10,11,@,NYG,L 35-38,35,38,-3,73,TAM_NYG_2018-11-18
LAR,2018-11-04,35,Sun,9,9,@,NOR,L 35-45,35,45,-10,80,LAR_NOR_2018-11-04
LAR,2018-09-23,35,Sun,3,3,,LAC,W 35-23,35,23,12,58,LAR_LAC_2018-09-23
DET,2017-12-31,35,Sun,16,17,,GNB,W 35-11,35,11,24,46,DET_GNB_2017-12-31
LAR,2017-12-10,35,Sun,13,14,,PHI,L 35-43,35,43,-8,78,LAR_PHI_2017-12-10
MIA,2017-12-03,35,Sun,12,13,,DEN,W 35-9,35,9,26,44,MIA_DEN_2017-12-03
NWE,2017-11-26,35,Sun,11,12,,MIA,W 35-17,35,17,18,52,NWE_MIA_2017-11-26
CAR,2017-11-26,35,Sun,11,12,@,NYJ,W 35-27,35,27,8,62,CAR_NYJ_2017-11-26
GNB,2017-10-08,35,Sun,5,5,@,DAL,W 35-31,35,31,4,66,GNB_DAL_2017-10-08
LAR,2017-10-01,35,Sun,4,4,@,DAL,W 35-30,35,30,5,65,LAR_DAL_2017-10-01
GNB,2017-09-28,35,Thu,4,4,,CHI,W 35-14,35,14,21,49,GNB_CHI_2017-09-28
DET,2017-09-10,35,Sun,1,1,,ARI,W 35-23,35,23,12,58,DET_ARI_2017-09-10
LVR,2023-01-01,34,Sun,16,17,,SFO,L 34-37 (OT),34,37,-3,71,LVR_SFO_2023-01-01
PHI,2022-12-24,34,Sat,15,16,@,DAL,L 34-40,34,40,-6,74,PHI_DAL_2022-12-24
DAL,2022-12-18,34,Sun,14,15,@,JAX,L 34-40 (OT),34,40,-6,74,DAL_JAX_2022-12-18
CIN,2022-12-18,34,Sun,14,15,@,TAM,W 34-23,34,23,11,57,CIN_TAM_2022-12-18
DET,2022-12-11,34,Sun,13,14,,MIN,W 34-23,34,23,11,57,DET_MIN_2022-12-11
KAN,2022-12-11,34,Sun,13,14,@,DEN,W 34-28,34,28,6,62,KAN_DEN_2022-12-11
SEA,2022-11-27,34,Sun,11,12,,LVR,L 34-40 (OT),34,40,-6,74,SEA_LVR_2022-11-27
MIN,2022-10-30,34,Sun,7,8,,ARI,W 34-26,34,26,8,60,MIN_ARI_2022-10-30
CAR,2022-10-30,34,Sun,8,8,@,ATL,L 34-37 (OT),34,37,-3,71,CAR_ATL_2022-10-30
NOR,2022-10-20,34,Thu,7,7,@,ARI,L 34-42,34,42,-8,76,NOR_ARI_2022-10-20
IND,2022-10-16,34,Sun,6,6,,JAX,W 34-27,34,27,7,61,IND_JAX_2022-10-16
LAC,2022-10-02,34,Sun,4,4,@,HOU,W 34-24,34,24,10,58,LAC_HOU_2022-10-02
CIN,2022-01-02,34,Sun,16,17,,KAN,W 34-31,34,31,3,65,CIN_KAN_2022-01-02
LAC,2022-01-02,34,Sun,16,17,,DEN,W 34-13,34,13,21,47,LAC_DEN_2022-01-02
TEN,2022-01-02,34,Sun,16,17,,MIA,W 34-3,34,3,31,37,TEN_MIA_2022-01-02
PHI,2021-12-26,34,Sun,15,16,,NYG,W 34-10,34,10,24,44,PHI_NYG_2021-12-26
KAN,2021-12-16,34,Thu,14,15,@,LAC,W 34-28 (OT),34,28,6,62,KAN_LAC_2021-12-16
SFO,2021-11-28,34,Sun,11,12,,MIN,W 34-26,34,26,8,60,SFO_MIN_2021-11-28
MIN,2021-11-21,34,Sun,10,11,,GNB,W 34-31,34,31,3,65,MIN_GNB_2021-11-21
CAR,2021-11-14,34,Sun,10,10,@,ARI,W 34-10,34,10,24,44,CAR_ARI_2021-11-14
BAL,2021-11-07,34,Sun,8,9,,MIN,W 34-31 (OT),34,31,3,65,BAL_MIN_2021-11-07
TEN,2021-10-31,34,Sun,8,8,@,IND,W 34-31 (OT),34,31,3,65,TEN_IND_2021-10-31
TEN,2021-10-31,34,Sun,8,8,@,IND,W 34-31 (OT),34,31,3,65,TEN_IND_2021-10-31
TEN,2021-10-18,34,Mon,6,6,,BUF,W 34-31,34,31,3,65,TEN_BUF_2021-10-18
BAL,2021-10-17,34,Sun,6,6,,LAC,W 34-6,34,6,28,40,BAL_LAC_2021-10-17
MIN,2021-10-17,34,Sun,6,6,@,CAR,W 34-28 (OT),34,28,6,62,MIN_CAR_2021-10-17
CIN,2021-10-17,34,Sun,6,6,@,DET,W 34-11,34,11,23,45,CIN_DET_2021-10-17
LVR,2021-10-17,34,Sun,6,6,@,DEN,W 34-24,34,24,10,58,LVR_DEN_2021-10-17
WAS,2021-10-03,34,Sun,4,4,@,ATL,W 34-30,34,30,4,64,WAS_ATL_2021-10-03
LAR,2021-09-26,34,Sun,3,3,,TAM,W 34-24,34,24,10,58,LAR_TAM_2021-09-26
ARI,2021-09-19,34,Sun,2,2,,MIN,W 34-33,34,33,1,67,ARI_MIN_2021-09-19
LAR,2021-09-12,34,Sun,1,1,,CHI,W 34-14,34,14,20,48,LAR_CHI_2021-09-12
BAL,2020-12-08,34,Tue,12,13,,DAL,W 34-17,34,17,17,51,BAL_DAL_2020-12-08
BUF,2020-12-07,34,Mon,12,13,@,SFO,W 34-24,34,24,10,58,BUF_SFO_2020-12-07
DET,2020-12-06,34,Sun,12,13,@,CHI,W 34-30,34,30,4,64,DET_CHI_2020-12-06
IND,2020-11-22,34,Sun,10,11,,GNB,W 34-31 (OT),34,31,3,65,IND_GNB_2020-11-22
LAC,2020-11-22,34,Sun,10,11,,NYJ,W 34-28,34,28,6,62,LAC_NYJ_2020-11-22
IND,2020-11-12,34,Thu,9,10,@,TEN,W 34-17,34,17,17,51,IND_TEN_2020-11-12
MIA,2020-11-08,34,Sun,8,9,@,ARI,W 34-31,34,31,3,65,MIA_ARI_2020-11-08
ATL,2020-11-08,34,Sun,9,9,,DEN,W 34-27,34,27,7,61,ATL_DEN_2020-11-08
MIN,2020-11-08,34,Sun,8,9,,DET,W 34-20,34,20,14,54,MIN_DET_2020-11-08
SEA,2020-11-08,34,Sun,8,9,@,BUF,L 34-44,34,44,-10,78,SEA_BUF_2020-11-08
GNB,2020-11-05,34,Thu,8,9,@,SFO,W 34-17,34,17,17,51,GNB_SFO_2020-11-05
SEA,2020-10-25,34,Sun,6,7,@,ARI,L 34-37 (OT),34,37,-3,71,SEA_ARI_2020-10-25
CIN,2020-10-25,34,Sun,7,7,,CLE,L 34-37,34,37,-3,71,CIN_CLE_2020-10-25
DET,2020-10-18,34,Sun,5,6,@,JAX,W 34-16,34,16,18,50,DET_JAX_2020-10-18
NYG,2020-10-11,34,Sun,5,5,@,DAL,L 34-37,34,37,-3,71,NYG_DAL_2020-10-11
KAN,2020-09-28,34,Mon,3,3,@,BAL,W 34-20,34,20,14,54,KAN_BAL_2020-09-28
CLE,2020-09-27,34,Sun,3,3,,WAS,W 34-20,34,20,14,54,CLE_WAS_2020-09-27
LVR,2020-09-21,34,Mon,2,2,,NOR,W 34-24,34,24,10,58,LVR_NOR_2020-09-21
MIN,2020-09-13,34,Sun,1,1,,GNB,L 34-43,34,43,-9,77,MIN_GNB_2020-09-13
NOR,2020-09-13,34,Sun,1,1,,TAM,W 34-23,34,23,11,57,NOR_TAM_2020-09-13
LVR,2020-09-13,34,Sun,1,1,@,CAR,W 34-30,34,30,4,64,LVR_CAR_2020-09-13
KAN,2020-09-10,34,Thu,1,1,,HOU,W 34-20,34,20,14,54,KAN_HOU_2020-09-10
PHI,2019-12-29,34,Sun,16,17,@,NYG,W 34-17,34,17,17,51,PHI_NYG_2019-12-29
SFO,2019-12-21,34,Sat,15,16,,LAR,W 34-31,34,31,3,65,SFO_LAR_2019-12-21
NOR,2019-12-16,34,Mon,14,15,,IND,W 34-7,34,7,27,41,NOR_IND_2019-12-16
NWE,2019-12-15,34,Sun,14,15,@,CIN,W 34-13,34,13,21,47,NWE_CIN_2019-12-15
LAR,2019-12-01,34,Sun,12,13,@,ARI,W 34-7,34,7,27,41,LAR_ARI_2019-12-01
NYJ,2019-11-24,34,Sun,11,12,,OAK,W 34-3,34,3,31,37,NYJ_OAK_2019-11-24
NOR,2019-11-24,34,Sun,11,12,,CAR,W 34-31,34,31,3,65,NOR_CAR_2019-11-24
NOR,2019-11-17,34,Sun,10,11,@,TAM,W 34-17,34,17,17,51,NOR_TAM_2019-11-17
NYJ,2019-11-17,34,Sun,10,11,@,WAS,W 34-17,34,17,17,51,NYJ_WAS_2019-11-17
NYJ,2019-11-10,34,Sun,9,10,,NYG,W 34-27,34,27,7,61,NYJ_NYG_2019-11-10
TAM,2019-11-03,34,Sun,8,9,@,SEA,L 34-40 (OT),34,40,-6,74,TAM_SEA_2019-11-03
ARI,2019-10-13,34,Sun,6,6,,ATL,W 34-33,34,33,1,67,ARI_ATL_2019-10-13
CAR,2019-10-06,34,Sun,5,5,,JAX,W 34-27,34,27,7,61,CAR_JAX_2019-10-06
GNB,2019-10-06,34,Sun,5,5,@,DAL,W 34-24,34,24,10,58,GNB_DAL_2019-10-06
KAN,2019-09-29,34,Sun,4,4,@,DET,W 34-30,34,30,4,64,KAN_DET_2019-09-29
PHI,2019-09-26,34,Thu,4,4,@,GNB,W 34-27,34,27,7,61,PHI_GNB_2019-09-26
MIN,2019-09-22,34,Sun,3,3,,OAK,W 34-14,34,14,20,48,MIN_OAK_2019-09-22
ATL,2018-12-30,34,Sun,16,17,@,TAM,W 34-32,34,32,2,66,ATL_TAM_2018-12-30
MIA,2018-12-09,34,Sun,13,14,,NWE,W 34-33,34,33,1,67,MIA_NWE_2018-12-09
GNB,2018-12-09,34,Sun,13,14,,ATL,W 34-20,34,20,14,54,GNB_ATL_2018-12-09
HOU,2018-11-26,34,Mon,11,12,,TEN,W 34-17,34,17,17,51,HOU_TEN_2018-11-26
BAL,2018-11-25,34,Sun,11,12,,OAK,W 34-17,34,17,17,51,BAL_OAK_2018-11-25
TEN,2018-11-11,34,Sun,9,10,,NWE,W 34-10,34,10,24,44,TEN_NWE_2018-11-11
CHI,2018-11-11,34,Sun,9,10,,DET,W 34-22,34,22,12,56,CHI_DET_2018-11-11
SFO,2018-11-01,34,Thu,9,9,,OAK,W 34-3,34,3,31,37,SFO_OAK_2018-11-01
TAM,2018-10-28,34,Sun,7,8,@,CIN,L 34-37,34,37,-3,71,TAM_CIN_2018-10-28
IND,2018-10-14,34,Sun,6,6,@,NYJ,L 34-42,34,42,-8,76,IND_NYJ_2018-10-14
ATL,2018-10-14,34,Sun,6,6,,TAM,W 34-29,34,29,5,63,ATL_TAM_2018-10-14
PHI,2018-10-11,34,Thu,6,6,@,NYG,W 34-13,34,13,21,47,PHI_NYG_2018-10-11
NYJ,2018-10-07,34,Sun,5,5,,DEN,W 34-16,34,16,18,50,NYJ_DEN_2018-10-07
IND,2018-09-30,34,Sun,4,4,,HOU,L 34-37 (OT),34,37,-3,71,IND_HOU_2018-09-30
LAR,2018-09-16,34,Sun,2,2,,ARI,W 34-0,34,0,34,34,LAR_ARI_2018-09-16
CIN,2018-09-13,34,Thu,2,2,,BAL,W 34-23,34,23,11,57,CIN_BAL_2018-09-13
CIN,2018-09-09,34,Sun,1,1,@,IND,W 34-23,34,23,11,57,CIN_IND_2018-09-09
SFO,2017-12-31,34,Sun,16,17,@,LAR,W 34-13,34,13,21,47,SFO_LAR_2017-12-31
PIT,2017-12-25,34,Mon,15,16,@,HOU,W 34-6,34,6,28,40,PIT_HOU_2017-12-25
PHI,2017-12-17,34,Sun,14,15,@,NYG,W 34-29,34,29,5,63,PHI_NYG_2017-12-17
MIN,2017-12-17,34,Sun,14,15,,CIN,W 34-7,34,7,27,41,MIN_CIN_2017-12-17
ATL,2017-11-26,34,Sun,11,12,,TAM,W 34-20,34,20,14,54,ATL_TAM_2017-11-26
ATL,2017-11-20,34,Mon,10,11,@,SEA,W 34-31,34,31,3,65,ATL_SEA_2017-11-20
NOR,2017-11-19,34,Sun,10,11,,WAS,W 34-31 (OT),34,31,3,65,NOR_WAS_2017-11-19
NYJ,2017-11-02,34,Thu,9,9,,BUF,W 34-21,34,21,13,55,NYJ_BUF_2017-11-02
BUF,2017-10-29,34,Sun,7,8,,OAK,W 34-14,34,14,20,48,BUF_OAK_2017-10-29
PHI,2017-10-23,34,Mon,7,7,,WAS,W 34-24,34,24,10,58,PHI_WAS_2017-10-23
HOU,2017-10-08,34,Sun,5,5,,KAN,L 34-42,34,42,-8,76,HOU_KAN_2017-10-08
PHI,2017-10-08,34,Sun,5,5,,ARI,W 34-7,34,7,27,41,PHI_ARI_2017-10-08
NOR,2017-09-24,34,Sun,3,3,@,CAR,W 34-13,34,13,21,47,NOR_CAR_2017-09-24
MIN,2017-09-24,34,Sun,3,3,,TAM,W 34-17,34,17,17,51,MIN_TAM_2017-09-24
ATL,2017-09-17,34,Sun,2,2,,GNB,W 34-23,34,23,11,57,ATL_GNB_2017-09-17
SFO,2022-12-04,33,Sun,12,13,,MIA,W 33-17,33,17,16,50,SFO_MIA_2022-12-04
GNB,2022-11-27,33,Sun,12,12,@,PHI,L 33-40,33,40,-7,73,GNB_PHI_2022-11-27
MIN,2022-11-24,33,Thu,11,12,,NWE,W 33-26,33,26,7,59,MIN_NWE_2022-11-24
MIN,2022-11-13,33,Sun,9,10,@,BUF,W 33-30 (OT),33,30,3,63,MIN_BUF_2022-11-13
CHI,2022-10-24,33,Mon,7,7,@,NWE,W 33-14,33,14,19,47,CHI_NWE_2022-10-24
MIA,2022-01-09,33,Sun,17,18,,NWE,W 33-24,33,24,9,57,MIA_NWE_2022-01-09
BUF,2021-12-26,33,Sun,15,16,@,NWE,W 33-21,33,21,12,54,BUF_NWE_2021-12-26
TAM,2021-12-12,33,Sun,13,14,,BUF,W 33-27 (OT),33,27,6,60,TAM_BUF_2021-12-12
SEA,2021-12-12,33,Sun,13,14,@,HOU,W 33-13,33,13,20,46,SEA_HOU_2021-12-12
PHI,2021-12-05,33,Sun,13,13,@,NYJ,W 33-18,33,18,15,51,PHI_NYJ_2021-12-05
ARI,2021-12-05,33,Sun,12,13,@,CHI,W 33-22,33,22,11,55,ARI_CHI_2021-12-05
MIA,2021-11-28,33,Sun,12,12,,CAR,W 33-10,33,10,23,43,MIA_CAR_2021-11-28
DAL,2021-11-25,33,Thu,11,12,,LVR,L 33-36 (OT),33,36,-3,69,DAL_LVR_2021-11-25
SFO,2021-10-31,33,Sun,7,8,@,CHI,W 33-22,33,22,11,55,SFO_CHI_2021-10-31
LVR,2021-10-24,33,Sun,7,7,,PHI,W 33-22,33,22,11,55,LVR_PHI_2021-10-24
NOR,2021-10-10,33,Sun,5,5,@,WAS,W 33-22,33,22,11,55,NOR_WAS_2021-10-10
TEN,2021-09-19,33,Sun,2,2,@,SEA,W 33-30 (OT),33,30,3,63,TEN_SEA_2021-09-19
MIN,2021-09-19,33,Sun,2,2,@,ARI,L 33-34,33,34,-1,67,MIN_ARI_2021-09-19
LVR,2021-09-13,33,Mon,1,1,,BAL,W 33-27 (OT),33,27,6,60,LVR_BAL_2021-09-13
DET,2021-09-12,33,Sun,1,1,,SFO,L 33-41,33,41,-8,74,DET_SFO_2021-09-12
KAN,2021-09-12,33,Sun,1,1,,CLE,W 33-29,33,29,4,62,KAN_CLE_2021-09-12
NOR,2021-01-03,33,Sun,16,17,@,CAR,W 33-7,33,7,26,40,NOR_CAR_2021-01-03
MIN,2020-12-25,33,Fri,15,16,@,NOR,L 33-52,33,52,-19,85,MIN_NOR_2020-12-25
SFO,2020-12-20,33,Sun,14,15,@,DAL,L 33-41,33,41,-8,74,SFO_DAL_2020-12-20
CHI,2020-12-20,33,Sun,14,15,@,MIN,W 33-27,33,27,6,60,CHI_MIN_2020-12-20
ARI,2020-12-20,33,Sun,14,15,,PHI,W 33-26,33,26,7,59,ARI_PHI_2020-12-20
KAN,2020-12-13,33,Sun,13,14,@,MIA,W 33-27,33,27,6,60,KAN_MIA_2020-12-13
KAN,2020-11-08,33,Sun,9,9,,CAR,W 33-31,33,31,2,64,KAN_CAR_2020-11-08
SFO,2020-10-25,33,Sun,7,7,@,NWE,W 33-6,33,6,27,39,SFO_NWE_2020-10-25
CIN,2020-10-04,33,Sun,4,4,,JAX,W 33-25,33,25,8,58,CIN_JAX_2020-10-04
BAL,2020-09-20,33,Sun,2,2,@,HOU,W 33-16,33,16,17,49,BAL_HOU_2020-09-20
TEN,2020-09-20,33,Sun,2,2,,JAX,W 33-30,33,30,3,63,TEN_JAX_2020-09-20
CIN,2019-12-29,33,Sun,16,17,,CLE,W 33-23,33,23,10,56,CIN_CLE_2019-12-29
IND,2019-11-17,33,Sun,10,11,,JAX,W 33-13,33,13,20,46,IND_JAX_2019-11-17
NWE,2019-10-21,33,Mon,7,7,@,NYJ,W 33-0,33,0,33,33,NWE_NYJ_2019-10-21
ATL,2019-10-13,33,Sun,6,6,@,ARI,L 33-34,33,34,-1,67,ATL_ARI_2019-10-13
NWE,2019-10-06,33,Sun,5,5,@,WAS,W 33-7,33,7,26,40,NWE_WAS_2019-10-06
NOR,2019-09-22,33,Sun,3,3,@,SEA,W 33-27,33,27,6,60,NOR_SEA_2019-09-22
KAN,2019-09-22,33,Sun,3,3,,BAL,W 33-28,33,28,5,61,KAN_BAL_2019-09-22
NWE,2019-09-08,33,Sun,1,1,,PIT,W 33-3,33,3,30,36,NWE_PIT_2019-09-08
IND,2018-12-30,33,Sun,16,17,@,TEN,W 33-17,33,17,16,50,IND_TEN_2018-12-30
CAR,2018-12-30,33,Sun,16,17,@,NOR,W 33-14,33,14,19,47,CAR_NOR_2018-12-30
NWE,2018-12-09,33,Sun,13,14,@,MIA,L 33-34,33,34,-1,67,NWE_MIA_2018-12-09
LAC,2018-12-02,33,Sun,12,13,@,PIT,W 33-30,33,30,3,63,LAC_PIT_2018-12-02
OAK,2018-12-02,33,Sun,12,13,,KAN,L 33-40,33,40,-7,73,OAK_KAN_2018-12-02
PIT,2018-10-28,33,Sun,7,8,,CLE,W 33-18,33,18,15,51,PIT_CLE_2018-10-28
GNB,2018-10-15,33,Mon,6,6,,SFO,W 33-30,33,30,3,63,GNB_SFO_2018-10-15
CAR,2018-10-07,33,Sun,4,5,,NYG,W 33-31,33,31,2,64,CAR_NYG_2018-10-07
LAR,2018-10-07,33,Sun,5,5,@,SEA,W 33-31,33,31,2,64,LAR_SEA_2018-10-07
NOR,2018-09-30,33,Sun,4,4,@,NYG,W 33-18,33,18,15,51,NOR_NYG_2018-09-30
LAR,2018-09-10,33,Mon,1,1,@,OAK,W 33-13,33,13,20,46,LAR_OAK_2018-09-10
JAX,2017-12-24,33,Sun,15,16,@,SFO,L 33-44,33,44,-11,77,JAX_SFO_2017-12-24
CHI,2017-12-10,33,Sun,13,14,@,CIN,W 33-7,33,7,26,40,CHI_CIN_2017-12-10
NWE,2017-11-19,33,Sun,10,11,@,OAK,W 33-8,33,8,25,41,NWE_OAK_2017-11-19
LAR,2017-11-12,33,Sun,9,10,,HOU,W 33-7,33,7,26,40,LAR_HOU_2017-11-12
PHI,2017-10-29,33,Sun,8,8,,SFO,W 33-10,33,10,23,43,PHI_SFO_2017-10-29
DAL,2017-10-29,33,Sun,7,8,@,WAS,W 33-19,33,19,14,52,DAL_WAS_2017-10-29
MIN,2017-10-29,33,Sun,8,8,@,CLE,W 33-16,33,16,17,49,MIN_CLE_2017-10-29
LAR,2017-10-22,33,Sun,7,7,,ARI,W 33-0,33,0,33,33,LAR_ARI_2017-10-22
TAM,2017-10-15,33,Sun,5,6,@,ARI,L 33-38,33,38,-5,71,TAM_ARI_2017-10-15
HOU,2017-10-15,33,Sun,6,6,,CLE,W 33-17,33,17,16,50,HOU_CLE_2017-10-15
CAR,2017-10-01,33,Sun,4,4,@,NWE,W 33-30,33,30,3,63,CAR_NWE_2017-10-01
HOU,2017-09-24,33,Sun,3,3,@,NWE,L 33-36,33,36,-3,69,HOU_NWE_2017-09-24
TEN,2017-09-24,33,Sun,3,3,,SEA,W 33-27,33,27,6,60,TEN_SEA_2017-09-24
HOU,2023-01-08,32,Sun,17,18,@,IND,W 32-31,32,31,1,63,HOU_IND_2023-01-08
BUF,2022-12-17,32,Sat,14,15,,MIA,W 32-29,32,29,3,61,BUF_MIA_2022-12-17
WAS,2022-11-14,32,Mon,10,10,@,PHI,W 32-21,32,21,11,53,WAS_PHI_2022-11-14
CHI,2022-11-06,32,Sun,9,9,,MIA,L 32-35,32,35,-3,67,CHI_MIA_2022-11-06
CLE,2022-10-31,32,Mon,8,8,,CIN,W 32-13,32,13,19,45,CLE_CIN_2022-10-31
SEA,2022-10-09,32,Sun,5,5,@,NOR,L 32-39,32,39,-7,71,SEA_NOR_2022-10-09
LVR,2022-10-02,32,Sun,4,4,,DEN,W 32-23,32,23,9,55,LVR_DEN_2022-10-02
LAC,2022-01-09,32,Sun,17,18,@,LVR,L 32-35 (OT),32,35,-3,67,LAC_LVR_2022-01-09
TAM,2021-12-26,32,Sun,15,16,@,CAR,W 32-6,32,6,26,38,TAM_CAR_2021-12-26
CIN,2021-11-21,32,Sun,10,11,@,LVR,W 32-13,32,13,19,45,CIN_LVR_2021-11-21
PHI,2021-09-12,32,Sun,1,1,@,ATL,W 32-6,32,6,26,38,PHI_ATL_2021-09-12
LVR,2021-01-03,32,Sun,16,17,@,DEN,W 32-31,32,31,1,63,LVR_DEN_2021-01-03
KAN,2020-12-20,32,Sun,14,15,@,NOR,W 32-29,32,29,3,61,KAN_NOR_2020-12-20
DEN,2020-12-13,32,Sun,13,14,@,CAR,W 32-27,32,27,5,59,DEN_CAR_2020-12-13
ARI,2020-11-15,32,Sun,9,10,,BUF,W 32-30,32,30,2,62,ARI_BUF_2020-11-15
CLE,2020-10-11,32,Sun,5,5,,IND,W 32-23,32,23,9,55,CLE_IND_2020-10-11
KAN,2020-10-11,32,Sun,5,5,,LVR,L 32-40,32,40,-8,72,KAN_LVR_2020-10-11
LAR,2020-09-27,32,Sun,3,3,@,BUF,L 32-35,32,35,-3,67,LAR_BUF_2020-09-27
KAN,2019-11-10,32,Sun,10,10,@,TEN,L 32-35,32,35,-3,67,KAN_TEN_2019-11-10
SEA,2019-10-13,32,Sun,6,6,@,CLE,W 32-28,32,28,4,60,SEA_CLE_2019-10-13
ATL,2019-10-06,32,Sun,5,5,@,HOU,L 32-53,32,53,-21,85,ATL_HOU_2019-10-06
NYG,2019-09-22,32,Sun,3,3,@,TAM,W 32-31,32,31,1,63,NYG_TAM_2019-09-22
PHI,2019-09-08,32,Sun,1,1,,WAS,W 32-27,32,27,5,59,PHI_WAS_2019-09-08
SFO,2018-12-30,32,Sun,16,17,@,LAR,L 32-48,32,48,-16,80,SFO_LAR_2018-12-30
TAM,2018-12-30,32,Sun,16,17,,ATL,L 32-34,32,34,-2,66,TAM_ATL_2018-12-30
PHI,2018-12-23,32,Sun,15,16,,HOU,W 32-30,32,30,2,62,PHI_HOU_2018-12-23
DET,2018-10-21,32,Sun,6,7,@,MIA,W 32-21,32,21,11,53,DET_MIA_2018-10-21
LAR,2017-12-03,32,Sun,12,13,@,ARI,W 32-16,32,16,16,48,LAR_ARI_2017-12-03
IND,2023-01-08,31,Sun,17,18,,HOU,L 31-32,31,32,-1,63,IND_HOU_2023-01-08
DEN,2023-01-08,31,Sun,17,18,,LAC,W 31-28,31,28,3,59,DEN_LAC_2023-01-08
KAN,2023-01-07,31,Sat,17,18,@,LVR,W 31-13,31,13,18,44,KAN_LVR_2023-01-07
JAX,2023-01-01,31,Sun,16,17,@,HOU,W 31-3,31,3,28,34,JAX_HOU_2023-01-01
LAC,2023-01-01,31,Sun,16,17,,LAR,W 31-10,31,10,21,41,LAC_LAR_2023-01-01
NYJ,2022-11-27,31,Sun,11,12,,CHI,W 31-10,31,10,21,41,NYJ_CHI_2022-11-27
BUF,2022-11-20,31,Sun,10,11,,CLE,W 31-23,31,23,8,54,BUF_CLE_2022-11-20
DET,2022-11-20,31,Sun,10,11,@,NYG,W 31-18,31,18,13,49,DET_NYG_2022-11-20
GNB,2022-11-13,31,Sun,10,10,,DAL,W 31-28 (OT),31,28,3,59,GNB_DAL_2022-11-13
DET,2022-11-13,31,Sun,9,10,@,CHI,W 31-30,31,30,1,61,DET_CHI_2022-11-13
SEA,2022-11-06,31,Sun,9,9,@,ARI,W 31-21,31,21,10,52,SEA_ARI_2022-11-06
MIA,2022-10-30,31,Sun,8,8,@,DET,W 31-27,31,27,4,58,MIA_DET_2022-10-30
SFO,2022-10-30,31,Sun,8,8,@,LAR,W 31-14,31,14,17,45,SFO_LAR_2022-10-30
TAM,2022-10-02,31,Sun,4,4,,KAN,L 31-41,31,41,-10,72,TAM_KAN_2022-10-02
NYJ,2022-09-18,31,Sun,2,2,@,CLE,W 31-30,31,30,1,61,NYJ_CLE_2022-09-18
LAR,2022-09-18,31,Sun,2,2,,ATL,W 31-27,31,27,4,58,LAR_ATL_2022-09-18
BUF,2022-09-08,31,Thu,1,1,@,LAR,W 31-10,31,10,21,41,BUF_LAR_2022-09-08
MIN,2022-01-09,31,Sun,17,18,,CHI,W 31-17,31,17,14,48,MIN_CHI_2022-01-09
KAN,2022-01-02,31,Sun,16,17,@,CIN,L 31-34,31,34,-3,65,KAN_CIN_2022-01-02
GNB,2021-12-19,31,Sun,14,15,@,BAL,W 31-30,31,30,1,61,GNB_BAL_2021-12-19
MIA,2021-12-19,31,Sun,14,15,,NYJ,W 31-24,31,24,7,55,MIA_NYJ_2021-12-19
SFO,2021-12-19,31,Sun,14,15,,ATL,W 31-13,31,13,18,44,SFO_ATL_2021-12-19
BUF,2021-12-19,31,Sun,14,15,,CAR,W 31-14,31,14,17,45,BUF_CAR_2021-12-19
IND,2021-12-05,31,Sun,13,13,@,HOU,W 31-0,31,0,31,31,IND_HOU_2021-12-05
IND,2021-11-28,31,Sun,12,12,,TAM,L 31-38,31,38,-7,69,IND_TAM_2021-11-28
BUF,2021-11-25,31,Thu,11,12,@,NOR,W 31-6,31,6,25,37,BUF_NOR_2021-11-25
GNB,2021-11-21,31,Sun,11,11,@,MIN,L 31-34,31,34,-3,65,GNB_MIN_2021-11-21
SFO,2021-11-15,31,Mon,9,10,,LAR,W 31-10,31,10,21,41,SFO_LAR_2021-11-15
MIN,2021-11-07,31,Sun,8,9,@,BAL,L 31-34 (OT),31,34,-3,65,MIN_BAL_2021-11-07
ARI,2021-11-07,31,Sun,9,9,@,SFO,W 31-17,31,17,14,48,ARI_SFO_2021-11-07
SEA,2021-10-31,31,Sun,8,8,,JAX,W 31-7,31,7,24,38,SEA_JAX_2021-10-31
CIN,2021-10-31,31,Sun,8,8,@,NYJ,L 31-34,31,34,-3,65,CIN_NYJ_2021-10-31
IND,2021-10-31,31,Sun,8,8,,TEN,L 31-34 (OT),31,34,-3,65,IND_TEN_2021-10-31
ARI,2021-10-24,31,Sun,7,7,,HOU,W 31-5,31,5,26,36,ARI_HOU_2021-10-24
BUF,2021-10-18,31,Mon,6,6,@,TEN,L 31-34,31,34,-3,65,BUF_TEN_2021-10-18
IND,2021-10-17,31,Sun,6,6,,HOU,W 31-3,31,3,28,34,IND_HOU_2021-10-17
KAN,2021-10-17,31,Sun,6,6,@,WAS,W 31-13,31,13,18,44,KAN_WAS_2021-10-17
BAL,2021-10-11,31,Mon,5,5,,IND,W 31-25 (OT),31,25,6,56,BAL_IND_2021-10-11
ARI,2021-09-26,31,Sun,3,3,@,JAX,W 31-19,31,19,12,50,ARI_JAX_2021-09-26
LVR,2021-09-26,31,Sun,3,3,,MIA,W 31-28 (OT),31,28,3,59,LVR_MIA_2021-09-26
CLE,2021-09-19,31,Sun,2,2,,HOU,W 31-21,31,21,10,52,CLE_HOU_2021-09-19
TAM,2021-09-09,31,Thu,1,1,,DAL,W 31-29,31,29,2,60,TAM_DAL_2021-09-09
DEN,2021-01-03,31,Sun,16,17,,LVR,L 31-32,31,32,-1,63,DEN_LVR_2021-01-03
HOU,2020-12-27,31,Sun,15,16,,CIN,L 31-37,31,37,-6,68,HOU_CIN_2020-12-27
TAM,2020-12-20,31,Sun,14,15,@,ATL,W 31-27,31,27,4,58,TAM_ATL_2020-12-20
GNB,2020-12-13,31,Sun,13,14,@,DET,W 31-24,31,24,7,55,GNB_DET_2020-12-13
TEN,2020-12-13,31,Sun,13,14,@,JAX,W 31-10,31,10,21,41,TEN_JAX_2020-12-13
LVR,2020-12-06,31,Sun,12,13,@,NYJ,W 31-28,31,28,3,59,LVR_NYJ_2020-12-06
NOR,2020-11-29,31,Sun,11,12,@,DEN,W 31-3,31,3,28,34,NOR_DEN_2020-11-29
GNB,2020-11-22,31,Sun,10,11,@,IND,L 31-34 (OT),31,34,-3,65,GNB_IND_2020-11-22
LVR,2020-11-22,31,Sun,10,11,,KAN,L 31-35,31,35,-4,66,LVR_KAN_2020-11-22
DAL,2020-11-22,31,Sun,10,11,@,MIN,W 31-28,31,28,3,59,DAL_MIN_2020-11-22
CAR,2020-11-08,31,Sun,9,9,@,KAN,L 31-33,31,33,-2,64,CAR_KAN_2020-11-08
ARI,2020-11-08,31,Sun,8,9,,MIA,L 31-34,31,34,-3,65,ARI_MIA_2020-11-08
LVR,2020-11-08,31,Sun,8,9,@,LAC,W 31-26,31,26,5,57,LVR_LAC_2020-11-08
CIN,2020-11-01,31,Sun,8,8,,TEN,W 31-20,31,20,11,51,CIN_TEN_2020-11-01
DEN,2020-11-01,31,Sun,7,8,,LAC,W 31-30,31,30,1,61,DEN_LAC_2020-11-01
IND,2020-10-18,31,Sun,6,6,,CIN,W 31-27,31,27,4,58,IND_CIN_2020-10-18
CAR,2020-10-04,31,Sun,4,4,,ARI,W 31-21,31,21,10,52,CAR_ARI_2020-10-04
MIN,2020-10-04,31,Sun,4,4,@,HOU,W 31-23,31,23,8,54,MIN_HOU_2020-10-04
SEA,2020-10-04,31,Sun,4,4,@,MIA,W 31-23,31,23,8,54,SEA_MIA_2020-10-04
LAC,2020-10-04,31,Sun,4,4,@,TAM,L 31-38,31,38,-7,69,LAC_TAM_2020-10-04
BAL,2020-10-04,31,Sun,4,4,@,WAS,W 31-17,31,17,14,48,BAL_WAS_2020-10-04
TEN,2020-09-27,31,Sun,3,3,@,MIN,W 31-30,31,30,1,61,TEN_MIN_2020-09-27
DAL,2020-09-27,31,Sun,3,3,@,SEA,L 31-38,31,38,-7,69,DAL_SEA_2020-09-27
MIA,2020-09-24,31,Thu,3,3,@,JAX,W 31-13,31,13,18,44,MIA_JAX_2020-09-24
BUF,2020-09-20,31,Sun,2,2,@,MIA,W 31-28,31,28,3,59,BUF_MIA_2020-09-20
SFO,2020-09-20,31,Sun,2,2,@,NYJ,W 31-13,31,13,18,44,SFO_NYJ_2020-09-20
TAM,2020-09-20,31,Sun,2,2,,CAR,W 31-17,31,17,14,48,TAM_CAR_2020-09-20
KAN,2019-12-29,31,Sun,16,17,,LAC,W 31-21,31,21,10,52,KAN_LAC_2019-12-29
LAR,2019-12-29,31,Sun,16,17,,ARI,W 31-24,31,24,7,55,LAR_ARI_2019-12-29
BAL,2019-12-22,31,Sun,15,16,@,CLE,W 31-15,31,15,16,46,BAL_CLE_2019-12-22
LAR,2019-12-21,31,Sat,15,16,@,SFO,L 31-34,31,34,-3,65,LAR_SFO_2019-12-21
CHI,2019-12-05,31,Thu,13,14,,DAL,W 31-24,31,24,7,55,CHI_DAL_2019-12-05
GNB,2019-12-01,31,Sun,12,13,@,NYG,W 31-13,31,13,18,44,GNB_NYG_2019-12-01
PHI,2019-12-01,31,Sun,12,13,@,MIA,L 31-37,31,37,-6,68,PHI_MIA_2019-12-01
TEN,2019-12-01,31,Sun,12,13,@,IND,W 31-17,31,17,14,48,TEN_IND_2019-12-01
CAR,2019-11-24,31,Sun,11,12,@,NOR,L 31-34,31,34,-3,65,CAR_NOR_2019-11-24
OAK,2019-11-03,31,Sun,8,9,,DET,W 31-24,31,24,7,55,OAK_DET_2019-11-03
DET,2019-10-27,31,Sun,7,8,,NYG,W 31-26,31,26,5,57,DET_NYG_2019-10-27
GNB,2019-10-27,31,Sun,8,8,@,KAN,W 31-24,31,24,7,55,GNB_KAN_2019-10-27
NOR,2019-10-27,31,Sun,8,8,,ARI,W 31-9,31,9,22,40,NOR_ARI_2019-10-27
PHI,2019-10-27,31,Sun,8,8,@,BUF,W 31-13,31,13,18,44,PHI_BUF_2019-10-27
BUF,2019-10-20,31,Sun,6,7,,MIA,W 31-21,31,21,10,52,BUF_MIA_2019-10-20
HOU,2019-10-13,31,Sun,6,6,@,KAN,W 31-24,31,24,7,55,HOU_KAN_2019-10-13
SFO,2019-10-07,31,Mon,4,5,,CLE,W 31-3,31,3,28,34,SFO_CLE_2019-10-07
PHI,2019-10-06,31,Sun,5,5,,NYJ,W 31-6,31,6,25,37,PHI_NYJ_2019-10-06
NOR,2019-10-06,31,Sun,5,5,,TAM,W 31-24,31,24,7,55,NOR_TAM_2019-10-06
OAK,2019-09-29,31,Sun,4,4,@,IND,W 31-24,31,24,7,55,OAK_IND_2019-09-29
CHI,2019-09-23,31,Mon,3,3,@,WAS,W 31-15,31,15,16,46,CHI_WAS_2019-09-23
TAM,2019-09-22,31,Sun,3,3,,NYG,L 31-32,31,32,-1,63,TAM_NYG_2019-09-22
DAL,2019-09-22,31,Sun,3,3,,MIA,W 31-6,31,6,25,37,DAL_MIA_2019-09-22
DAL,2019-09-15,31,Sun,2,2,@,WAS,W 31-21,31,21,10,52,DAL_WAS_2019-09-15
SFO,2019-09-08,31,Sun,1,1,@,TAM,W 31-17,31,17,14,48,SFO_TAM_2019-09-08
DET,2018-12-30,31,Sun,16,17,@,GNB,W 31-0,31,0,31,31,DET_GNB_2018-12-30
NOR,2018-12-23,31,Sun,15,16,,PIT,W 31-28,31,28,3,59,NOR_PIT_2018-12-23
KAN,2018-12-23,31,Sun,15,16,@,SEA,L 31-38,31,38,-7,69,KAN_SEA_2018-12-23
LAR,2018-12-23,31,Sun,15,16,@,ARI,W 31-9,31,9,22,40,LAR_ARI_2018-12-23
DAL,2018-11-22,31,Thu,11,12,,WAS,W 31-23,31,23,8,54,DAL_WAS_2018-11-22
NOR,2018-11-22,31,Thu,11,12,,ATL,W 31-17,31,17,14,48,NOR_ATL_2018-11-22
GNB,2018-11-11,31,Sun,9,10,,MIA,W 31-12,31,12,19,43,GNB_MIA_2018-11-11
SEA,2018-11-11,31,Sun,9,10,@,LAR,L 31-36,31,36,-5,67,SEA_LAR_2018-11-11
NWE,2018-11-04,31,Sun,9,9,,GNB,W 31-17,31,17,14,48,NWE_GNB_2018-11-04
CHI,2018-10-21,31,Sun,6,7,,NWE,L 31-38,31,38,-7,69,CHI_NWE_2018-10-21
MIA,2018-10-14,31,Sun,6,6,,CHI,W 31-28 (OT),31,28,3,59,MIA_CHI_2018-10-14
SEA,2018-10-07,31,Sun,5,5,,LAR,L 31-33,31,33,-2,64,SEA_LAR_2018-10-07
DET,2018-10-07,31,Sun,5,5,,GNB,W 31-23,31,23,8,54,DET_GNB_2018-10-07
NYG,2018-10-07,31,Sun,5,5,@,CAR,L 31-33,31,33,-2,64,NYG_CAR_2018-10-07
JAX,2018-09-30,31,Sun,4,4,,NYJ,W 31-12,31,12,19,43,JAX_NYJ_2018-09-30
MIN,2018-09-27,31,Thu,4,4,@,LAR,L 31-38,31,38,-7,69,MIN_LAR_2018-09-27
WAS,2018-09-23,31,Sun,3,3,,GNB,W 31-17,31,17,14,48,WAS_GNB_2018-09-23
CAR,2018-09-23,31,Sun,3,3,,CIN,W 31-21,31,21,10,52,CAR_CIN_2018-09-23
JAX,2018-09-16,31,Sun,2,2,,NWE,W 31-20,31,20,11,51,JAX_NWE_2018-09-16
LAC,2018-09-16,31,Sun,2,2,@,BUF,W 31-20,31,20,11,51,LAC_BUF_2018-09-16
ATL,2018-09-16,31,Sun,2,2,,CAR,W 31-24,31,24,7,55,ATL_CAR_2018-09-16
TAM,2017-12-31,31,Sun,16,17,,NOR,W 31-24,31,24,7,55,TAM_NOR_2017-12-31
CIN,2017-12-31,31,Sun,16,17,@,BAL,W 31-27,31,27,4,58,CIN_BAL_2017-12-31
CAR,2017-12-17,31,Sun,14,15,,GNB,W 31-24,31,24,7,55,CAR_GNB_2017-12-17
NOR,2017-12-17,31,Sun,14,15,,NYJ,W 31-19,31,19,12,50,NOR_NYJ_2017-12-17
CAR,2017-12-10,31,Sun,13,14,,MIN,W 31-24,31,24,7,55,CAR_MIN_2017-12-10
KAN,2017-12-03,31,Sun,12,13,@,NYJ,L 31-38,31,38,-7,69,KAN_NYJ_2017-12-03
NOR,2017-12-03,31,Sun,12,13,,CAR,W 31-21,31,21,10,52,NOR_CAR_2017-12-03
PIT,2017-11-26,31,Sun,11,12,,GNB,W 31-28,31,28,3,59,PIT_GNB_2017-11-26
PHI,2017-11-26,31,Sun,11,12,,CHI,W 31-3,31,3,28,34,PHI_CHI_2017-11-26
SEA,2017-11-20,31,Mon,10,11,,ATL,L 31-34,31,34,-3,65,SEA_ATL_2017-11-20
WAS,2017-11-19,31,Sun,10,11,@,NOR,L 31-34 (OT),31,34,-3,65,WAS_NOR_2017-11-19
HOU,2017-11-19,31,Sun,10,11,,ARI,W 31-21,31,21,10,52,HOU_ARI_2017-11-19
SFO,2017-11-12,31,Sun,10,10,,NYG,W 31-21,31,21,10,52,SFO_NYG_2017-11-12
MIA,2017-10-22,31,Sun,6,7,,NYJ,W 31-28,31,28,3,59,MIA_NYJ_2017-10-22
OAK,2017-10-19,31,Thu,7,7,,KAN,W 31-30,31,30,1,61,OAK_KAN_2017-10-19
DAL,2017-10-08,31,Sun,5,5,,GNB,L 31-35,31,35,-4,66,DAL_GNB_2017-10-08
CIN,2017-10-01,31,Sun,4,4,@,CLE,W 31-7,31,7,24,38,CIN_CLE_2017-10-01
IND,2017-09-24,31,Sun,3,3,,CLE,W 31-28,31,28,3,59,IND_CLE_2017-09-24
ATL,2023-01-08,30,Sun,17,18,,TAM,W 30-17,30,17,13,47,ATL_TAM_2023-01-08
TAM,2023-01-01,30,Sun,16,17,,CAR,W 30-24,30,24,6,54,TAM_CAR_2023-01-01
KAN,2022-12-18,30,Sun,14,15,@,HOU,W 30-24 (OT),30,24,6,54,KAN_HOU_2022-12-18
LVR,2022-12-18,30,Sun,14,15,,NWE,W 30-24,30,24,6,54,LVR_NWE_2022-12-18
CAR,2022-12-11,30,Sun,13,14,@,SEA,W 30-24,30,24,6,54,CAR_SEA_2022-12-11
MIA,2022-11-27,30,Sun,11,12,,HOU,W 30-15,30,15,15,45,MIA_HOU_2022-11-27
PIT,2022-11-20,30,Sun,10,11,,CIN,L 30-37,30,37,-7,67,PIT_CIN_2022-11-20
KAN,2022-11-20,30,Sun,10,11,@,LAC,W 30-27,30,27,3,57,KAN_LAC_2022-11-20
CHI,2022-11-13,30,Sun,10,10,,DET,L 30-31,30,31,-1,61,CHI_DET_2022-11-13
BUF,2022-11-13,30,Sun,9,10,,MIN,L 30-33 (OT),30,33,-3,63,BUF_MIN_2022-11-13
CIN,2022-10-16,30,Sun,6,6,@,NOR,W 30-26,30,26,4,56,CIN_NOR_2022-10-16
KAN,2022-10-10,30,Mon,5,5,,LVR,W 30-29,30,29,1,59,KAN_LVR_2022-10-10
LAC,2022-10-09,30,Sun,5,5,@,CLE,W 30-28,30,28,2,58,LAC_CLE_2022-10-09
CLE,2022-09-18,30,Sun,2,2,,NYJ,L 30-31,30,31,-1,61,CLE_NYJ_2022-09-18
NOR,2022-01-09,30,Sun,17,18,@,ATL,W 30-20,30,20,10,50,NOR_ATL_2022-01-09
GNB,2022-01-09,30,Sun,17,18,@,DET,L 30-37,30,37,-7,67,GNB_DET_2022-01-09
ARI,2022-01-09,30,Sun,17,18,,SEA,L 30-38,30,38,-8,68,ARI_SEA_2022-01-09
LAR,2021-12-26,30,Sun,15,16,@,MIN,W 30-23,30,23,7,53,LAR_MIN_2021-12-26
DET,2021-12-19,30,Sun,14,15,,ARI,W 30-12,30,12,18,42,DET_ARI_2021-12-19
BAL,2021-12-19,30,Sun,14,15,,GNB,L 30-31,30,31,-1,61,BAL_GNB_2021-12-19
HOU,2021-12-19,30,Sun,14,15,@,JAX,W 30-16,30,16,14,46,HOU_JAX_2021-12-19
LAR,2021-12-13,30,Mon,13,14,@,ARI,W 30-23,30,23,7,53,LAR_ARI_2021-12-13
CHI,2021-12-12,30,Sun,13,14,@,GNB,L 30-45,30,45,-15,75,CHI_GNB_2021-12-12
NOR,2021-12-12,30,Sun,13,14,@,NYJ,W 30-9,30,9,21,39,NOR_NYJ_2021-12-12
TAM,2021-12-05,30,Sun,12,13,@,ATL,W 30-17,30,17,13,47,TAM_ATL_2021-12-05
SEA,2021-12-05,30,Sun,12,13,,SFO,W 30-23,30,23,7,53,SEA_SFO_2021-12-05
TAM,2021-11-22,30,Mon,10,11,,NYG,W 30-10,30,10,20,40,TAM_NYG_2021-11-22
SFO,2021-11-21,30,Sun,10,11,@,JAX,W 30-10,30,10,20,40,SFO_JAX_2021-11-21
PHI,2021-11-14,30,Sun,10,10,@,DEN,W 30-13,30,13,17,43,PHI_DEN_2021-11-14
DEN,2021-11-07,30,Sun,9,9,@,DAL,W 30-16,30,16,14,46,DEN_DAL_2021-11-07
NYJ,2021-11-04,30,Thu,8,9,@,IND,L 30-45,30,45,-15,75,NYJ_IND_2021-11-04
ATL,2021-10-24,30,Sun,6,7,@,MIA,W 30-28,30,28,2,58,ATL_MIA_2021-10-24
IND,2021-10-24,30,Sun,7,7,@,SFO,W 30-18,30,18,12,48,IND_SFO_2021-10-24
PHI,2021-10-03,30,Sun,4,4,,KAN,L 30-42,30,42,-12,72,PHI_KAN_2021-10-03
ATL,2021-10-03,30,Sun,4,4,,WAS,L 30-34,30,34,-4,64,ATL_WAS_2021-10-03
LAC,2021-09-26,30,Sun,3,3,@,KAN,W 30-24,30,24,6,54,LAC_KAN_2021-09-26
MIN,2021-09-26,30,Sun,3,3,,SEA,W 30-17,30,17,13,47,MIN_SEA_2021-09-26
GNB,2021-09-26,30,Sun,3,3,@,SFO,W 30-28,30,28,2,58,GNB_SFO_2021-09-26
SEA,2021-09-19,30,Sun,2,2,,TEN,L 30-33 (OT),30,33,-3,63,SEA_TEN_2021-09-19
WAS,2021-09-16,30,Thu,2,2,,NYG,W 30-29,30,29,1,59,WAS_NYG_2021-09-16
LAC,2020-12-17,30,Thu,14,15,@,LVR,W 30-27 (OT),30,27,3,57,LAC_LVR_2020-12-17
DAL,2020-12-13,30,Sun,13,14,@,CIN,W 30-7,30,7,23,37,DAL_CIN_2020-12-13
CHI,2020-12-06,30,Sun,12,13,,DET,L 30-34,30,34,-4,64,CHI_DET_2020-12-06
GNB,2020-12-06,30,Sun,12,13,,PHI,W 30-16,30,16,14,46,GNB_PHI_2020-12-06
TEN,2020-11-22,30,Sun,10,11,@,BAL,W 30-24 (OT),30,24,6,54,TEN_BAL_2020-11-22
BUF,2020-11-15,30,Sun,10,10,@,ARI,L 30-32,30,32,-2,62,BUF_ARI_2020-11-15
DET,2020-11-15,30,Sun,9,10,,WAS,W 30-27,30,27,3,57,DET_WAS_2020-11-15
NWE,2020-11-09,30,Mon,8,9,@,NYJ,W 30-27,30,27,3,57,NWE_NYJ_2020-11-09
LAC,2020-11-01,30,Sun,7,8,@,DEN,L 30-31,30,31,-1,61,LAC_DEN_2020-11-01
BAL,2020-10-18,30,Sun,6,6,@,PHI,W 30-28,30,28,2,58,BAL_PHI_2020-10-18
NOR,2020-10-12,30,Mon,5,5,,LAC,W 30-27 (OT),30,27,3,57,NOR_LAC_2020-10-12
HOU,2020-10-11,30,Sun,5,5,,JAX,W 30-14,30,14,16,44,HOU_JAX_2020-10-11
ARI,2020-10-11,30,Sun,5,5,@,NYJ,W 30-10,30,10,20,40,ARI_NYJ_2020-10-11
LAR,2020-10-11,30,Sun,5,5,@,WAS,W 30-10,30,10,20,40,LAR_WAS_2020-10-11
GNB,2020-10-05,30,Mon,4,4,,ATL,W 30-16,30,16,14,46,GNB_ATL_2020-10-05
BUF,2020-10-04,30,Sun,4,4,@,LVR,W 30-23,30,23,7,53,BUF_LVR_2020-10-04
NOR,2020-09-27,30,Sun,3,3,,GNB,L 30-37,30,37,-7,67,NOR_GNB_2020-09-27
MIN,2020-09-27,30,Sun,3,3,,TEN,L 30-31,30,31,-1,61,MIN_TEN_2020-09-27
CHI,2020-09-27,30,Sun,3,3,@,ATL,W 30-26,30,26,4,56,CHI_ATL_2020-09-27
JAX,2020-09-20,30,Sun,2,2,@,TEN,L 30-33,30,33,-3,63,JAX_TEN_2020-09-20
NWE,2020-09-20,30,Sun,2,2,@,SEA,L 30-35,30,35,-5,65,NWE_SEA_2020-09-20
ARI,2020-09-20,30,Sun,2,2,,WAS,W 30-15,30,15,15,45,ARI_WAS_2020-09-20
CIN,2020-09-17,30,Thu,2,2,@,CLE,L 30-35,30,35,-5,65,CIN_CLE_2020-09-17
CAR,2020-09-13,30,Sun,1,1,,LVR,L 30-34,30,34,-4,64,CAR_LVR_2020-09-13
SEA,2019-12-15,30,Sun,14,15,@,CAR,W 30-24,30,24,6,54,SEA_CAR_2019-12-15
MIN,2019-12-02,30,Mon,12,13,@,SEA,L 30-37,30,37,-7,67,MIN_SEA_2019-12-02
TAM,2019-11-10,30,Sun,9,10,,ARI,W 30-27,30,27,3,57,TAM_ARI_2019-11-10
CAR,2019-11-03,30,Sun,8,9,,TEN,W 30-20,30,20,10,50,CAR_TEN_2019-11-03
BAL,2019-10-20,30,Sun,7,7,@,SEA,W 30-16,30,16,14,46,BAL_SEA_2019-10-20
DET,2019-10-20,30,Sun,6,7,,MIN,L 30-42,30,42,-12,72,DET_MIN_2019-10-20
IND,2019-10-20,30,Sun,6,7,,HOU,W 30-23,30,23,7,53,IND_HOU_2019-10-20
KAN,2019-10-17,30,Thu,7,7,@,DEN,W 30-6,30,6,24,36,KAN_DEN_2019-10-17
SEA,2019-10-03,30,Thu,5,5,,LAR,W 30-29,30,29,1,59,SEA_LAR_2019-10-03
LAC,2019-09-29,30,Sun,4,4,@,MIA,W 30-10,30,10,20,40,LAC_MIA_2019-09-29
DET,2019-09-29,30,Sun,4,4,,KAN,L 30-34,30,34,-4,64,DET_KAN_2019-09-29
NWE,2019-09-22,30,Sun,3,3,,NYJ,W 30-14,30,14,16,44,NWE_NYJ_2019-09-22
NOR,2019-09-09,30,Mon,1,1,,HOU,W 30-28,30,28,2,58,NOR_HOU_2019-09-09
LAC,2019-09-08,30,Sun,1,1,,IND,W 30-24 (OT),30,24,6,54,LAC_IND_2019-09-08
LAR,2019-09-08,30,Sun,1,1,@,CAR,W 30-27,30,27,3,57,LAR_CAR_2019-09-08
HOU,2018-12-23,30,Sun,15,16,@,PHI,L 30-32,30,32,-2,62,HOU_PHI_2018-12-23
CIN,2018-12-16,30,Sun,14,15,,OAK,W 30-16,30,16,14,46,CIN_OAK_2018-12-16
PHI,2018-12-16,30,Sun,14,15,@,LAR,W 30-23,30,23,7,53,PHI_LAR_2018-12-16
TEN,2018-12-06,30,Thu,13,14,,JAX,W 30-9,30,9,21,39,TEN_JAX_2018-12-06
PIT,2018-12-02,30,Sun,12,13,,LAC,L 30-33,30,33,-3,63,PIT_LAC_2018-12-02
LAR,2018-12-02,30,Sun,12,13,@,DET,W 30-16,30,16,14,46,LAR_DET_2018-12-02
NYG,2018-12-02,30,Sun,12,13,,CHI,W 30-27 (OT),30,27,3,57,NYG_CHI_2018-12-02
SEA,2018-11-25,30,Sun,11,12,@,CAR,W 30-27,30,27,3,57,SEA_CAR_2018-11-25
NOR,2018-10-28,30,Sun,7,8,@,MIN,W 30-20,30,20,10,50,NOR_MIN_2018-10-28
KAN,2018-10-28,30,Sun,8,8,,DEN,W 30-23,30,23,7,53,KAN_DEN_2018-10-28
SFO,2018-10-15,30,Mon,6,6,@,GNB,L 30-33,30,33,-3,63,SFO_GNB_2018-10-15
KAN,2018-10-07,30,Sun,5,5,,JAX,W 30-14,30,14,16,44,KAN_JAX_2018-10-07
PIT,2018-09-24,30,Mon,3,3,@,TAM,W 30-27,30,27,3,57,PIT_TAM_2018-09-24
SFO,2018-09-16,30,Sun,2,2,,DET,W 30-27,30,27,3,57,SFO_DET_2018-09-16
LAC,2017-12-31,30,Sun,16,17,,OAK,W 30-10,30,10,20,40,LAC_OAK_2017-12-31
KAN,2017-12-16,30,Sat,14,15,,LAC,W 30-13,30,13,17,43,KAN_LAC_2017-12-16
JAX,2017-12-10,30,Sun,13,14,,SEA,W 30-24,30,24,6,54,JAX_SEA_2017-12-10
DAL,2017-12-10,30,Sun,13,14,@,NYG,W 30-10,30,10,20,40,DAL_NYG_2017-12-10
LAC,2017-12-10,30,Sun,13,14,,WAS,W 30-13,30,13,17,43,LAC_WAS_2017-12-10
JAX,2017-12-03,30,Sun,12,13,,IND,W 30-10,30,10,20,40,JAX_IND_2017-12-03
CIN,2017-11-26,30,Sun,11,12,,CLE,W 30-16,30,16,14,46,CIN_CLE_2017-11-26
MIN,2017-11-23,30,Thu,11,12,@,DET,W 30-23,30,23,7,53,MIN_DET_2017-11-23
TAM,2017-11-19,30,Sun,10,11,@,MIA,W 30-20,30,20,10,50,TAM_MIA_2017-11-19
WAS,2017-11-12,30,Sun,9,10,,MIN,L 30-38,30,38,-8,68,WAS_MIN_2017-11-12
DET,2017-11-06,30,Mon,8,9,@,GNB,W 30-17,30,17,13,47,DET_GNB_2017-11-06
NOR,2017-11-05,30,Sun,8,9,,TAM,W 30-10,30,10,20,40,NOR_TAM_2017-11-05
BUF,2017-10-22,30,Sun,6,7,,TAM,W 30-27,30,27,3,57,BUF_TAM_2017-10-22
KAN,2017-10-19,30,Thu,7,7,@,OAK,L 30-31,30,31,-1,61,KAN_OAK_2017-10-19
JAX,2017-10-08,30,Sun,5,5,@,PIT,W 30-9,30,9,21,39,JAX_PIT_2017-10-08
BAL,2017-10-08,30,Sun,5,5,@,OAK,W 30-17,30,17,13,47,BAL_OAK_2017-10-08
DAL,2017-10-01,30,Sun,4,4,,LAR,L 30-35,30,35,-5,65,DAL_LAR_2017-10-01
NWE,2017-10-01,30,Sun,4,4,,CAR,L 30-33,30,33,-3,63,NWE_CAR_2017-10-01
ATL,2017-09-24,30,Sun,3,3,@,DET,W 30-26,30,26,4,56,ATL_DET_2017-09-24
PHI,2017-09-10,30,Sun,1,1,@,WAS,W 30-17,30,17,13,47,PHI_WAS_2017-09-10
MIN,2023-01-08,29,Sun,17,18,@,CHI,W 29-13,29,13,16,42,MIN_CHI_2023-01-08
MIA,2022-12-17,29,Sat,14,15,@,BUF,L 29-32,29,32,-3,61,MIA_BUF_2022-12-17
PHI,2022-11-03,29,Thu,8,9,@,HOU,W 29-17,29,17,12,46,PHI_HOU_2022-11-03
CHI,2022-10-30,29,Sun,8,8,@,DAL,L 29-49,29,49,-20,78,CHI_DAL_2022-10-30
LVR,2022-10-10,29,Mon,5,5,@,KAN,L 29-30,29,30,-1,59,LVR_KAN_2022-10-10
MIN,2022-10-09,29,Sun,5,5,,CHI,W 29-22,29,22,7,51,MIN_CHI_2022-10-09
NWE,2022-10-09,29,Sun,5,5,,DET,W 29-0,29,0,29,29,NWE_DET_2022-10-09
PHI,2022-10-02,29,Sun,4,4,,JAX,W 29-21,29,21,8,50,PHI_JAX_2022-10-02
CLE,2022-09-22,29,Thu,3,3,,PIT,W 29-17,29,17,12,46,CLE_PIT_2022-09-22
ARI,2022-09-18,29,Sun,2,2,@,LVR,W 29-23 (OT),29,23,6,52,ARI_LVR_2022-09-18
DET,2022-01-02,29,Sun,16,17,@,SEA,L 29-51,29,51,-22,80,DET_SEA_2022-01-02
BUF,2022-01-02,29,Sun,16,17,,ATL,W 29-15,29,15,14,44,BUF_ATL_2022-01-02
CHI,2022-01-02,29,Sun,16,17,,NYG,W 29-3,29,3,26,32,CHI_NYG_2022-01-02
LAC,2021-12-26,29,Sun,15,16,@,HOU,L 29-41,29,41,-12,70,LAC_HOU_2021-12-26
ATL,2021-12-12,29,Sun,13,14,@,CAR,W 29-21,29,21,8,50,ATL_CAR_2021-12-12
DET,2021-12-05,29,Sun,12,13,,MIN,W 29-27,29,27,2,56,DET_MIN_2021-12-05
NOR,2021-11-21,29,Sun,10,11,@,PHI,L 29-40,29,40,-11,69,NOR_PHI_2021-11-21
WAS,2021-11-14,29,Sun,9,10,,TAM,W 29-19,29,19,10,48,WAS_TAM_2021-11-14
PIT,2021-11-08,29,Mon,8,9,,CHI,W 29-27,29,27,2,56,PIT_CHI_2021-11-08
NWE,2021-10-17,29,Sun,6,6,,DAL,L 29-35 (OT),29,35,-6,64,NWE_DAL_2021-10-17
NYG,2021-09-16,29,Thu,2,2,@,WAS,L 29-30,29,30,-1,59,NYG_WAS_2021-09-16
CLE,2021-09-12,29,Sun,1,1,@,KAN,L 29-33,29,33,-4,62,CLE_KAN_2021-09-12
DAL,2021-09-09,29,Thu,1,1,@,TAM,L 29-31,29,31,-2,60,DAL_TAM_2021-09-09
NOR,2020-12-20,29,Sun,14,15,,KAN,L 29-32,29,32,-3,61,NOR_KAN_2020-12-20
MIA,2020-11-15,29,Sun,9,10,,LAC,W 29-21,29,21,8,50,MIA_LAC_2020-11-15
JAX,2020-10-25,29,Sun,7,7,@,LAC,L 29-39,29,39,-10,68,JAX_LAC_2020-10-25
PHI,2020-10-11,29,Sun,5,5,@,PIT,L 29-38,29,38,-9,67,PHI_PIT_2020-10-11
DET,2020-10-04,29,Sun,4,4,,NOR,L 29-35,29,35,-6,64,DET_NOR_2020-10-04
ATL,2019-12-15,29,Sun,14,15,@,SFO,W 29-22,29,22,7,51,ATL_SFO_2019-12-15
WAS,2019-12-01,29,Sun,12,13,@,CAR,W 29-21,29,21,8,50,WAS_CAR_2019-12-01
ATL,2019-11-17,29,Sun,10,11,@,CAR,W 29-3,29,3,26,32,ATL_CAR_2019-11-17
JAX,2019-10-27,29,Sun,8,8,,NYJ,W 29-15,29,15,14,44,JAX_NYJ_2019-10-27
LAR,2019-10-03,29,Thu,5,5,@,SEA,L 29-30,29,30,-1,59,LAR_SEA_2019-10-03
HOU,2018-12-15,29,Sat,14,15,@,NYJ,W 29-22,29,22,7,51,HOU_NYJ_2018-12-15
LAC,2018-12-13,29,Thu,14,15,@,KAN,W 29-28,29,28,1,57,LAC_KAN_2018-12-13
DAL,2018-12-09,29,Sun,13,14,,PHI,W 29-23 (OT),29,23,6,52,DAL_PHI_2018-12-09
HOU,2018-12-02,29,Sun,12,13,,CLE,W 29-13,29,13,16,42,HOU_CLE_2018-12-02
IND,2018-11-11,29,Sun,9,10,,JAX,W 29-26,29,26,3,55,IND_JAX_2018-11-11
LAR,2018-10-28,29,Sun,8,8,,GNB,W 29-27,29,27,2,56,LAR_GNB_2018-10-28
TAM,2018-10-14,29,Sun,5,6,@,ATL,L 29-34,29,34,-5,63,TAM_ATL_2018-10-14
LAC,2018-09-30,29,Sun,4,4,,SFO,W 29-27,29,27,2,56,LAC_SFO_2018-09-30
GNB,2018-09-16,29,Sun,2,2,,MIN,T 29-29 (OT),29,29,0,58,GNB_MIN_2018-09-16
MIN,2018-09-16,29,Sun,2,2,@,GNB,T 29-29 (OT),29,29,0,58,MIN_GNB_2018-09-16
KAN,2017-12-24,29,Sun,15,16,,MIA,W 29-13,29,13,16,42,KAN_MIA_2017-12-24
NYG,2017-12-17,29,Sun,14,15,,PHI,L 29-34,29,34,-5,63,NYG_PHI_2017-12-17
KAN,2017-10-30,29,Mon,8,8,,DEN,W 29-19,29,19,10,48,KAN_DEN_2017-10-30
PIT,2017-10-22,29,Sun,7,7,,CIN,W 29-14,29,14,15,43,PIT_CIN_2017-10-22
KAN,2017-10-02,29,Mon,4,4,,WAS,W 29-20,29,20,9,49,KAN_WAS_2017-10-02
TAM,2017-09-17,29,Sun,1,2,,CHI,W 29-7,29,7,22,36,TAM_CHI_2017-09-17
MIN,2017-09-11,29,Mon,1,1,,NOR,W 29-19,29,19,10,48,MIN_NOR_2017-09-11
JAX,2017-09-10,29,Sun,1,1,@,HOU,W 29-7,29,7,22,36,JAX_HOU_2017-09-10
LAC,2023-01-08,28,Sun,17,18,@,DEN,L 28-31,28,31,-3,59,LAC_DEN_2023-01-08
PIT,2023-01-08,28,Sun,17,18,,CLE,W 28-14,28,14,14,42,PIT_CLE_2023-01-08
DEN,2022-12-11,28,Sun,13,14,,KAN,L 28-34,28,34,-6,62,DEN_KAN_2022-12-11
GNB,2022-12-04,28,Sun,13,13,@,CHI,W 28-19,28,19,9,47,GNB_CHI_2022-12-04
JAX,2022-11-27,28,Sun,11,12,,BAL,W 28-27,28,27,1,55,JAX_BAL_2022-11-27
DAL,2022-11-24,28,Thu,11,12,,NYG,W 28-20,28,20,8,48,DAL_NYG_2022-11-24
BUF,2022-11-24,28,Thu,11,12,@,DET,W 28-25,28,25,3,53,BUF_DET_2022-11-24
DAL,2022-11-13,28,Sun,9,10,@,GNB,L 28-31 (OT),28,31,-3,59,DAL_GNB_2022-11-13
ATL,2022-10-16,28,Sun,6,6,,SFO,W 28-14,28,14,14,42,ATL_SFO_2022-10-16
CLE,2022-10-09,28,Sun,5,5,,LAC,L 28-30,28,30,-2,58,CLE_LAC_2022-10-09
MIN,2022-10-02,28,Sun,4,4,@,NOR,W 28-25,28,25,3,53,MIN_NOR_2022-10-02
MIN,2022-09-25,28,Sun,3,3,,DET,W 28-24,28,24,4,52,MIN_DET_2022-09-25
WAS,2022-09-11,28,Sun,1,1,,JAX,W 28-22,28,22,6,50,WAS_JAX_2022-09-11
TEN,2022-01-09,28,Sun,17,18,@,HOU,W 28-25,28,25,3,53,TEN_HOU_2022-01-09
KAN,2022-01-08,28,Sat,17,18,@,DEN,W 28-24,28,24,4,52,KAN_DEN_2022-01-08
TAM,2022-01-02,28,Sun,16,17,@,NYJ,W 28-24,28,24,4,52,TAM_NYJ_2022-01-02
LAC,2021-12-16,28,Thu,14,15,,KAN,L 28-34 (OT),28,34,-6,62,LAC_KAN_2021-12-16
PIT,2021-12-09,28,Thu,13,14,@,MIN,L 28-36,28,36,-8,64,PIT_MIN_2021-12-09
DEN,2021-11-28,28,Sun,11,12,,LAC,W 28-13,28,13,15,41,DEN_LAC_2021-11-28
LAR,2021-11-28,28,Sun,11,12,@,GNB,L 28-36,28,36,-8,64,LAR_GNB_2021-11-28
TEN,2021-11-07,28,Sun,9,9,@,LAR,W 28-16,28,16,12,44,TEN_LAR_2021-11-07
LAR,2021-10-24,28,Sun,7,7,,DET,W 28-19,28,19,9,47,LAR_DET_2021-10-24
MIA,2021-10-24,28,Sun,7,7,,ATL,L 28-30,28,30,-2,58,MIA_ATL_2021-10-24
CAR,2021-10-17,28,Sun,6,6,,MIN,L 28-34 (OT),28,34,-6,62,CAR_MIN_2021-10-17
TAM,2021-10-14,28,Thu,6,6,@,PHI,W 28-22,28,22,6,50,TAM_PHI_2021-10-14
LAC,2021-10-04,28,Mon,4,4,,LVR,W 28-14,28,14,14,42,LAC_LVR_2021-10-04
SEA,2021-10-03,28,Sun,4,4,@,SFO,W 28-21,28,21,7,49,SEA_SFO_2021-10-03
CAR,2021-10-03,28,Sun,4,4,@,DAL,L 28-36,28,36,-8,64,CAR_DAL_2021-10-03
MIA,2021-09-26,28,Sun,3,3,@,LVR,L 28-31 (OT),28,31,-3,59,MIA_LVR_2021-09-26
SFO,2021-09-26,28,Sun,3,3,,GNB,L 28-30,28,30,-2,58,SFO_GNB_2021-09-26
NOR,2021-09-26,28,Sun,3,3,@,NWE,W 28-13,28,13,15,41,NOR_NWE_2021-09-26
SEA,2021-09-12,28,Sun,1,1,@,IND,W 28-16,28,16,12,44,SEA_IND_2021-09-12
IND,2021-01-03,28,Sun,16,17,,JAX,W 28-14,28,14,14,42,IND_JAX_2021-01-03
NWE,2021-01-03,28,Sun,16,17,,NYJ,W 28-14,28,14,14,42,NWE_NYJ_2021-01-03
PIT,2020-12-27,28,Sun,15,16,,IND,W 28-24,28,24,4,52,PIT_IND_2020-12-27
NYJ,2020-12-06,28,Sun,12,13,,LVR,L 28-31,28,31,-3,59,NYJ_LVR_2020-12-06
ARI,2020-12-06,28,Sun,12,13,,LAR,L 28-38,28,38,-10,66,ARI_LAR_2020-12-06
MIN,2020-11-29,28,Sun,11,12,,CAR,W 28-27,28,27,1,55,MIN_CAR_2020-11-29
MIN,2020-11-22,28,Sun,10,11,,DAL,L 28-31,28,31,-3,59,MIN_DAL_2020-11-22
NYJ,2020-11-22,28,Sun,10,11,@,LAC,L 28-34,28,34,-6,62,NYJ_LAC_2020-11-22
SEA,2020-11-19,28,Thu,10,11,,ARI,W 28-21,28,21,7,49,SEA_ARI_2020-11-19
PIT,2020-11-01,28,Sun,7,8,@,BAL,W 28-24,28,24,4,52,PIT_BAL_2020-11-01
MIN,2020-11-01,28,Sun,7,8,@,GNB,W 28-22,28,22,6,50,MIN_GNB_2020-11-01
MIA,2020-11-01,28,Sun,7,8,,LAR,W 28-17,28,17,11,45,MIA_LAR_2020-11-01
PHI,2020-10-18,28,Sun,6,6,,BAL,L 28-30,28,30,-2,58,PHI_BAL_2020-10-18
NYJ,2020-10-01,28,Thu,4,4,,DEN,L 28-37,28,37,-9,65,NYJ_DEN_2020-10-01
PIT,2020-09-27,28,Sun,3,3,,HOU,W 28-21,28,21,7,49,PIT_HOU_2020-09-27
TAM,2020-09-27,28,Sun,3,3,@,DEN,W 28-10,28,10,18,38,TAM_DEN_2020-09-27
IND,2020-09-20,28,Sun,2,2,,MIN,W 28-11,28,11,17,39,IND_MIN_2020-09-20
MIA,2020-09-20,28,Sun,2,2,,BUF,L 28-31,28,31,-3,59,MIA_BUF_2020-09-20
ATL,2019-12-29,28,Sun,16,17,@,TAM,W 28-22 (OT),28,22,6,50,ATL_TAM_2019-12-29
BAL,2019-12-29,28,Sun,16,17,,PIT,W 28-10,28,10,18,38,BAL_PIT_2019-12-29
TEN,2019-12-22,28,Sun,15,16,,NOR,L 28-38,28,38,-10,66,TEN_NOR_2019-12-22
LAR,2019-12-08,28,Sun,13,14,,SEA,W 28-12,28,12,16,40,LAR_SEA_2019-12-08
HOU,2019-12-01,28,Sun,12,13,,NWE,W 28-22,28,22,6,50,HOU_NWE_2019-12-01
TAM,2019-12-01,28,Sun,12,13,@,JAX,W 28-11,28,11,17,39,TAM_JAX_2019-12-01
MIN,2019-11-10,28,Sun,10,10,@,DAL,W 28-24,28,24,4,52,MIN_DAL_2019-11-10
SFO,2019-10-31,28,Thu,8,9,@,ARI,W 28-25,28,25,3,53,SFO_ARI_2019-10-31
CLE,2019-10-13,28,Sun,6,6,,SEA,L 28-32,28,32,-4,60,CLE_SEA_2019-10-13
MIN,2019-10-06,28,Sun,5,5,@,NYG,W 28-10,28,10,18,38,MIN_NYG_2019-10-06
BAL,2019-09-22,28,Sun,3,3,@,KAN,L 28-33,28,33,-5,61,BAL_KAN_2019-09-22
SEA,2019-09-15,28,Sun,2,2,@,PIT,W 28-26,28,26,2,54,SEA_PIT_2019-09-15
BUF,2019-09-15,28,Sun,2,2,@,NYG,W 28-14,28,14,14,42,BUF_NYG_2019-09-15
KAN,2019-09-15,28,Sun,2,2,@,OAK,W 28-10,28,10,18,38,KAN_OAK_2019-09-15
HOU,2019-09-09,28,Mon,1,1,@,NOR,L 28-30,28,30,-2,58,HOU_NOR_2019-09-09
MIN,2019-09-08,28,Sun,1,1,,ATL,W 28-12,28,12,16,40,MIN_ATL_2019-09-08
IND,2018-12-23,28,Sun,15,16,,NYG,W 28-27,28,27,1,55,IND_NYG_2018-12-23
PIT,2018-12-23,28,Sun,15,16,@,NOR,L 28-31,28,31,-3,59,PIT_NOR_2018-12-23
KAN,2018-12-13,28,Thu,14,15,,LAC,L 28-29,28,29,-1,57,KAN_LAC_2018-12-13
NOR,2018-12-09,28,Sun,13,14,@,TAM,W 28-14,28,14,14,42,NOR_TAM_2018-12-09
PHI,2018-12-03,28,Mon,12,13,,WAS,W 28-13,28,13,15,41,PHI_WAS_2018-12-03
CLE,2018-11-11,28,Sun,10,10,,ATL,W 28-16,28,16,12,44,CLE_ATL_2018-11-11
TEN,2018-11-05,28,Mon,8,9,@,DAL,W 28-14,28,14,14,42,TEN_DAL_2018-11-05
TAM,2018-11-04,28,Sun,8,9,@,CAR,L 28-42,28,42,-14,70,TAM_CAR_2018-11-04
OAK,2018-10-28,28,Sun,7,8,,IND,L 28-42,28,42,-14,70,OAK_IND_2018-10-28
SEA,2018-10-28,28,Sun,7,8,@,DET,W 28-14,28,14,14,42,SEA_DET_2018-10-28
CHI,2018-10-14,28,Sun,5,6,@,MIA,L 28-31 (OT),28,31,-3,59,CHI_MIA_2018-10-14
PIT,2018-10-14,28,Sun,6,6,@,CIN,W 28-21,28,21,7,49,PIT_CIN_2018-10-14
ARI,2018-10-07,28,Sun,5,5,@,SFO,W 28-18,28,18,10,46,ARI_SFO_2018-10-07
MIA,2018-09-23,28,Sun,3,3,,OAK,W 28-20,28,20,8,48,MIA_OAK_2018-09-23
LAC,2018-09-09,28,Sun,1,1,,KAN,L 28-38,28,38,-10,66,LAC_KAN_2018-09-09
PIT,2017-12-31,28,Sun,16,17,,CLE,W 28-24,28,24,4,52,PIT_CLE_2017-12-31
GNB,2017-11-26,28,Sun,11,12,@,PIT,L 28-31,28,31,-3,59,GNB_PIT_2017-11-26
LAC,2017-11-23,28,Thu,11,12,@,DAL,W 28-6,28,6,22,34,LAC_DAL_2017-11-23
DAL,2017-11-05,28,Sun,8,9,,KAN,W 28-17,28,17,11,45,DAL_KAN_2017-11-05
NYJ,2017-10-22,28,Sun,7,7,@,MIA,L 28-31,28,31,-3,59,NYJ_MIA_2017-10-22
PHI,2017-10-12,28,Thu,6,6,@,CAR,W 28-23,28,23,5,51,PHI_CAR_2017-10-12
DAL,2017-09-25,28,Mon,3,3,@,ARI,W 28-17,28,17,11,45,DAL_ARI_2017-09-25
CLE,2017-09-24,28,Sun,3,3,@,IND,L 28-31,28,31,-3,59,CLE_IND_2017-09-24
CIN,2023-01-08,27,Sun,16,18,,BAL,W 27-16,27,16,11,43,CIN_BAL_2023-01-08
KAN,2023-01-01,27,Sun,16,17,,DEN,W 27-24,27,24,3,51,KAN_DEN_2023-01-01
DAL,2022-12-29,27,Thu,16,17,@,TEN,W 27-13,27,13,14,40,DAL_TEN_2022-12-29
MIN,2022-12-24,27,Sat,15,16,,NYG,W 27-24,27,24,3,51,MIN_NYG_2022-12-24
NWE,2022-12-12,27,Mon,13,14,@,ARI,W 27-13,27,13,14,40,NWE_ARI_2022-12-12
DAL,2022-12-11,27,Sun,13,14,,HOU,W 27-23,27,23,4,50,DAL_HOU_2022-12-11
SEA,2022-12-04,27,Sun,12,13,@,LAR,W 27-23,27,23,4,50,SEA_LAR_2022-12-04
CLE,2022-12-04,27,Sun,12,13,@,HOU,W 27-14,27,14,13,41,CLE_HOU_2022-12-04
CIN,2022-12-04,27,Sun,12,13,,KAN,W 27-24,27,24,3,51,CIN_KAN_2022-12-04
LVR,2022-12-04,27,Sun,12,13,,LAC,W 27-20,27,20,7,47,LVR_LAC_2022-12-04
MIN,2022-12-04,27,Sun,12,13,,NYJ,W 27-22,27,22,5,49,MIN_NYJ_2022-12-04
BAL,2022-11-27,27,Sun,11,12,@,JAX,L 27-28,27,28,-1,55,BAL_JAX_2022-11-27
ATL,2022-11-20,27,Sun,11,11,,CHI,W 27-24,27,24,3,51,ATL_CHI_2022-11-20
NOR,2022-11-20,27,Sun,11,11,,LAR,W 27-20,27,20,7,47,NOR_LAR_2022-11-20
LAC,2022-11-20,27,Sun,10,11,,KAN,L 27-30,27,30,-3,57,LAC_KAN_2022-11-20
TEN,2022-11-17,27,Thu,10,11,@,GNB,W 27-17,27,17,10,44,TEN_GNB_2022-11-17
ARI,2022-11-13,27,Sun,10,10,@,LAR,W 27-17,27,17,10,44,ARI_LAR_2022-11-13
KAN,2022-11-13,27,Sun,9,10,,JAX,W 27-17,27,17,10,44,KAN_JAX_2022-11-13
BAL,2022-11-07,27,Mon,9,9,@,NOR,W 27-13,27,13,14,40,BAL_NOR_2022-11-07
JAX,2022-11-06,27,Sun,9,9,,LVR,W 27-20,27,20,7,47,JAX_LVR_2022-11-06
DET,2022-10-30,27,Sun,7,8,,MIA,L 27-31,27,31,-4,58,DET_MIA_2022-10-30
BUF,2022-10-30,27,Sun,7,8,,GNB,W 27-17,27,17,10,44,BUF_GNB_2022-10-30
SEA,2022-10-30,27,Sun,8,8,,NYG,W 27-13,27,13,14,40,SEA_NYG_2022-10-30
BAL,2022-10-27,27,Thu,8,8,@,TAM,W 27-22,27,22,5,49,BAL_TAM_2022-10-27
NYJ,2022-10-16,27,Sun,6,6,@,GNB,W 27-10,27,10,17,37,NYJ_GNB_2022-10-16
JAX,2022-10-16,27,Sun,6,6,@,IND,L 27-34,27,34,-7,61,JAX_IND_2022-10-16
NYG,2022-10-09,27,Sun,5,5,@,GNB,W 27-22,27,22,5,49,NYG_GNB_2022-10-09
GNB,2022-10-02,27,Sun,4,4,,NWE,W 27-24 (OT),27,24,3,51,GNB_NWE_2022-10-02
CIN,2022-09-29,27,Thu,4,4,,MIA,W 27-15,27,15,12,42,CIN_MIA_2022-09-29
ATL,2022-09-25,27,Sun,3,3,@,SEA,W 27-23,27,23,4,50,ATL_SEA_2022-09-25
CIN,2022-09-25,27,Sun,3,3,@,NYJ,W 27-12,27,12,15,39,CIN_NYJ_2022-09-25
GNB,2022-09-18,27,Sun,2,2,,CHI,W 27-10,27,10,17,37,GNB_CHI_2022-09-18
ATL,2022-09-18,27,Sun,2,2,@,LAR,L 27-31,27,31,-4,58,ATL_LAR_2022-09-18
SFO,2022-09-18,27,Sun,2,2,,SEA,W 27-7,27,7,20,34,SFO_SEA_2022-09-18
WAS,2022-09-18,27,Sun,2,2,@,DET,L 27-36,27,36,-9,63,WAS_DET_2022-09-18
KAN,2022-09-15,27,Thu,2,2,,LAC,W 27-24,27,24,3,51,KAN_LAC_2022-09-15
NOR,2022-09-11,27,Sun,1,1,@,ATL,W 27-26,27,26,1,53,NOR_ATL_2022-09-11
BUF,2022-01-09,27,Sun,17,18,,NYJ,W 27-10,27,10,17,37,BUF_NYJ_2022-01-09
SFO,2022-01-09,27,Sun,17,18,@,LAR,W 27-24 (OT),27,24,3,51,SFO_LAR_2022-01-09
PHI,2021-12-21,27,Tue,14,15,,WAS,W 27-17,27,17,10,44,PHI_WAS_2021-12-21
IND,2021-12-18,27,Sat,14,15,,NWE,W 27-17,27,17,10,44,IND_NWE_2021-12-18
DAL,2021-12-12,27,Sun,13,14,@,WAS,W 27-20,27,20,7,47,DAL_WAS_2021-12-12
BUF,2021-12-12,27,Sun,13,14,@,TAM,L 27-33 (OT),27,33,-6,60,BUF_TAM_2021-12-12
MIN,2021-12-05,27,Sun,12,13,@,DET,L 27-29,27,29,-2,56,MIN_DET_2021-12-05
DAL,2021-12-02,27,Thu,12,13,@,NOR,W 27-17,27,17,10,44,DAL_NOR_2021-12-02
WAS,2021-11-21,27,Sun,10,11,@,CAR,W 27-21,27,21,6,48,WAS_CAR_2021-11-21
MIN,2021-11-14,27,Sun,9,10,@,LAC,W 27-20,27,20,7,47,MIN_LAC_2021-11-14
CHI,2021-11-08,27,Mon,9,9,@,PIT,L 27-29,27,29,-2,56,CHI_PIT_2021-11-08
LAC,2021-11-07,27,Sun,8,9,@,PHI,W 27-24,27,24,3,51,LAC_PHI_2021-11-07
ATL,2021-11-07,27,Sun,8,9,@,NOR,W 27-25,27,25,2,52,ATL_NOR_2021-11-07
NWE,2021-10-31,27,Sun,8,8,@,LAC,W 27-24,27,24,3,51,NWE_LAC_2021-10-31
TAM,2021-10-31,27,Sun,8,8,@,NOR,L 27-36,27,36,-9,63,TAM_NOR_2021-10-31
TEN,2021-10-24,27,Sun,7,7,,KAN,W 27-3,27,3,24,30,TEN_KAN_2021-10-24
ATL,2021-10-10,27,Sun,5,5,,NYJ,W 27-20,27,20,7,47,ATL_NYJ_2021-10-10
PIT,2021-10-10,27,Sun,5,5,,DEN,W 27-19,27,19,8,46,PIT_DEN_2021-10-10
IND,2021-10-03,27,Sun,4,4,@,MIA,W 27-17,27,17,10,44,IND_MIA_2021-10-03
NYJ,2021-10-03,27,Sun,4,4,,TEN,W 27-24 (OT),27,24,3,51,NYJ_TEN_2021-10-03
NYG,2021-10-03,27,Sun,4,4,@,NOR,W 27-21 (OT),27,21,6,48,NYG_NOR_2021-10-03
GNB,2021-10-03,27,Sun,4,4,,PIT,W 27-17,27,17,10,44,GNB_PIT_2021-10-03
LAR,2021-09-19,27,Sun,2,2,@,IND,W 27-24,27,24,3,51,LAR_IND_2021-09-19
BAL,2021-09-13,27,Mon,1,1,@,LVR,L 27-33 (OT),27,33,-6,60,BAL_LVR_2021-09-13
CIN,2021-09-12,27,Sun,1,1,,MIN,W 27-24 (OT),27,24,3,51,CIN_MIN_2021-09-12
DEN,2021-09-12,27,Sun,1,1,@,NYG,W 27-13,27,13,14,40,DEN_NYG_2021-09-12
ATL,2021-01-03,27,Sun,16,17,@,TAM,L 27-44,27,44,-17,71,ATL_TAM_2021-01-03
BAL,2020-12-27,27,Sun,15,16,,NYG,W 27-13,27,13,14,40,BAL_NYG_2020-12-27
CIN,2020-12-21,27,Mon,14,15,,PIT,W 27-17,27,17,10,44,CIN_PIT_2020-12-21
IND,2020-12-20,27,Sun,14,15,,HOU,W 27-20,27,20,7,47,IND_HOU_2020-12-20
ATL,2020-12-20,27,Sun,14,15,,TAM,L 27-31,27,31,-4,58,ATL_TAM_2020-12-20
MIN,2020-12-20,27,Sun,14,15,,CHI,L 27-33,27,33,-6,60,MIN_CHI_2020-12-20
LVR,2020-12-17,27,Thu,14,15,,LAC,L 27-30 (OT),27,30,-3,57,LVR_LAC_2020-12-17
MIA,2020-12-13,27,Sun,13,14,,KAN,L 27-33,27,33,-6,60,MIA_KAN_2020-12-13
LVR,2020-12-13,27,Sun,13,14,,IND,L 27-44,27,44,-17,71,LVR_IND_2020-12-13
CAR,2020-12-13,27,Sun,13,14,,DEN,L 27-32,27,32,-5,59,CAR_DEN_2020-12-13
MIN,2020-12-06,27,Sun,12,13,,JAX,W 27-24 (OT),27,24,3,51,MIN_JAX_2020-12-06
CLE,2020-11-29,27,Sun,11,12,@,JAX,W 27-25,27,25,2,52,CLE_JAX_2020-11-29
CAR,2020-11-29,27,Sun,12,12,@,MIN,L 27-28,27,28,-1,55,CAR_MIN_2020-11-29
BUF,2020-11-29,27,Sun,11,12,,LAC,W 27-17,27,17,10,44,BUF_LAC_2020-11-29
KAN,2020-11-29,27,Sun,11,12,@,TAM,W 27-24,27,24,3,51,KAN_TAM_2020-11-29
LAR,2020-11-23,27,Mon,10,11,@,TAM,W 27-24,27,24,3,51,LAR_TAM_2020-11-23
PIT,2020-11-22,27,Sun,10,11,@,JAX,W 27-3,27,3,24,30,PIT_JAX_2020-11-22
HOU,2020-11-22,27,Sun,10,11,,NWE,W 27-20,27,20,7,47,HOU_NWE_2020-11-22
WAS,2020-11-15,27,Sun,9,10,@,DET,L 27-30,27,30,-3,57,WAS_DET_2020-11-15
NYG,2020-11-15,27,Sun,10,10,,PHI,W 27-17,27,17,10,44,NYG_PHI_2020-11-15
NOR,2020-11-15,27,Sun,9,10,,SFO,W 27-13,27,13,14,40,NOR_SFO_2020-11-15
NYJ,2020-11-09,27,Mon,9,9,,NWE,L 27-30,27,30,-3,57,NYJ_NWE_2020-11-09
DEN,2020-11-08,27,Sun,8,9,@,ATL,L 27-34,27,34,-7,61,DEN_ATL_2020-11-08
HOU,2020-11-08,27,Sun,8,9,@,JAX,W 27-25,27,25,2,52,HOU_JAX_2020-11-08
SFO,2020-11-01,27,Sun,8,8,@,SEA,L 27-37,27,37,-10,64,SFO_SEA_2020-11-01
NOR,2020-10-25,27,Sun,6,7,,CAR,W 27-24,27,24,3,51,NOR_CAR_2020-10-25
PIT,2020-10-25,27,Sun,6,7,@,TEN,W 27-24,27,24,3,51,PIT_TEN_2020-10-25
CIN,2020-10-18,27,Sun,6,6,@,IND,L 27-31,27,31,-4,58,CIN_IND_2020-10-18
LAC,2020-10-12,27,Mon,5,5,@,NOR,L 27-30 (OT),27,30,-3,57,LAC_NOR_2020-10-12
SEA,2020-10-11,27,Sun,5,5,,MIN,W 27-26,27,26,1,53,SEA_MIN_2020-10-11
BAL,2020-10-11,27,Sun,5,5,,CIN,W 27-3,27,3,24,30,BAL_CIN_2020-10-11
JAX,2020-09-13,27,Sun,1,1,,IND,W 27-20,27,20,7,47,JAX_IND_2020-09-13
CHI,2020-09-13,27,Sun,1,1,@,DET,W 27-23,27,23,4,50,CHI_DET_2020-09-13
WAS,2020-09-13,27,Sun,1,1,,PHI,W 27-17,27,17,10,44,WAS_PHI_2020-09-13
BUF,2020-09-13,27,Sun,1,1,,NYJ,W 27-17,27,17,10,44,BUF_NYJ_2020-09-13
MIA,2019-12-29,27,Sun,16,17,@,NWE,W 27-24,27,24,3,51,MIA_NWE_2019-12-29
ARI,2019-12-22,27,Sun,15,16,@,SEA,W 27-13,27,13,14,40,ARI_SEA_2019-12-22
DEN,2019-12-22,27,Sun,15,16,,DET,W 27-17,27,17,10,44,DEN_DET_2019-12-22
WAS,2019-12-15,27,Sun,14,15,,PHI,L 27-37,27,37,-10,64,WAS_PHI_2019-12-15
CLE,2019-12-08,27,Sun,13,14,,CIN,W 27-19,27,19,8,46,CLE_CIN_2019-12-08
MIN,2019-11-17,27,Sun,11,11,,DEN,W 27-23,27,23,4,50,MIN_DEN_2019-11-17
DET,2019-11-17,27,Sun,10,11,,DAL,L 27-35,27,35,-8,62,DET_DAL_2019-11-17
SEA,2019-11-11,27,Mon,10,10,@,SFO,W 27-24 (OT),27,24,3,51,SEA_SFO_2019-11-11
NYG,2019-11-10,27,Sun,10,10,@,NYJ,L 27-34,27,34,-7,61,NYG_NYJ_2019-11-10
ARI,2019-11-10,27,Sun,10,10,@,TAM,L 27-30,27,30,-3,57,ARI_TAM_2019-11-10
PIT,2019-10-28,27,Mon,7,8,,MIA,W 27-14,27,14,13,41,PIT_MIA_2019-10-28
TEN,2019-10-27,27,Sun,8,8,,TAM,W 27-23,27,23,4,50,TEN_TAM_2019-10-27
SEA,2019-10-27,27,Sun,8,8,@,ATL,W 27-20,27,20,7,47,SEA_ATL_2019-10-27
NWE,2019-10-27,27,Sun,8,8,,CLE,W 27-13,27,13,14,40,NWE_CLE_2019-10-27
HOU,2019-10-27,27,Sun,8,8,,OAK,W 27-24,27,24,3,51,HOU_OAK_2019-10-27
JAX,2019-10-20,27,Sun,7,7,@,CIN,W 27-17,27,17,10,44,JAX_CIN_2019-10-20
ARI,2019-10-20,27,Sun,7,7,@,NYG,W 27-21,27,21,6,48,ARI_NYG_2019-10-20
JAX,2019-10-06,27,Sun,5,5,@,CAR,L 27-34,27,34,-7,61,JAX_CAR_2019-10-06
PIT,2019-09-30,27,Mon,4,4,,CIN,W 27-3,27,3,24,30,PIT_CIN_2019-09-30
SEA,2019-09-29,27,Sun,4,4,@,ARI,W 27-10,27,10,17,37,SEA_ARI_2019-09-29
GNB,2019-09-26,27,Thu,4,4,,PHI,L 27-34,27,34,-7,61,GNB_PHI_2019-09-26
DET,2019-09-22,27,Sun,3,3,@,PHI,W 27-24,27,24,3,51,DET_PHI_2019-09-22
GNB,2019-09-22,27,Sun,3,3,,DEN,W 27-16,27,16,11,43,GNB_DEN_2019-09-22
SEA,2019-09-22,27,Sun,3,3,,NOR,L 27-33,27,33,-6,60,SEA_NOR_2019-09-22
IND,2019-09-22,27,Sun,3,3,,ATL,W 27-24,27,24,3,51,IND_ATL_2019-09-22
HOU,2019-09-22,27,Sun,3,3,@,LAC,W 27-20,27,20,7,47,HOU_LAC_2019-09-22
LAR,2019-09-15,27,Sun,2,2,,NOR,W 27-9,27,9,18,36,LAR_NOR_2019-09-15
WAS,2019-09-08,27,Sun,1,1,@,PHI,L 27-32,27,32,-5,59,WAS_PHI_2019-09-08
DET,2019-09-08,27,Sun,1,1,@,ARI,T 27-27 (OT),27,27,0,54,DET_ARI_2019-09-08
CAR,2019-09-08,27,Sun,1,1,,LAR,L 27-30,27,30,-3,57,CAR_LAR_2019-09-08
ARI,2019-09-08,27,Sun,1,1,,DET,T 27-27 (OT),27,27,0,54,ARI_DET_2019-09-08
SEA,2018-12-30,27,Sun,16,17,,ARI,W 27-24,27,24,3,51,SEA_ARI_2018-12-30
OAK,2018-12-24,27,Mon,15,16,,DEN,W 27-14,27,14,13,41,OAK_DEN_2018-12-24
NYG,2018-12-23,27,Sun,15,16,@,IND,L 27-28,27,28,-1,55,NYG_IND_2018-12-23
MIN,2018-12-23,27,Sun,15,16,@,DET,W 27-9,27,9,18,36,MIN_DET_2018-12-23
DAL,2018-12-23,27,Sun,15,16,,TAM,W 27-20,27,20,7,47,DAL_TAM_2018-12-23
KAN,2018-12-09,27,Sun,13,14,,BAL,W 27-24 (OT),27,24,3,51,KAN_BAL_2018-12-09
NYJ,2018-12-09,27,Sun,13,14,@,BUF,W 27-23,27,23,4,50,NYJ_BUF_2018-12-09
CHI,2018-12-02,27,Sun,12,13,@,NYG,L 27-30 (OT),27,30,-3,57,CHI_NYG_2018-12-02
NWE,2018-11-25,27,Sun,11,12,@,NYJ,W 27-13,27,13,14,40,NWE_NYJ_2018-11-25
IND,2018-11-25,27,Sun,11,12,,MIA,W 27-24,27,24,3,51,IND_MIA_2018-11-25
TAM,2018-11-25,27,Sun,11,12,,SFO,W 27-9,27,9,18,36,TAM_SFO_2018-11-25
CAR,2018-11-25,27,Sun,11,12,,SEA,L 27-30,27,30,-3,57,CAR_SEA_2018-11-25
SEA,2018-11-15,27,Thu,10,11,,GNB,W 27-24,27,24,3,51,SEA_GNB_2018-11-15
NYG,2018-11-12,27,Mon,9,10,@,SFO,W 27-23,27,23,4,50,NYG_SFO_2018-11-12
DAL,2018-11-11,27,Sun,9,10,@,PHI,W 27-20,27,20,7,47,DAL_PHI_2018-11-11
GNB,2018-10-28,27,Sun,7,8,@,LAR,L 27-29,27,29,-2,56,GNB_LAR_2018-10-28
SEA,2018-10-14,27,Sun,6,6,@,OAK,W 27-3,27,3,24,30,SEA_OAK_2018-10-14
MIN,2018-10-14,27,Sun,6,6,,ARI,W 27-17,27,17,10,44,MIN_ARI_2018-10-14
CIN,2018-10-07,27,Sun,5,5,,MIA,W 27-17,27,17,10,44,CIN_MIA_2018-10-07
KAN,2018-10-01,27,Mon,4,4,@,DEN,W 27-23,27,23,4,50,KAN_DEN_2018-10-01
SFO,2018-09-30,27,Sun,4,4,@,LAC,L 27-29,27,29,-2,56,SFO_LAC_2018-09-30
TAM,2018-09-24,27,Mon,3,3,,PIT,L 27-30,27,30,-3,57,TAM_PIT_2018-09-24
BUF,2018-09-23,27,Sun,3,3,@,MIN,W 27-6,27,6,21,33,BUF_MIN_2018-09-23
BAL,2018-09-23,27,Sun,3,3,,DEN,W 27-14,27,14,13,41,BAL_DEN_2018-09-23
NYG,2018-09-23,27,Sun,3,3,@,HOU,W 27-22,27,22,5,49,NYG_HOU_2018-09-23
SFO,2018-09-23,27,Sun,3,3,@,KAN,L 27-38,27,38,-11,65,SFO_KAN_2018-09-23
TAM,2018-09-16,27,Sun,2,2,,PHI,W 27-21,27,21,6,48,TAM_PHI_2018-09-16
DET,2018-09-16,27,Sun,2,2,@,SFO,L 27-30,27,30,-3,57,DET_SFO_2018-09-16
MIA,2018-09-09,27,Sun,1,1,,TEN,W 27-20,27,20,7,47,MIA_TEN_2018-09-09
DEN,2018-09-09,27,Sun,1,1,,SEA,W 27-24,27,24,3,51,DEN_SEA_2018-09-09
NWE,2018-09-09,27,Sun,1,1,,HOU,W 27-20,27,20,7,47,NWE_HOU_2018-09-09
BAL,2017-12-31,27,Sun,16,17,,CIN,L 27-31,27,31,-4,58,BAL_CIN_2017-12-31
KAN,2017-12-31,27,Sun,16,17,@,DEN,W 27-24,27,24,3,51,KAN_DEN_2017-12-31
WAS,2017-12-24,27,Sun,15,16,,DEN,W 27-11,27,11,16,38,WAS_DEN_2017-12-24
LAR,2017-12-24,27,Sun,15,16,@,TEN,W 27-23,27,23,4,50,LAR_TEN_2017-12-24
NWE,2017-12-17,27,Sun,14,15,@,PIT,W 27-24,27,24,3,51,NWE_PIT_2017-12-17
BAL,2017-12-17,27,Sun,14,15,@,CLE,W 27-10,27,10,17,37,BAL_CLE_2017-12-17
MIA,2017-12-11,27,Mon,13,14,,NWE,W 27-20,27,20,7,47,MIA_NWE_2017-12-11
GNB,2017-12-10,27,Sun,13,14,@,CLE,W 27-21 (OT),27,21,6,48,GNB_CLE_2017-12-10
NYJ,2017-11-26,27,Sun,11,12,,CAR,L 27-35,27,35,-8,62,NYJ_CAR_2017-11-26
ARI,2017-11-26,27,Sun,11,12,,JAX,W 27-24,27,24,3,51,ARI_JAX_2017-11-26
DET,2017-11-19,27,Sun,10,11,@,CHI,W 27-24,27,24,3,51,DET_CHI_2017-11-19
ATL,2017-11-12,27,Sun,9,10,,DAL,W 27-7,27,7,20,34,ATL_DAL_2017-11-12
OAK,2017-11-05,27,Sun,9,9,@,MIA,W 27-24,27,24,3,51,OAK_MIA_2017-11-05
JAX,2017-10-22,27,Sun,7,7,@,IND,W 27-0,27,0,27,27,JAX_IND_2017-10-22
TAM,2017-10-22,27,Sun,6,7,@,BUF,L 27-30,27,30,-3,57,TAM_BUF_2017-10-22
LAR,2017-10-15,27,Sun,6,6,@,JAX,W 27-17,27,17,10,44,LAR_JAX_2017-10-15
CHI,2017-10-15,27,Sun,6,6,@,BAL,W 27-24 (OT),27,24,3,51,CHI_BAL_2017-10-15
LAC,2017-10-08,27,Sun,5,5,@,NYG,W 27-22,27,22,5,49,LAC_NYG_2017-10-08
CAR,2017-10-08,27,Sun,5,5,@,DET,W 27-24,27,24,3,51,CAR_DET_2017-10-08
GNB,2017-09-24,27,Sun,3,3,,CIN,W 27-24 (OT),27,24,3,51,GNB_CIN_2017-09-24
PHI,2017-09-24,27,Sun,3,3,,NYG,W 27-24,27,24,3,51,PHI_NYG_2017-09-24
WAS,2017-09-24,27,Sun,3,3,,OAK,W 27-10,27,10,17,37,WAS_OAK_2017-09-24
SEA,2017-09-24,27,Sun,3,3,@,TEN,L 27-33,27,33,-6,60,SEA_TEN_2017-09-24
WAS,2017-09-17,27,Sun,2,2,@,LAR,W 27-20,27,20,7,47,WAS_LAR_2017-09-17
KAN,2017-09-17,27,Sun,2,2,,PHI,W 27-20,27,20,7,47,KAN_PHI_2017-09-17
NWE,2017-09-07,27,Thu,1,1,,KAN,L 27-42,27,42,-15,69,NWE_KAN_2017-09-07
WAS,2023-01-08,26,Sun,17,18,,DAL,W 26-6,26,6,20,32,WAS_DAL_2023-01-08
GNB,2022-12-25,26,Sun,15,16,@,MIA,W 26-20,26,20,6,46,GNB_MIA_2022-12-25
KAN,2022-11-27,26,Sun,11,12,,LAR,W 26-10,26,10,16,36,KAN_LAR_2022-11-27
NWE,2022-11-24,26,Thu,11,12,@,MIN,L 26-33,26,33,-7,59,NWE_MIN_2022-11-24
NWE,2022-11-06,26,Sun,9,9,,IND,W 26-3,26,3,23,29,NWE_IND_2022-11-06
ARI,2022-10-30,26,Sun,8,8,@,MIN,L 26-34,26,34,-8,60,ARI_MIN_2022-10-30
NOR,2022-10-16,26,Sun,6,6,,CIN,L 26-30,26,30,-4,56,NOR_CIN_2022-10-16
PHI,2022-10-16,26,Sun,6,6,,DAL,W 26-17,26,17,9,43,PHI_DAL_2022-10-16
ARI,2022-10-02,26,Sun,4,4,@,CAR,W 26-16,26,16,10,42,ARI_CAR_2022-10-02
NWE,2022-09-25,26,Sun,3,3,,BAL,L 26-37,26,37,-11,63,NWE_BAL_2022-09-25
ATL,2022-09-11,26,Sun,1,1,,NOR,L 26-27,26,27,-1,53,ATL_NOR_2022-09-11
CLE,2022-09-11,26,Sun,1,1,@,CAR,W 26-24,26,24,2,50,CLE_CAR_2022-09-11
JAX,2022-01-09,26,Sun,17,18,,IND,W 26-11,26,11,15,37,JAX_IND_2022-01-09
PHI,2022-01-08,26,Sat,17,18,,DAL,L 26-51,26,51,-25,77,PHI_DAL_2022-01-08
PIT,2022-01-03,26,Mon,16,17,,CLE,W 26-14,26,14,12,40,PIT_CLE_2022-01-03
NYJ,2021-12-26,26,Sun,15,16,,JAX,W 26-21,26,21,5,47,NYJ_JAX_2021-12-26
SFO,2021-12-12,26,Sun,13,14,@,CIN,W 26-23 (OT),26,23,3,49,SFO_CIN_2021-12-12
MIN,2021-11-28,26,Sun,11,12,@,SFO,L 26-34,26,34,-8,60,MIN_SFO_2021-11-28
BUF,2021-10-31,26,Sun,7,8,,MIA,W 26-11,26,11,15,37,BUF_MIA_2021-10-31
LAR,2021-10-07,26,Thu,5,5,@,SEA,W 26-17,26,17,9,43,LAR_SEA_2021-10-07
DEN,2021-09-26,26,Sun,3,3,,NYJ,W 26-0,26,0,26,26,DEN_NYJ_2021-09-26
CLE,2021-09-26,26,Sun,3,3,,CHI,W 26-6,26,6,20,32,CLE_CHI_2021-09-26
CAR,2021-09-19,26,Sun,2,2,,NOR,W 26-7,26,7,19,33,CAR_NOR_2021-09-19
LVR,2021-09-19,26,Sun,2,2,@,PIT,W 26-17,26,17,9,43,LVR_PIT_2021-09-19
MIA,2021-01-03,26,Sun,16,17,@,BUF,L 26-56,26,56,-30,82,MIA_BUF_2021-01-03
SEA,2021-01-03,26,Sun,16,17,@,SFO,W 26-23,26,23,3,49,SEA_SFO_2021-01-03
MIA,2020-12-26,26,Sat,15,16,@,LVR,W 26-25,26,25,1,51,MIA_LVR_2020-12-26
PHI,2020-12-20,26,Sun,14,15,@,ARI,L 26-33,26,33,-7,59,PHI_ARI_2020-12-20
ARI,2020-12-13,26,Sun,13,14,@,NYG,W 26-7,26,7,19,33,ARI_NYG_2020-12-13
TAM,2020-12-13,26,Sun,13,14,,MIN,W 26-14,26,14,12,40,TAM_MIN_2020-12-13
BUF,2020-12-13,26,Sun,13,14,,PIT,W 26-15,26,15,11,41,BUF_PIT_2020-12-13
IND,2020-12-06,26,Sun,12,13,@,HOU,W 26-20,26,20,6,46,IND_HOU_2020-12-06
IND,2020-11-29,26,Sun,11,12,,TEN,L 26-45,26,45,-19,71,IND_TEN_2020-11-29
LAC,2020-11-08,26,Sun,8,9,,LVR,L 26-31,26,31,-5,57,LAC_LVR_2020-11-08
NOR,2020-11-01,26,Sun,7,8,@,CHI,W 26-23 (OT),26,23,3,49,NOR_CHI_2020-11-01
KAN,2020-10-19,26,Mon,6,6,@,BUF,W 26-17,26,17,9,43,KAN_BUF_2020-10-19
MIN,2020-10-11,26,Sun,5,5,@,SEA,L 26-27,26,27,-1,53,MIN_SEA_2020-10-11
KAN,2020-10-05,26,Mon,4,4,,NWE,W 26-10,26,10,16,36,KAN_NWE_2020-10-05
DET,2020-09-27,26,Sun,3,3,@,ARI,W 26-23,26,23,3,49,DET_ARI_2020-09-27
ATL,2020-09-27,26,Sun,3,3,,CHI,L 26-30,26,30,-4,56,ATL_CHI_2020-09-27
PIT,2020-09-20,26,Sun,2,2,,DEN,W 26-21,26,21,5,47,PIT_DEN_2020-09-20
PIT,2020-09-14,26,Mon,1,1,@,NYG,W 26-16,26,16,10,42,PIT_NYG_2020-09-14
SFO,2019-12-29,26,Sun,16,17,@,SEA,W 26-21,26,21,5,47,SFO_SEA_2019-12-29
KAN,2019-12-22,26,Sun,15,16,@,CHI,W 26-3,26,3,23,29,KAN_CHI_2019-12-22
NOR,2019-11-28,26,Thu,12,13,@,ATL,W 26-18,26,18,8,44,NOR_ATL_2019-11-28
BUF,2019-11-28,26,Thu,12,13,@,DAL,W 26-15,26,15,11,41,BUF_DAL_2019-11-28
ARI,2019-11-17,26,Sun,11,11,@,SFO,L 26-36,26,36,-10,62,ARI_SFO_2019-11-17
ATL,2019-11-10,26,Sun,9,10,@,NOR,W 26-9,26,9,17,35,ATL_NOR_2019-11-10
OAK,2019-11-07,26,Thu,9,10,,LAC,W 26-24,26,24,2,50,OAK_LAC_2019-11-07
MIA,2019-11-03,26,Sun,8,9,,NYJ,W 26-18,26,18,8,44,MIA_NYJ_2019-11-03
LAC,2019-11-03,26,Sun,9,9,,GNB,W 26-11,26,11,15,37,LAC_GNB_2019-11-03
HOU,2019-11-03,26,Sun,9,9,@,JAX,W 26-3,26,3,23,29,HOU_JAX_2019-11-03
KAN,2019-11-03,26,Sun,9,9,,MIN,W 26-23,26,23,3,49,KAN_MIN_2019-11-03
PIT,2019-11-03,26,Sun,8,9,,IND,W 26-24,26,24,2,50,PIT_IND_2019-11-03
NYG,2019-10-27,26,Sun,8,8,@,DET,L 26-31,26,31,-5,57,NYG_DET_2019-10-27
TAM,2019-10-13,26,Sun,6,6,,CAR,L 26-37,26,37,-11,63,TAM_CAR_2019-10-13
ARI,2019-10-06,26,Sun,5,5,@,CIN,W 26-23,26,23,3,49,ARI_CIN_2019-10-06
BAL,2019-10-06,26,Sun,5,5,@,PIT,W 26-23 (OT),26,23,3,49,BAL_PIT_2019-10-06
JAX,2019-09-29,26,Sun,4,4,@,DEN,W 26-24,26,24,2,50,JAX_DEN_2019-09-29
PIT,2019-09-15,26,Sun,2,2,,SEA,L 26-28,26,28,-2,54,PIT_SEA_2019-09-15
JAX,2019-09-08,26,Sun,1,1,,KAN,L 26-40,26,40,-14,66,JAX_KAN_2019-09-08
BAL,2018-12-30,26,Sun,16,17,,CLE,W 26-24,26,24,2,50,BAL_CLE_2018-12-30
CLE,2018-12-23,26,Sun,15,16,,CIN,W 26-18,26,18,8,44,CLE_CIN_2018-12-23
SFO,2018-12-16,26,Sun,14,15,,SEA,W 26-23 (OT),26,23,3,49,SFO_SEA_2018-12-16
LAC,2018-12-09,26,Sun,13,14,,CIN,W 26-21,26,21,5,47,LAC_CIN_2018-12-09
CLE,2018-12-09,26,Sun,13,14,,CAR,W 26-20,26,20,6,46,CLE_CAR_2018-12-09
TEN,2018-12-02,26,Sun,12,13,,NYJ,W 26-22,26,22,4,48,TEN_NYJ_2018-12-02
BAL,2018-12-02,26,Sun,12,13,@,ATL,W 26-16,26,16,10,42,BAL_ATL_2018-12-02
JAX,2018-11-11,26,Sun,9,10,@,IND,L 26-29,26,29,-3,55,JAX_IND_2018-11-11
KAN,2018-11-11,26,Sun,10,10,,ARI,W 26-14,26,14,12,40,KAN_ARI_2018-11-11
TAM,2018-10-21,26,Sun,6,7,,CLE,W 26-23 (OT),26,23,3,49,TAM_CLE_2018-10-21
LAC,2018-10-07,26,Sun,5,5,,OAK,W 26-10,26,10,16,36,LAC_OAK_2018-10-07
DAL,2018-09-30,26,Sun,4,4,,DET,W 26-24,26,24,2,50,DAL_DET_2018-09-30
TEN,2018-09-30,26,Sun,4,4,,PHI,W 26-23 (OT),26,23,3,49,TEN_PHI_2018-09-30
BAL,2018-09-30,26,Sun,4,4,@,PIT,W 26-14,26,14,12,40,BAL_PIT_2018-09-30
DET,2018-09-23,26,Sun,3,3,,NWE,W 26-10,26,10,16,36,DET_NWE_2018-09-23
ARI,2017-12-31,26,Sun,16,17,@,SEA,W 26-24,26,24,2,50,ARI_SEA_2017-12-31
NWE,2017-12-31,26,Sun,16,17,,NYJ,W 26-6,26,6,20,32,NWE_NYJ_2017-12-31
CIN,2017-12-24,26,Sun,15,16,,DET,W 26-17,26,17,9,43,CIN_DET_2017-12-24
SFO,2017-12-10,26,Sun,13,14,@,HOU,W 26-16,26,16,10,42,SFO_HOU_2017-12-10
KAN,2017-12-10,26,Sun,13,14,,OAK,W 26-15,26,15,11,41,KAN_OAK_2017-12-10
GNB,2017-12-03,26,Sun,12,13,,TAM,W 26-20 (OT),26,20,6,46,GNB_TAM_2017-12-03
LAR,2017-11-26,26,Sun,11,12,,NOR,W 26-20,26,20,6,46,LAR_NOR_2017-11-26
NOR,2017-10-22,26,Sun,6,7,@,GNB,W 26-17,26,17,9,43,NOR_GNB_2017-10-22
WAS,2017-10-15,26,Sun,5,6,,SFO,W 26-24,26,24,2,50,WAS_SFO_2017-10-15
IND,2017-10-08,26,Sun,5,5,,SFO,W 26-23 (OT),26,23,3,49,IND_SFO_2017-10-08
PIT,2017-10-01,26,Sun,4,4,@,BAL,W 26-9,26,9,17,35,PIT_BAL_2017-10-01
PHI,2017-10-01,26,Sun,4,4,@,LAC,W 26-24,26,24,2,50,PHI_LAC_2017-10-01
DET,2017-09-24,26,Sun,3,3,,ATL,L 26-30,26,30,-4,56,DET_ATL_2017-09-24
BUF,2017-09-24,26,Sun,3,3,,DEN,W 26-16,26,16,10,42,BUF_DEN_2017-09-24
PIT,2017-09-17,26,Sun,2,2,,MIN,W 26-9,26,9,17,35,PIT_MIN_2017-09-17
OAK,2017-09-10,26,Sun,1,1,@,TEN,W 26-16,26,16,10,42,OAK_TEN_2017-09-10
PHI,2022-12-18,25,Sun,14,15,@,CHI,W 25-20,25,20,5,45,PHI_CHI_2022-12-18
LAC,2022-11-27,25,Sun,11,12,@,ARI,W 25-24,25,24,1,49,LAC_ARI_2022-11-27
DET,2022-11-24,25,Thu,11,12,,BUF,L 25-28,25,28,-3,53,DET_BUF_2022-11-24
IND,2022-11-13,25,Sun,10,10,@,LVR,W 25-20,25,20,5,45,IND_LVR_2022-11-13
CAR,2022-11-10,25,Thu,10,10,,ATL,W 25-15,25,15,10,40,CAR_ATL_2022-11-10
DAL,2022-10-02,25,Sun,4,4,,WAS,W 25-10,25,10,15,35,DAL_WAS_2022-10-02
NOR,2022-10-02,25,Sun,4,4,,MIN,L 25-28,25,28,-3,53,NOR_MIN_2022-10-02
HOU,2022-01-09,25,Sun,17,18,,TEN,L 25-28,25,28,-3,53,HOU_TEN_2022-01-09
ARI,2022-01-02,25,Sun,16,17,@,DAL,W 25-22,25,22,3,47,ARI_DAL_2022-01-02
CHI,2021-12-26,25,Sun,15,16,@,SEA,W 25-24,25,24,1,49,CHI_SEA_2021-12-26
NWE,2021-11-18,25,Thu,11,11,@,ATL,W 25-0,25,0,25,25,NWE_ATL_2021-11-18
NOR,2021-11-07,25,Sun,8,9,,ATL,L 25-27,25,27,-2,52,NOR_ATL_2021-11-07
NYG,2021-10-24,25,Sun,7,7,,CAR,W 25-3,25,3,22,28,NYG_CAR_2021-10-24
IND,2021-10-11,25,Mon,5,5,@,BAL,L 25-31 (OT),25,31,-6,56,IND_BAL_2021-10-11
GNB,2021-10-10,25,Sun,5,5,@,CIN,W 25-22 (OT),25,22,3,47,GNB_CIN_2021-10-10
NWE,2021-10-10,25,Sun,5,5,@,HOU,W 25-22,25,22,3,47,NWE_HOU_2021-10-10
TEN,2021-09-26,25,Sun,3,3,,IND,W 25-16,25,16,9,41,TEN_IND_2021-09-26
NWE,2021-09-19,25,Sun,2,2,@,NYJ,W 25-6,25,6,19,31,NWE_NYJ_2021-09-19
ATL,2021-09-19,25,Sun,2,2,@,TAM,L 25-48,25,48,-23,73,ATL_TAM_2021-09-19
LVR,2020-12-26,25,Sat,15,16,,MIA,L 25-26,25,26,-1,51,LVR_MIA_2020-12-26
DET,2020-12-20,25,Sun,14,15,@,TEN,L 25-46,25,46,-21,71,DET_TEN_2020-12-20
JAX,2020-11-29,25,Sun,11,12,,CLE,L 25-27,25,27,-2,52,JAX_CLE_2020-11-29
CHI,2020-11-29,25,Sun,11,12,@,GNB,L 25-41,25,41,-16,66,CHI_GNB_2020-11-29
DET,2020-11-26,25,Thu,11,12,,HOU,L 25-41,25,41,-16,66,DET_HOU_2020-11-26
JAX,2020-11-08,25,Sun,8,9,,HOU,L 25-27,25,27,-2,52,JAX_HOU_2020-11-08
TAM,2020-11-02,25,Mon,8,8,@,NYG,W 25-23,25,23,2,48,TAM_NYG_2020-11-02
ATL,2020-10-29,25,Thu,8,8,@,CAR,W 25-17,25,17,8,42,ATL_CAR_2020-10-29
WAS,2020-10-25,25,Sun,7,7,,DAL,W 25-3,25,3,22,28,WAS_DAL_2020-10-25
PHI,2020-10-04,25,Sun,4,4,@,SFO,W 25-20,25,20,5,45,PHI_SFO_2020-10-04
JAX,2020-10-04,25,Sun,4,4,@,CIN,L 25-33,25,33,-8,58,JAX_CIN_2020-10-04
ATL,2020-09-13,25,Sun,1,1,,SEA,L 25-38,25,38,-13,63,ATL_SEA_2020-09-13
ARI,2019-10-31,25,Thu,9,9,,SFO,L 25-28,25,28,-3,53,ARI_SFO_2019-10-31
CHI,2019-10-20,25,Sun,6,7,,NOR,L 25-36,25,36,-11,61,CHI_NOR_2019-10-20
BAL,2019-09-29,25,Sun,4,4,,CLE,L 25-40,25,40,-15,65,BAL_CLE_2019-09-29
TEN,2018-12-22,25,Sat,15,16,,WAS,W 25-16,25,16,9,41,TEN_WAS_2018-12-22
PHI,2018-11-25,25,Sun,11,12,,NYG,W 25-22,25,22,3,47,PHI_NYG_2018-11-25
CHI,2018-11-18,25,Sun,10,11,,MIN,W 25-20,25,20,5,45,CHI_MIN_2018-11-18
LAC,2018-11-04,25,Sun,8,9,@,SEA,W 25-17,25,17,8,42,LAC_SEA_2018-11-04
NWE,2018-10-29,25,Mon,8,8,@,BUF,W 25-6,25,6,19,31,NWE_BUF_2018-10-29
SFO,2017-12-17,25,Sun,14,15,,TEN,W 25-23,25,23,2,48,SFO_TEN_2017-12-17
DEN,2017-12-14,25,Thu,14,15,@,IND,W 25-13,25,13,12,38,DEN_IND_2017-12-14
ATL,2017-10-29,25,Sun,7,8,@,NYJ,W 25-20,25,20,5,45,ATL_NYJ_2017-10-29
TAM,2017-10-01,25,Sun,3,4,,NYG,W 25-23,25,23,2,48,TAM_NYG_2017-10-01
CAR,2023-01-01,24,Sun,16,17,@,TAM,L 24-30,24,30,-6,54,CAR_TAM_2023-01-01
DEN,2023-01-01,24,Sun,16,17,@,KAN,L 24-27,24,27,-3,51,DEN_KAN_2023-01-01
CLE,2023-01-01,24,Sun,16,17,@,WAS,W 24-10,24,10,14,34,CLE_WAS_2023-01-01
KAN,2022-12-24,24,Sat,15,16,,SEA,W 24-10,24,10,14,34,KAN_SEA_2022-12-24
NYG,2022-12-24,24,Sat,15,16,@,MIN,L 24-27,24,27,-3,51,NYG_MIN_2022-12-24
GNB,2022-12-19,24,Mon,14,15,,LAR,W 24-12,24,12,12,36,GNB_LAR_2022-12-19
DEN,2022-12-18,24,Sun,14,15,,ARI,W 24-15,24,15,9,39,DEN_ARI_2022-12-18
PIT,2022-12-18,24,Sun,14,15,@,CAR,W 24-16,24,16,8,40,PIT_CAR_2022-12-18
HOU,2022-12-18,24,Sun,14,15,,KAN,L 24-30 (OT),24,30,-6,54,HOU_KAN_2022-12-18
NWE,2022-12-18,24,Sun,14,15,@,LVR,L 24-30,24,30,-6,54,NWE_LVR_2022-12-18
SEA,2022-12-11,24,Sun,13,14,,CAR,L 24-30,24,30,-6,54,SEA_CAR_2022-12-11
KAN,2022-12-04,24,Sun,12,13,@,CIN,L 24-27,24,27,-3,51,KAN_CIN_2022-12-04
BUF,2022-12-01,24,Thu,12,13,@,NWE,W 24-10,24,10,14,34,BUF_NWE_2022-12-01
PIT,2022-11-28,24,Mon,11,12,@,IND,W 24-17,24,17,7,41,PIT_IND_2022-11-28
ARI,2022-11-27,24,Sun,12,12,,LAC,L 24-25,24,25,-1,49,ARI_LAC_2022-11-27
CHI,2022-11-20,24,Sun,11,11,@,ATL,L 24-27,24,27,-3,51,CHI_ATL_2022-11-20
NYG,2022-11-13,24,Sun,9,10,,HOU,W 24-16,24,16,8,40,NYG_HOU_2022-11-13
NOR,2022-10-30,24,Sun,8,8,,LVR,W 24-0,24,0,24,24,NOR_LVR_2022-10-30
DAL,2022-10-23,24,Sun,7,7,,DET,W 24-6,24,6,18,30,DAL_DET_2022-10-23
MIN,2022-10-16,24,Sun,6,6,@,MIA,W 24-16,24,16,8,40,MIN_MIA_2022-10-16
LAR,2022-10-16,24,Sun,6,6,,CAR,W 24-10,24,10,14,34,LAR_CAR_2022-10-16
BUF,2022-10-16,24,Sun,6,6,@,KAN,W 24-20,24,20,4,44,BUF_KAN_2022-10-16
NYG,2022-10-16,24,Sun,6,6,,BAL,W 24-20,24,20,4,44,NYG_BAL_2022-10-16
SFO,2022-10-03,24,Mon,4,4,,LAR,W 24-9,24,9,15,33,SFO_LAR_2022-10-03
NWE,2022-10-02,24,Sun,4,4,@,GNB,L 24-27 (OT),24,27,-3,51,NWE_GNB_2022-10-02
NYJ,2022-10-02,24,Sun,4,4,@,PIT,W 24-20,24,20,4,44,NYJ_PIT_2022-10-02
TEN,2022-10-02,24,Sun,4,4,@,IND,W 24-17,24,17,7,41,TEN_IND_2022-10-02
HOU,2022-10-02,24,Sun,4,4,,LAC,L 24-34,24,34,-10,58,HOU_LAC_2022-10-02
PHI,2022-09-25,24,Sun,3,3,@,WAS,W 24-8,24,8,16,32,PHI_WAS_2022-09-25
DET,2022-09-25,24,Sun,3,3,@,MIN,L 24-28,24,28,-4,52,DET_MIN_2022-09-25
TEN,2022-09-25,24,Sun,3,3,,LVR,W 24-22,24,22,2,46,TEN_LVR_2022-09-25
PHI,2022-09-19,24,Mon,2,2,,MIN,W 24-7,24,7,17,31,PHI_MIN_2022-09-19
JAX,2022-09-18,24,Sun,2,2,,IND,W 24-0,24,0,24,24,JAX_IND_2022-09-18
LAC,2022-09-15,24,Thu,2,2,@,KAN,L 24-27,24,27,-3,51,LAC_KAN_2022-09-15
CAR,2022-09-11,24,Sun,1,1,,CLE,L 24-26,24,26,-2,50,CAR_CLE_2022-09-11
LAC,2022-09-11,24,Sun,1,1,,LVR,W 24-19,24,19,5,43,LAC_LVR_2022-09-11
BAL,2022-09-11,24,Sun,1,1,@,NYJ,W 24-9,24,9,15,33,BAL_NYJ_2022-09-11
NWE,2022-01-09,24,Sun,17,18,@,MIA,L 24-33,24,33,-9,57,NWE_MIA_2022-01-09
LAR,2022-01-09,24,Sun,17,18,,SFO,L 24-27 (OT),24,27,-3,51,LAR_SFO_2022-01-09
DEN,2022-01-08,24,Sat,17,18,,KAN,L 24-28,24,28,-4,52,DEN_KAN_2022-01-08
NYJ,2022-01-02,24,Sun,16,17,,TAM,L 24-28,24,28,-4,52,NYJ_TAM_2022-01-02
SEA,2021-12-26,24,Sun,15,16,,CHI,L 24-25,24,25,-1,49,SEA_CHI_2021-12-26
GNB,2021-12-25,24,Sat,15,16,,CLE,W 24-22,24,22,2,46,GNB_CLE_2021-12-25
NYJ,2021-12-19,24,Sun,14,15,@,MIA,L 24-31,24,31,-7,55,NYJ_MIA_2021-12-19
CLE,2021-12-12,24,Sun,13,14,,BAL,W 24-22,24,22,2,46,CLE_BAL_2021-12-12
MIA,2021-11-21,24,Sun,11,11,@,NYJ,W 24-17,24,17,7,41,MIA_NYJ_2021-11-21
PHI,2021-11-07,24,Sun,9,9,,LAC,L 24-27,24,27,-3,51,PHI_LAC_2021-11-07
NWE,2021-11-07,24,Sun,9,9,@,CAR,W 24-6,24,6,18,30,NWE_CAR_2021-11-07
LAC,2021-10-31,24,Sun,7,8,,NWE,L 24-27,24,27,-3,51,LAC_NWE_2021-10-31
GNB,2021-10-28,24,Thu,8,8,@,ARI,W 24-21,24,21,3,45,GNB_ARI_2021-10-28
GNB,2021-10-24,24,Sun,7,7,,WAS,W 24-10,24,10,14,34,GNB_WAS_2021-10-24
DEN,2021-10-17,24,Sun,6,6,,LVR,L 24-34,24,34,-10,58,DEN_LVR_2021-10-17
GNB,2021-10-17,24,Sun,6,6,@,CHI,W 24-14,24,14,10,38,GNB_CHI_2021-10-17
CHI,2021-10-03,24,Sun,4,4,,DET,W 24-14,24,14,10,38,CHI_DET_2021-10-03
TEN,2021-10-03,24,Sun,4,4,@,NYJ,L 24-27 (OT),24,27,-3,51,TEN_NYJ_2021-10-03
CIN,2021-09-30,24,Thu,4,4,,JAX,W 24-21,24,21,3,45,CIN_JAX_2021-09-30
KAN,2021-09-26,24,Sun,3,3,,LAC,L 24-30,24,30,-6,54,KAN_LAC_2021-09-26
TAM,2021-09-26,24,Sun,3,3,@,LAR,L 24-34,24,34,-10,58,TAM_LAR_2021-09-26
CIN,2021-09-26,24,Sun,3,3,@,PIT,W 24-10,24,10,14,34,CIN_PIT_2021-09-26
CAR,2021-09-23,24,Thu,3,3,@,HOU,W 24-9,24,9,15,33,CAR_HOU_2021-09-23
IND,2021-09-19,24,Sun,2,2,,LAR,L 24-27,24,27,-3,51,IND_LAR_2021-09-19
MIN,2021-09-12,24,Sun,1,1,@,CIN,L 24-27 (OT),24,27,-3,51,MIN_CIN_2021-09-12
CLE,2021-01-03,24,Sun,16,17,,PIT,W 24-22,24,22,2,46,CLE_PIT_2021-01-03
IND,2020-12-27,24,Sun,15,16,@,PIT,L 24-28,24,28,-4,52,IND_PIT_2020-12-27
GNB,2020-12-19,24,Sat,14,15,,CAR,W 24-16,24,16,8,40,GNB_CAR_2020-12-19
DET,2020-12-13,24,Sun,13,14,,GNB,L 24-31,24,31,-7,55,DET_GNB_2020-12-13
PHI,2020-12-13,24,Sun,13,14,,NOR,W 24-21,24,21,3,45,PHI_NOR_2020-12-13
LAR,2020-12-10,24,Thu,13,14,,NWE,W 24-3,24,3,21,27,LAR_NWE_2020-12-10
SFO,2020-12-07,24,Mon,12,13,,BUF,L 24-34,24,34,-10,58,SFO_BUF_2020-12-07
JAX,2020-12-06,24,Sun,12,13,@,MIN,L 24-27 (OT),24,27,-3,51,JAX_MIN_2020-12-06
TAM,2020-11-29,24,Sun,12,12,,KAN,L 24-27,24,27,-3,51,TAM_KAN_2020-11-29
TAM,2020-11-23,24,Mon,11,11,,LAR,L 24-27,24,27,-3,51,TAM_LAR_2020-11-23
NOR,2020-11-22,24,Sun,10,11,,ATL,W 24-9,24,9,15,33,NOR_ATL_2020-11-22
BAL,2020-11-22,24,Sun,10,11,,TEN,L 24-30 (OT),24,30,-6,54,BAL_TEN_2020-11-22
GNB,2020-11-15,24,Sun,9,10,,JAX,W 24-20,24,20,4,44,GNB_JAX_2020-11-15
PIT,2020-11-08,24,Sun,8,9,@,DAL,W 24-19,24,19,5,43,PIT_DAL_2020-11-08
BAL,2020-11-08,24,Sun,8,9,@,IND,W 24-10,24,10,14,34,BAL_IND_2020-11-08
TEN,2020-11-08,24,Sun,8,9,,CHI,W 24-17,24,17,7,41,TEN_CHI_2020-11-08
BUF,2020-11-01,24,Sun,8,8,,NWE,W 24-21,24,21,3,45,BUF_NWE_2020-11-01
BAL,2020-11-01,24,Sun,7,8,,PIT,L 24-28,24,28,-4,52,BAL_PIT_2020-11-01
LAR,2020-10-26,24,Mon,7,7,,CHI,W 24-10,24,10,14,34,LAR_CHI_2020-10-26
CAR,2020-10-25,24,Sun,7,7,@,NOR,L 24-27,24,27,-3,51,CAR_NOR_2020-10-25
TEN,2020-10-25,24,Sun,6,7,,PIT,L 24-27,24,27,-3,51,TEN_PIT_2020-10-25
SFO,2020-10-18,24,Sun,6,6,,LAR,W 24-16,24,16,8,40,SFO_LAR_2020-10-18
MIA,2020-10-18,24,Sun,6,6,,NYJ,W 24-0,24,0,24,24,MIA_NYJ_2020-10-18
NOR,2020-09-21,24,Mon,2,2,@,LVR,L 24-34,24,34,-10,58,NOR_LVR_2020-09-21
ARI,2020-09-13,24,Sun,1,1,@,SFO,W 24-20,24,20,4,44,ARI_SFO_2020-09-13
NWE,2019-12-29,24,Sun,16,17,,MIA,L 24-27,24,27,-3,51,NWE_MIA_2019-12-29
ARI,2019-12-29,24,Sun,16,17,@,LAR,L 24-31,24,31,-7,55,ARI_LAR_2019-12-29
ATL,2019-12-22,24,Sun,15,16,,JAX,W 24-12,24,12,12,36,ATL_JAX_2019-12-22
OAK,2019-12-22,24,Sun,15,16,@,LAC,W 24-17,24,17,7,41,OAK_LAC_2019-12-22
NWE,2019-12-21,24,Sat,15,16,,BUF,W 24-17,24,17,7,41,NWE_BUF_2019-12-21
CLE,2019-12-15,24,Sun,14,15,@,ARI,L 24-38,24,38,-14,62,CLE_ARI_2019-12-15
HOU,2019-12-15,24,Sun,14,15,@,TEN,W 24-21,24,21,3,45,HOU_TEN_2019-12-15
CAR,2019-12-15,24,Sun,14,15,,SEA,L 24-30,24,30,-6,54,CAR_SEA_2019-12-15
HOU,2019-12-08,24,Sun,13,14,,DEN,L 24-38,24,38,-14,62,HOU_DEN_2019-12-08
BAL,2019-12-08,24,Sun,13,14,@,BUF,W 24-17,24,17,7,41,BAL_BUF_2019-12-08
DAL,2019-12-05,24,Thu,13,14,@,CHI,L 24-31,24,31,-7,55,DAL_CHI_2019-12-05
CHI,2019-11-28,24,Thu,12,13,@,DET,W 24-20,24,20,4,44,CHI_DET_2019-11-28
MIA,2019-11-24,24,Sun,11,12,@,CLE,L 24-41,24,41,-17,65,MIA_CLE_2019-11-24
KAN,2019-11-18,24,Mon,11,11,@,LAC,W 24-17,24,17,7,41,KAN_LAC_2019-11-18
SFO,2019-11-11,24,Mon,9,10,,SEA,L 24-27 (OT),24,27,-3,51,SFO_SEA_2019-11-11
GNB,2019-11-10,24,Sun,10,10,,CAR,W 24-16,24,16,8,40,GNB_CAR_2019-11-10
DAL,2019-11-10,24,Sun,9,10,,MIN,L 24-28,24,28,-4,52,DAL_MIN_2019-11-10
LAC,2019-11-07,24,Thu,10,10,@,OAK,L 24-26,24,26,-2,50,LAC_OAK_2019-11-07
IND,2019-11-03,24,Sun,8,9,@,PIT,L 24-26,24,26,-2,50,IND_PIT_2019-11-03
DEN,2019-11-03,24,Sun,9,9,,CLE,W 24-19,24,19,5,43,DEN_CLE_2019-11-03
BUF,2019-11-03,24,Sun,8,9,,WAS,W 24-9,24,9,15,33,BUF_WAS_2019-11-03
DET,2019-11-03,24,Sun,8,9,@,OAK,L 24-31,24,31,-7,55,DET_OAK_2019-11-03
KAN,2019-10-27,24,Sun,8,8,,GNB,L 24-31,24,31,-7,55,KAN_GNB_2019-10-27
LAR,2019-10-27,24,Sun,8,8,,CIN,W 24-10,24,10,14,34,LAR_CIN_2019-10-27
OAK,2019-10-27,24,Sun,7,8,@,HOU,L 24-27,24,27,-3,51,OAK_HOU_2019-10-27
OAK,2019-10-20,24,Sun,6,7,@,GNB,L 24-42,24,42,-18,66,OAK_GNB_2019-10-20
KAN,2019-10-13,24,Sun,6,6,,HOU,L 24-31,24,31,-7,55,KAN_HOU_2019-10-13
NYJ,2019-10-13,24,Sun,5,6,,DAL,W 24-22,24,22,2,46,NYJ_DAL_2019-10-13
PIT,2019-10-13,24,Sun,6,6,@,LAC,W 24-17,24,17,7,41,PIT_LAC_2019-10-13
DAL,2019-10-06,24,Sun,5,5,,GNB,L 24-34,24,34,-10,58,DAL_GNB_2019-10-06
OAK,2019-10-06,24,Sun,5,5,,CHI,W 24-21,24,21,3,45,OAK_CHI_2019-10-06
TAM,2019-10-06,24,Sun,5,5,@,NOR,L 24-31,24,31,-7,55,TAM_NOR_2019-10-06
TEN,2019-09-29,24,Sun,4,4,@,ATL,W 24-10,24,10,14,34,TEN_ATL_2019-09-29
DEN,2019-09-29,24,Sun,4,4,,JAX,L 24-26,24,26,-2,50,DEN_JAX_2019-09-29
NYG,2019-09-29,24,Sun,4,4,,WAS,W 24-3,24,3,21,27,NYG_WAS_2019-09-29
IND,2019-09-29,24,Sun,4,4,,OAK,L 24-31,24,31,-7,55,IND_OAK_2019-09-29
SFO,2019-09-22,24,Sun,3,3,,PIT,W 24-20,24,20,4,44,SFO_PIT_2019-09-22
ATL,2019-09-22,24,Sun,3,3,@,IND,L 24-27,24,27,-3,51,ATL_IND_2019-09-22
PHI,2019-09-22,24,Sun,3,3,,DET,L 24-27,24,27,-3,51,PHI_DET_2019-09-22
ATL,2019-09-15,24,Sun,2,2,,PHI,W 24-20,24,20,4,44,ATL_PHI_2019-09-15
OAK,2019-09-09,24,Mon,1,1,,DEN,W 24-16,24,16,8,40,OAK_DEN_2019-09-09
IND,2019-09-08,24,Sun,1,1,@,LAC,L 24-30 (OT),24,30,-6,54,IND_LAC_2019-09-08
PHI,2018-12-30,24,Sun,16,17,@,WAS,W 24-0,24,0,24,24,PHI_WAS_2018-12-30
CLE,2018-12-30,24,Sun,16,17,@,BAL,L 24-26,24,26,-2,50,CLE_BAL_2018-12-30
CHI,2018-12-30,24,Sun,16,17,@,MIN,W 24-10,24,10,14,34,CHI_MIN_2018-12-30
ARI,2018-12-30,24,Sun,16,17,@,SEA,L 24-27,24,27,-3,51,ARI_SEA_2018-12-30
NWE,2018-12-23,24,Sun,15,16,,BUF,W 24-12,24,12,12,36,NWE_BUF_2018-12-23
ATL,2018-12-23,24,Sun,15,16,@,CAR,W 24-10,24,10,14,34,ATL_CAR_2018-12-23
CHI,2018-12-16,24,Sun,14,15,,GNB,W 24-17,24,17,7,41,CHI_GNB_2018-12-16
OAK,2018-12-09,24,Sun,13,14,,PIT,W 24-21,24,21,3,45,OAK_PIT_2018-12-09
IND,2018-12-09,24,Sun,13,14,@,HOU,W 24-21,24,21,3,45,IND_HOU_2018-12-09
BAL,2018-12-09,24,Sun,13,14,@,KAN,L 24-27 (OT),24,27,-3,51,BAL_KAN_2018-12-09
NWE,2018-12-02,24,Sun,12,13,,MIN,W 24-10,24,10,14,34,NWE_MIN_2018-12-02
DEN,2018-12-02,24,Sun,12,13,@,CIN,W 24-10,24,10,14,34,DEN_CIN_2018-12-02
TAM,2018-12-02,24,Sun,12,13,,CAR,W 24-17,24,17,7,41,TAM_CAR_2018-12-02
MIA,2018-11-25,24,Sun,11,12,@,IND,L 24-27,24,27,-3,51,MIA_IND_2018-11-25
MIN,2018-11-25,24,Sun,11,12,,GNB,W 24-17,24,17,7,41,MIN_GNB_2018-11-25
DEN,2018-11-25,24,Sun,11,12,,PIT,W 24-17,24,17,7,41,DEN_PIT_2018-11-25
BUF,2018-11-25,24,Sun,11,12,,JAX,W 24-21,24,21,3,45,BUF_JAX_2018-11-25
BAL,2018-11-18,24,Sun,10,11,,CIN,W 24-21,24,21,3,45,BAL_CIN_2018-11-18
GNB,2018-11-15,24,Thu,10,11,@,SEA,L 24-27,24,27,-3,51,GNB_SEA_2018-11-15
MIN,2018-11-04,24,Sun,9,9,,DET,W 24-9,24,9,15,33,MIN_DET_2018-11-04
CHI,2018-10-28,24,Sun,7,8,,NYJ,W 24-10,24,10,14,34,CHI_NYJ_2018-10-28
PHI,2018-10-28,24,Sun,8,8,@,JAX,W 24-18,24,18,6,42,PHI_JAX_2018-10-28
NOR,2018-10-21,24,Sun,6,7,@,BAL,W 24-23,24,23,1,47,NOR_BAL_2018-10-21
IND,2018-10-04,24,Thu,5,5,@,NWE,L 24-38,24,38,-14,62,IND_NWE_2018-10-04
DET,2018-09-30,24,Sun,4,4,@,DAL,L 24-26,24,26,-2,50,DET_DAL_2018-09-30
SEA,2018-09-23,24,Sun,3,3,,DAL,W 24-13,24,13,11,37,SEA_DAL_2018-09-23
CHI,2018-09-17,24,Mon,2,2,,SEA,W 24-17,24,17,7,41,CHI_SEA_2018-09-17
CAR,2018-09-16,24,Sun,2,2,@,ATL,L 24-31,24,31,-7,55,CAR_ATL_2018-09-16
SEA,2018-09-09,24,Sun,1,1,@,DEN,L 24-27,24,27,-3,51,SEA_DEN_2018-09-09
MIN,2018-09-09,24,Sun,1,1,,SFO,W 24-16,24,16,8,40,MIN_SFO_2018-09-09
WAS,2018-09-09,24,Sun,1,1,@,ARI,W 24-6,24,6,18,30,WAS_ARI_2018-09-09
GNB,2018-09-09,24,Sun,1,1,,CHI,W 24-23,24,23,1,47,GNB_CHI_2018-09-09
CLE,2017-12-31,24,Sun,16,17,@,PIT,L 24-28,24,28,-4,52,CLE_PIT_2017-12-31
DEN,2017-12-31,24,Sun,16,17,,KAN,L 24-27,24,27,-3,51,DEN_KAN_2017-12-31
NOR,2017-12-31,24,Sun,16,17,@,TAM,L 24-31,24,31,-7,55,NOR_TAM_2017-12-31
SEA,2017-12-31,24,Sun,16,17,,ARI,L 24-26,24,26,-2,50,SEA_ARI_2017-12-31
ATL,2017-12-18,24,Mon,14,15,@,TAM,W 24-21,24,21,3,45,ATL_TAM_2017-12-18
PIT,2017-12-17,24,Sun,14,15,,NWE,L 24-27,24,27,-3,51,PIT_NWE_2017-12-17
GNB,2017-12-17,24,Sun,14,15,@,CAR,L 24-31,24,31,-7,55,GNB_CAR_2017-12-17
BUF,2017-12-17,24,Sun,14,15,,MIA,W 24-16,24,16,8,40,BUF_MIA_2017-12-17
MIN,2017-12-10,24,Sun,13,14,@,CAR,L 24-31,24,31,-7,55,MIN_CAR_2017-12-10
SEA,2017-12-10,24,Sun,13,14,@,JAX,L 24-30,24,30,-6,54,SEA_JAX_2017-12-10
DET,2017-12-10,24,Sun,13,14,@,TAM,W 24-21,24,21,3,45,DET_TAM_2017-12-10
TEN,2017-12-03,24,Sun,12,13,,HOU,W 24-13,24,13,11,37,TEN_HOU_2017-12-03
OAK,2017-12-03,24,Sun,12,13,,NYG,W 24-17,24,17,7,41,OAK_NYG_2017-12-03
SEA,2017-12-03,24,Sun,12,13,,PHI,W 24-10,24,10,14,34,SEA_PHI_2017-12-03
SEA,2017-11-26,24,Sun,11,12,@,SFO,W 24-13,24,13,11,37,SEA_SFO_2017-11-26
JAX,2017-11-26,24,Sun,11,12,@,ARI,L 24-27,24,27,-3,51,JAX_ARI_2017-11-26
MIN,2017-11-19,24,Sun,10,11,,LAR,W 24-7,24,7,17,31,MIN_LAR_2017-11-19
CHI,2017-11-19,24,Sun,10,11,,DET,L 24-27,24,27,-3,51,CHI_DET_2017-11-19
BUF,2017-11-19,24,Sun,10,11,@,LAC,L 24-54,24,54,-30,78,BUF_LAC_2017-11-19
TEN,2017-11-12,24,Sun,9,10,,CIN,W 24-20,24,20,4,44,TEN_CIN_2017-11-12
CLE,2017-11-12,24,Sun,9,10,@,DET,L 24-38,24,38,-14,62,CLE_DET_2017-11-12
MIA,2017-11-05,24,Sun,8,9,,OAK,L 24-27,24,27,-3,51,MIA_OAK_2017-11-05
CIN,2017-10-29,24,Sun,7,8,,IND,W 24-23,24,23,1,47,CIN_IND_2017-10-29
WAS,2017-10-23,24,Mon,6,7,@,PHI,L 24-34,24,34,-10,58,WAS_PHI_2017-10-23
SEA,2017-10-22,24,Sun,6,7,@,NYG,W 24-7,24,7,17,31,SEA_NYG_2017-10-22
MIN,2017-10-22,24,Sun,7,7,,BAL,W 24-16,24,16,8,40,MIN_BAL_2017-10-22
SFO,2017-10-15,24,Sun,6,6,@,WAS,L 24-26,24,26,-2,50,SFO_WAS_2017-10-15
NWE,2017-10-15,24,Sun,6,6,@,NYJ,W 24-17,24,17,7,41,NWE_NYJ_2017-10-15
BAL,2017-10-15,24,Sun,6,6,,CHI,L 24-27 (OT),24,27,-3,51,BAL_CHI_2017-10-15
DET,2017-10-08,24,Sun,5,5,,CAR,L 24-27,24,27,-3,51,DET_CAR_2017-10-08
LAC,2017-10-01,24,Sun,4,4,,PHI,L 24-26,24,26,-2,50,LAC_PHI_2017-10-01
KAN,2017-09-24,24,Sun,3,3,@,LAC,W 24-10,24,10,14,34,KAN_LAC_2017-09-24
NYG,2017-09-24,24,Sun,3,3,@,PHI,L 24-27,24,27,-3,51,NYG_PHI_2017-09-24
CIN,2017-09-24,24,Sun,3,3,@,GNB,L 24-27 (OT),24,27,-3,51,CIN_GNB_2017-09-24
DET,2017-09-18,24,Mon,2,2,@,NYG,W 24-10,24,10,14,34,DET_NYG_2017-09-18
BAL,2017-09-17,24,Sun,2,2,,CLE,W 24-10,24,10,14,34,BAL_CLE_2017-09-17
DEN,2017-09-11,24,Mon,1,1,,LAC,W 24-21,24,21,3,45,DEN_LAC_2017-09-11
NWE,2023-01-08,23,Sun,17,18,@,BUF,L 23-35,23,35,-12,58,NWE_BUF_2023-01-08
NWE,2023-01-01,23,Sun,16,17,,MIA,W 23-21,23,21,2,44,NWE_MIA_2023-01-01
SEA,2023-01-01,23,Sun,16,17,,NYJ,W 23-6,23,6,17,29,SEA_NYJ_2023-01-01
DET,2022-12-24,23,Sat,15,16,@,CAR,L 23-37,23,37,-14,60,DET_CAR_2022-12-24
TAM,2022-12-18,23,Sun,14,15,,CIN,L 23-34,23,34,-11,57,TAM_CIN_2022-12-18
LAC,2022-12-11,23,Sun,13,14,,MIA,W 23-17,23,17,6,40,LAC_MIA_2022-12-11
CIN,2022-12-11,23,Sun,13,14,,CLE,W 23-10,23,10,13,33,CIN_CLE_2022-12-11
HOU,2022-12-11,23,Sun,13,14,@,DAL,L 23-27,23,27,-4,50,HOU_DAL_2022-12-11
MIN,2022-12-11,23,Sun,13,14,@,DET,L 23-34,23,34,-11,57,MIN_DET_2022-12-11
LAR,2022-12-04,23,Sun,12,13,,SEA,L 23-27,23,27,-4,50,LAR_SEA_2022-12-04
CLE,2022-11-27,23,Sun,11,12,,TAM,W 23-17 (OT),23,17,6,40,CLE_TAM_2022-11-27
CAR,2022-11-27,23,Sun,12,12,,DEN,W 23-10,23,10,13,33,CAR_DEN_2022-11-27
CLE,2022-11-20,23,Sun,10,11,@,BUF,L 23-31,23,31,-8,54,CLE_BUF_2022-11-20
WAS,2022-11-20,23,Sun,11,11,@,HOU,W 23-10,23,10,13,33,WAS_HOU_2022-11-20
WAS,2022-10-23,23,Sun,7,7,,GNB,W 23-21,23,21,2,44,WAS_GNB_2022-10-23
LAC,2022-10-23,23,Sun,7,7,,SEA,L 23-37,23,37,-14,60,LAC_SEA_2022-10-23
BAL,2022-10-23,23,Sun,7,7,,CLE,W 23-20,23,20,3,43,BAL_CLE_2022-10-23
NYG,2022-10-23,23,Sun,7,7,@,JAX,W 23-17,23,17,6,40,NYG_JAX_2022-10-23
SFO,2022-10-23,23,Sun,7,7,,KAN,L 23-44,23,44,-21,67,SFO_KAN_2022-10-23
ATL,2022-10-02,23,Sun,4,4,,CLE,W 23-20,23,20,3,43,ATL_CLE_2022-10-02
BUF,2022-10-02,23,Sun,4,4,@,BAL,W 23-20,23,20,3,43,BUF_BAL_2022-10-02
DEN,2022-10-02,23,Sun,4,4,@,LVR,L 23-32,23,32,-9,55,DEN_LVR_2022-10-02
DAL,2022-09-26,23,Mon,3,3,@,NYG,W 23-16,23,16,7,39,DAL_NYG_2022-09-26
SEA,2022-09-25,23,Sun,3,3,,ATL,L 23-27,23,27,-4,50,SEA_ATL_2022-09-25
CHI,2022-09-25,23,Sun,3,3,,HOU,W 23-20,23,20,3,43,CHI_HOU_2022-09-25
LVR,2022-09-18,23,Sun,2,2,,ARI,L 23-29 (OT),23,29,-6,52,LVR_ARI_2022-09-18
MIN,2022-09-11,23,Sun,1,1,,GNB,W 23-7,23,7,16,30,MIN_GNB_2022-09-11
PIT,2022-09-11,23,Sun,1,1,@,CIN,W 23-20 (OT),23,20,3,43,PIT_CIN_2022-09-11
LVR,2022-01-02,23,Sun,16,17,@,IND,W 23-20,23,20,3,43,LVR_IND_2022-01-02
SFO,2022-01-02,23,Sun,16,17,,HOU,W 23-7,23,7,16,30,SFO_HOU_2022-01-02
MIN,2021-12-26,23,Sun,15,16,,LAR,L 23-30,23,30,-7,53,MIN_LAR_2021-12-26
ARI,2021-12-13,23,Mon,13,14,,LAR,L 23-30,23,30,-7,53,ARI_LAR_2021-12-13
CIN,2021-12-12,23,Sun,13,14,,SFO,L 23-26 (OT),23,26,-3,49,CIN_SFO_2021-12-12
SFO,2021-12-05,23,Sun,12,13,@,SEA,L 23-30,23,30,-7,53,SFO_SEA_2021-12-05
ARI,2021-11-21,23,Sun,11,11,@,SEA,W 23-13,23,13,10,36,ARI_SEA_2021-11-21
TEN,2021-11-14,23,Sun,10,10,,NOR,W 23-21,23,21,2,44,TEN_NOR_2021-11-14
IND,2021-11-14,23,Sun,10,10,,JAX,W 23-17,23,17,6,40,IND_JAX_2021-11-14
NYG,2021-11-07,23,Sun,9,9,,LVR,W 23-16,23,16,7,39,NYG_LVR_2021-11-07
JAX,2021-10-17,23,Sun,6,6,,MIA,W 23-20,23,20,3,43,JAX_MIA_2021-10-17
PIT,2021-10-17,23,Sun,6,6,,SEA,W 23-20 (OT),23,20,3,43,PIT_SEA_2021-10-17
BAL,2021-10-03,23,Sun,4,4,@,DEN,W 23-7,23,7,16,30,BAL_DEN_2021-10-03
DEN,2021-09-19,23,Sun,2,2,@,JAX,W 23-13,23,13,10,36,DEN_JAX_2021-09-19
PIT,2021-09-12,23,Sun,1,1,@,BUF,W 23-16,23,16,7,39,PIT_BUF_2021-09-12
NYG,2021-01-03,23,Sun,16,17,,DAL,W 23-19,23,19,4,42,NYG_DAL_2021-01-03
SFO,2021-01-03,23,Sun,16,17,,SEA,L 23-26,23,26,-3,49,SFO_SEA_2021-01-03
NYJ,2020-12-27,23,Sun,15,16,,CLE,W 23-16,23,16,7,39,NYJ_CLE_2020-12-27
NYJ,2020-12-20,23,Sun,14,15,@,LAR,W 23-20,23,20,3,43,NYJ_LAR_2020-12-20
WAS,2020-12-13,23,Sun,13,14,@,SFO,W 23-15,23,15,8,38,WAS_SFO_2020-12-13
WAS,2020-12-07,23,Mon,12,13,@,PIT,W 23-17,23,17,6,40,WAS_PIT_2020-12-07
SEA,2020-11-30,23,Mon,11,12,@,PHI,W 23-17,23,17,6,40,SEA_PHI_2020-11-30
SFO,2020-11-29,23,Sun,11,12,@,LAR,W 23-20,23,20,3,43,SFO_LAR_2020-11-29
LAR,2020-11-15,23,Sun,9,10,,SEA,W 23-16,23,16,7,39,LAR_SEA_2020-11-15
NWE,2020-11-15,23,Sun,9,10,,BAL,W 23-17,23,17,6,40,NWE_BAL_2020-11-15
CAR,2020-11-15,23,Sun,10,10,,TAM,L 23-46,23,46,-23,69,CAR_TAM_2020-11-15
NYG,2020-11-08,23,Sun,9,9,@,WAS,W 23-20,23,20,3,43,NYG_WAS_2020-11-08
NYG,2020-11-02,23,Mon,8,8,,TAM,L 23-25,23,25,-2,48,NYG_TAM_2020-11-02
PHI,2020-11-01,23,Sun,8,8,,DAL,W 23-9,23,9,14,32,PHI_DAL_2020-11-01
CHI,2020-11-01,23,Sun,8,8,,NOR,L 23-26 (OT),23,26,-3,49,CHI_NOR_2020-11-01
DET,2020-10-25,23,Sun,6,7,@,ATL,W 23-22,23,22,1,45,DET_ATL_2020-10-25
MIN,2020-10-18,23,Sun,6,6,,ATL,L 23-40,23,40,-17,63,MIN_ATL_2020-10-18
CHI,2020-10-18,23,Sun,6,6,@,CAR,W 23-16,23,16,7,39,CHI_CAR_2020-10-18
CAR,2020-10-11,23,Sun,5,5,@,ATL,W 23-16,23,16,7,39,CAR_ATL_2020-10-11
IND,2020-10-11,23,Sun,5,5,@,CLE,L 23-32,23,32,-9,55,IND_CLE_2020-10-11
HOU,2020-10-04,23,Sun,4,4,,MIN,L 23-31,23,31,-8,54,HOU_MIN_2020-10-04
LVR,2020-10-04,23,Sun,4,4,,BUF,L 23-30,23,30,-7,53,LVR_BUF_2020-10-04
MIA,2020-10-04,23,Sun,4,4,,SEA,L 23-31,23,31,-8,54,MIA_SEA_2020-10-04
ARI,2020-09-27,23,Sun,3,3,,DET,L 23-26,23,26,-3,49,ARI_DET_2020-09-27
CIN,2020-09-27,23,Sun,3,3,@,PHI,T 23-23 (OT),23,23,0,46,CIN_PHI_2020-09-27
PHI,2020-09-27,23,Sun,3,3,,CIN,T 23-23 (OT),23,23,0,46,PHI_CIN_2020-09-27
KAN,2020-09-20,23,Sun,2,2,@,LAC,W 23-20 (OT),23,20,3,43,KAN_LAC_2020-09-20
DET,2020-09-13,23,Sun,1,1,,CHI,L 23-27,23,27,-4,50,DET_CHI_2020-09-13
TAM,2020-09-13,23,Sun,1,1,@,NOR,L 23-34,23,34,-11,57,TAM_NOR_2020-09-13
CLE,2019-12-29,23,Sun,16,17,@,CIN,L 23-33,23,33,-10,56,CLE_CIN_2019-12-29
GNB,2019-12-29,23,Sun,16,17,@,DET,W 23-20,23,20,3,43,GNB_DET_2019-12-29
GNB,2019-12-23,23,Mon,15,16,@,MIN,W 23-10,23,10,13,33,GNB_MIN_2019-12-23
HOU,2019-12-21,23,Sat,15,16,@,TAM,W 23-20,23,20,3,43,HOU_TAM_2019-12-21
KAN,2019-12-15,23,Sun,14,15,,DEN,W 23-3,23,3,20,26,KAN_DEN_2019-12-15
PHI,2019-12-09,23,Mon,13,14,,NYG,W 23-17 (OT),23,17,6,40,PHI_NYG_2019-12-09
PIT,2019-12-08,23,Sun,13,14,@,ARI,W 23-17,23,17,6,40,PIT_ARI_2019-12-08
KAN,2019-12-08,23,Sun,13,14,@,NWE,W 23-16,23,16,7,39,KAN_NWE_2019-12-08
DEN,2019-12-01,23,Sun,12,13,,LAC,W 23-20,23,20,3,43,DEN_LAC_2019-12-01
DEN,2019-11-17,23,Sun,10,11,@,MIN,L 23-27,23,27,-4,50,DEN_MIN_2019-11-17
MIN,2019-11-03,23,Sun,9,9,@,KAN,L 23-26,23,26,-3,49,MIN_KAN_2019-11-03
TAM,2019-10-27,23,Sun,7,8,@,TEN,L 23-27,23,27,-4,50,TAM_TEN_2019-10-27
HOU,2019-10-20,23,Sun,7,7,@,IND,L 23-30,23,30,-7,53,HOU_IND_2019-10-20
TEN,2019-10-20,23,Sun,7,7,,LAC,W 23-20,23,20,3,43,TEN_LAC_2019-10-20
GNB,2019-10-14,23,Mon,6,6,,DET,W 23-22,23,22,1,45,GNB_DET_2019-10-14
BAL,2019-10-13,23,Sun,6,6,,CIN,W 23-17,23,17,6,40,BAL_CIN_2019-10-13
CIN,2019-10-06,23,Sun,5,5,,ARI,L 23-26,23,26,-3,49,CIN_ARI_2019-10-06
PIT,2019-10-06,23,Sun,5,5,,BAL,L 23-26 (OT),23,26,-3,49,PIT_BAL_2019-10-06
CLE,2019-09-16,23,Mon,2,2,@,NYJ,W 23-3,23,3,20,26,CLE_NYJ_2019-09-16
BAL,2019-09-15,23,Sun,2,2,,ARI,W 23-17,23,17,6,40,BAL_ARI_2019-09-15
LAC,2018-12-30,23,Sun,16,17,@,DEN,W 23-9,23,9,14,32,LAC_DEN_2018-12-30
LAR,2018-12-16,23,Sun,14,15,,PHI,L 23-30,23,30,-7,53,LAR_PHI_2018-12-16
SEA,2018-12-16,23,Sun,14,15,@,SFO,L 23-26 (OT),23,26,-3,49,SEA_SFO_2018-12-16
IND,2018-12-16,23,Sun,14,15,,DAL,W 23-0,23,0,23,23,IND_DAL_2018-12-16
BUF,2018-12-09,23,Sun,13,14,,NYJ,L 23-27,23,27,-4,50,BUF_NYJ_2018-12-09
PHI,2018-12-09,23,Sun,13,14,@,DAL,L 23-29 (OT),23,29,-6,52,PHI_DAL_2018-12-09
CHI,2018-11-22,23,Thu,11,12,@,DET,W 23-16,23,16,7,39,CHI_DET_2018-11-22
WAS,2018-11-22,23,Thu,11,12,@,DAL,L 23-31,23,31,-8,54,WAS_DAL_2018-11-22
HOU,2018-11-18,23,Sun,10,11,@,WAS,W 23-21,23,21,2,44,HOU_WAS_2018-11-18
DEN,2018-11-18,23,Sun,10,11,@,LAC,W 23-22,23,22,1,45,DEN_LAC_2018-11-18
OAK,2018-11-18,23,Sun,10,11,@,ARI,W 23-21,23,21,2,44,OAK_ARI_2018-11-18
SFO,2018-11-12,23,Mon,10,10,,NYG,L 23-27,23,27,-4,50,SFO_NYG_2018-11-12
PIT,2018-11-04,23,Sun,8,9,@,BAL,W 23-16,23,16,7,39,PIT_BAL_2018-11-04
DEN,2018-10-28,23,Sun,8,8,@,KAN,L 23-30,23,30,-7,53,DEN_KAN_2018-10-28
MIA,2018-10-25,23,Thu,8,8,@,HOU,L 23-42,23,42,-19,65,MIA_HOU_2018-10-25
ATL,2018-10-22,23,Mon,7,7,,NYG,W 23-20,23,20,3,43,ATL_NYG_2018-10-22
CLE,2018-10-21,23,Sun,7,7,@,TAM,L 23-26 (OT),23,26,-3,49,CLE_TAM_2018-10-21
BAL,2018-10-21,23,Sun,7,7,,NOR,L 23-24,23,24,-1,47,BAL_NOR_2018-10-21
LAR,2018-10-14,23,Sun,6,6,@,DEN,W 23-20,23,20,3,43,LAR_DEN_2018-10-14
WAS,2018-10-14,23,Sun,5,6,,CAR,W 23-17,23,17,6,40,WAS_CAR_2018-10-14
GNB,2018-10-07,23,Sun,5,5,@,DET,L 23-31,23,31,-8,54,GNB_DET_2018-10-07
MIN,2018-10-07,23,Sun,5,5,@,PHI,W 23-21,23,21,2,44,MIN_PHI_2018-10-07
DEN,2018-10-01,23,Mon,4,4,,KAN,L 23-27,23,27,-4,50,DEN_KAN_2018-10-01
PHI,2018-09-30,23,Sun,4,4,@,TEN,L 23-26 (OT),23,26,-3,49,PHI_TEN_2018-09-30
LAC,2018-09-23,23,Sun,3,3,@,LAR,L 23-35,23,35,-12,58,LAC_LAR_2018-09-23
BAL,2018-09-13,23,Thu,2,2,@,CIN,L 23-34,23,34,-11,57,BAL_CIN_2018-09-13
CHI,2018-09-09,23,Sun,1,1,@,GNB,L 23-24,23,24,-1,47,CHI_GNB_2018-09-09
IND,2018-09-09,23,Sun,1,1,,CIN,L 23-34,23,34,-11,57,IND_CIN_2018-09-09
MIN,2017-12-31,23,Sun,16,17,,CHI,W 23-10,23,10,13,33,MIN_CHI_2017-12-31
TEN,2017-12-24,23,Sun,15,16,,LAR,L 23-27,23,27,-4,50,TEN_LAR_2017-12-24
ARI,2017-12-24,23,Sun,15,16,,NYG,W 23-0,23,0,23,23,ARI_NYG_2017-12-24
TEN,2017-12-24,23,Sun,15,16,,LAR,L 23-27,23,27,-4,50,TEN_LAR_2017-12-24
BAL,2017-12-23,23,Sat,15,16,,IND,W 23-16,23,16,7,39,BAL_IND_2017-12-23
TEN,2017-12-17,23,Sun,14,15,@,SFO,L 23-25,23,25,-2,48,TEN_SFO_2017-12-17
DEN,2017-12-10,23,Sun,13,14,,NYJ,W 23-0,23,0,23,23,DEN_NYJ_2017-12-10
PIT,2017-12-04,23,Mon,12,13,@,CIN,W 23-20,23,20,3,43,PIT_CIN_2017-12-04
NWE,2017-12-03,23,Sun,12,13,@,BUF,W 23-3,23,3,20,26,NWE_BUF_2017-12-03
BAL,2017-11-27,23,Mon,11,12,,HOU,W 23-16,23,16,7,39,BAL_HOU_2017-11-27
DET,2017-11-23,23,Thu,11,12,,MIN,L 23-30,23,30,-7,53,DET_MIN_2017-11-23
BAL,2017-11-19,23,Sun,10,11,@,GNB,W 23-0,23,0,23,23,BAL_GNB_2017-11-19
GNB,2017-11-12,23,Sun,9,10,@,CHI,W 23-16,23,16,7,39,GNB_CHI_2017-11-12
JAX,2017-11-05,23,Sun,8,9,,CIN,W 23-7,23,7,16,30,JAX_CIN_2017-11-05
DEN,2017-11-05,23,Sun,8,9,@,PHI,L 23-51,23,51,-28,74,DEN_PHI_2017-11-05
TEN,2017-11-05,23,Sun,8,9,,BAL,W 23-20,23,20,3,43,TEN_BAL_2017-11-05
IND,2017-10-29,23,Sun,8,8,@,CIN,L 23-24,23,24,-1,47,IND_CIN_2017-10-29
NWE,2017-10-22,23,Sun,7,7,,ATL,W 23-7,23,7,16,30,NWE_ATL_2017-10-22
NYG,2017-10-15,23,Sun,6,6,@,DEN,W 23-10,23,10,13,33,NYG_DEN_2017-10-15
MIN,2017-10-15,23,Sun,6,6,,GNB,W 23-10,23,10,13,33,MIN_GNB_2017-10-15
CAR,2017-10-12,23,Thu,6,6,,PHI,L 23-28,23,28,-5,51,CAR_PHI_2017-10-12
SFO,2017-10-08,23,Sun,5,5,@,IND,L 23-26 (OT),23,26,-3,49,SFO_IND_2017-10-08
BUF,2017-10-01,23,Sun,4,4,@,ATL,W 23-17,23,17,6,40,BUF_ATL_2017-10-01
NYJ,2017-10-01,23,Sun,4,4,,JAX,W 23-20 (OT),23,20,3,43,NYJ_JAX_2017-10-01
NYG,2017-10-01,23,Sun,4,4,@,TAM,L 23-25,23,25,-2,48,NYG_TAM_2017-10-01
CHI,2017-09-24,23,Sun,3,3,,PIT,W 23-17 (OT),23,17,6,40,CHI_PIT_2017-09-24
GNB,2017-09-17,23,Sun,2,2,@,ATL,L 23-34,23,34,-11,57,GNB_ATL_2017-09-17
ATL,2017-09-10,23,Sun,1,1,@,CHI,W 23-17,23,17,6,40,ATL_CHI_2017-09-10
ARI,2017-09-10,23,Sun,1,1,@,DET,L 23-35,23,35,-12,58,ARI_DET_2017-09-10
CAR,2017-09-10,23,Sun,1,1,@,SFO,W 23-3,23,3,20,26,CAR_SFO_2017-09-10
PHI,2023-01-08,22,Sun,17,18,,NYG,W 22-16,22,16,6,38,PHI_NYG_2023-01-08
CIN,2022-12-24,22,Sat,15,16,@,NWE,W 22-18,22,18,4,40,CIN_NWE_2022-12-24
TEN,2022-12-11,22,Sun,13,14,,JAX,L 22-36,22,36,-14,58,TEN_JAX_2022-12-11
NYG,2022-12-11,22,Sun,13,14,,PHI,L 22-48,22,48,-26,70,NYG_PHI_2022-12-11
NYJ,2022-12-04,22,Sun,12,13,@,MIN,L 22-27,22,27,-5,49,NYJ_MIN_2022-12-04
LVR,2022-11-20,22,Sun,10,11,@,DEN,W 22-16 (OT),22,16,6,38,LVR_DEN_2022-11-20
SFO,2022-11-13,22,Sun,9,10,,LAC,W 22-16,22,16,6,38,SFO_LAC_2022-11-13
NWE,2022-10-30,22,Sun,8,8,@,NYJ,W 22-17,22,17,5,39,NWE_NYJ_2022-10-30
TAM,2022-10-27,22,Thu,8,8,,BAL,L 22-27,22,27,-5,49,TAM_BAL_2022-10-27
CHI,2022-10-09,22,Sun,5,5,@,MIN,L 22-29,22,29,-7,51,CHI_MIN_2022-10-09
GNB,2022-10-09,22,Sun,5,5,,NYG,L 22-27,22,27,-5,49,GNB_NYG_2022-10-09
DAL,2022-10-09,22,Sun,5,5,@,LAR,W 22-10,22,10,12,32,DAL_LAR_2022-10-09
CAR,2022-09-25,22,Sun,3,3,,NOR,W 22-14,22,14,8,36,CAR_NOR_2022-09-25
LVR,2022-09-25,22,Sun,3,3,@,TEN,L 22-24,22,24,-2,46,LVR_TEN_2022-09-25
JAX,2022-09-11,22,Sun,1,1,@,WAS,L 22-28,22,28,-6,50,JAX_WAS_2022-09-11
WAS,2022-01-09,22,Sun,17,18,@,NYG,W 22-7,22,7,15,29,WAS_NYG_2022-01-09
DAL,2022-01-02,22,Sun,16,17,,ARI,L 22-25,22,25,-3,47,DAL_ARI_2022-01-02
IND,2021-12-25,22,Sat,15,16,@,ARI,W 22-16,22,16,6,38,IND_ARI_2021-12-25
CLE,2021-12-25,22,Sat,15,16,@,GNB,L 22-24,22,24,-2,46,CLE_GNB_2021-12-25
BAL,2021-12-12,22,Sun,13,14,@,CLE,L 22-24,22,24,-2,46,BAL_CLE_2021-12-12
CHI,2021-12-05,22,Sun,12,13,,ARI,L 22-33,22,33,-11,55,CHI_ARI_2021-12-05
KAN,2021-12-05,22,Sun,12,13,,DEN,W 22-9,22,9,13,31,KAN_DEN_2021-12-05
CIN,2021-12-05,22,Sun,12,13,,LAC,L 22-41,22,41,-19,63,CIN_LAC_2021-12-05
HOU,2021-11-21,22,Sun,10,11,@,TEN,W 22-13,22,13,9,35,HOU_TEN_2021-11-21
MIA,2021-11-11,22,Thu,10,10,,BAL,W 22-10,22,10,12,32,MIA_BAL_2021-11-11
HOU,2021-10-31,22,Sun,8,8,,LAR,L 22-38,22,38,-16,60,HOU_LAR_2021-10-31
CHI,2021-10-31,22,Sun,8,8,,SFO,L 22-33,22,33,-11,55,CHI_SFO_2021-10-31
PHI,2021-10-24,22,Sun,7,7,@,LVR,L 22-33,22,33,-11,55,PHI_LVR_2021-10-24
PHI,2021-10-14,22,Thu,6,6,,TAM,L 22-28,22,28,-6,50,PHI_TAM_2021-10-14
CIN,2021-10-10,22,Sun,5,5,,GNB,L 22-25 (OT),22,25,-3,47,CIN_GNB_2021-10-10
WAS,2021-10-10,22,Sun,5,5,,NOR,L 22-33,22,33,-11,55,WAS_NOR_2021-10-10
HOU,2021-10-10,22,Sun,5,5,,NWE,L 22-25,22,25,-3,47,HOU_NWE_2021-10-10
PIT,2021-01-03,22,Sun,16,17,@,CLE,L 22-24,22,24,-2,46,PIT_CLE_2021-01-03
MIA,2020-12-20,22,Sun,14,15,,NWE,W 22-12,22,12,10,34,MIA_NWE_2020-12-20
KAN,2020-12-06,22,Sun,12,13,,DEN,W 22-16,22,16,6,38,KAN_DEN_2020-12-06
CLE,2020-11-22,22,Sun,10,11,,PHI,W 22-17,22,17,5,39,CLE_PHI_2020-11-22
GNB,2020-11-01,22,Sun,7,8,,MIN,L 22-28,22,28,-6,50,GNB_MIN_2020-11-01
ATL,2020-10-25,22,Sun,7,7,,DET,L 22-23,22,23,-1,45,ATL_DET_2020-10-25
PHI,2020-10-22,22,Thu,7,7,,NYG,W 22-21,22,21,1,43,PHI_NYG_2020-10-22
TAM,2019-12-29,22,Sun,16,17,,ATL,L 22-28 (OT),22,28,-6,50,TAM_ATL_2019-12-29
SFO,2019-12-15,22,Sun,14,15,,ATL,L 22-29,22,29,-7,51,SFO_ATL_2019-12-15
NYJ,2019-12-08,22,Sun,13,14,,MIA,W 22-21,22,21,1,43,NYJ_MIA_2019-12-08
NWE,2019-12-01,22,Sun,12,13,@,HOU,L 22-28,22,28,-6,50,NWE_HOU_2019-12-01
CIN,2019-12-01,22,Sun,12,13,,NYJ,W 22-6,22,6,16,28,CIN_NYJ_2019-12-01
ATL,2019-11-24,22,Sun,11,12,,TAM,L 22-35,22,35,-13,57,ATL_TAM_2019-11-24
PHI,2019-11-03,22,Sun,9,9,,CHI,W 22-14,22,14,8,36,PHI_CHI_2019-11-03
DET,2019-10-14,22,Mon,5,6,@,GNB,L 22-23,22,23,-1,45,DET_GNB_2019-10-14
DAL,2019-10-13,22,Sun,6,6,@,NYJ,L 22-24,22,24,-2,46,DAL_NYJ_2019-10-13
BAL,2018-12-22,22,Sat,15,16,@,LAC,W 22-10,22,10,12,32,BAL_LAC_2018-12-22
NYJ,2018-12-15,22,Sat,14,15,,HOU,L 22-29,22,29,-7,51,NYJ_HOU_2018-12-15
NYJ,2018-12-02,22,Sun,12,13,@,TEN,L 22-26,22,26,-4,48,NYJ_TEN_2018-12-02
NYG,2018-11-25,22,Sun,11,12,@,PHI,L 22-25,22,25,-3,47,NYG_PHI_2018-11-25
DAL,2018-11-18,22,Sun,10,11,@,ATL,W 22-19,22,19,3,41,DAL_ATL_2018-11-18
LAC,2018-11-18,22,Sun,10,11,,DEN,L 22-23,22,23,-1,45,LAC_DEN_2018-11-18
DET,2018-11-11,22,Sun,9,10,@,CHI,L 22-34,22,34,-12,56,DET_CHI_2018-11-11
GNB,2018-09-30,22,Sun,4,4,,BUF,W 22-0,22,0,22,22,GNB_BUF_2018-09-30
HOU,2018-09-23,22,Sun,3,3,,NYG,L 22-27,22,27,-5,49,HOU_NYG_2018-09-23
ATL,2017-12-31,22,Sun,16,17,,CAR,W 22-10,22,10,12,32,ATL_CAR_2017-12-31
IND,2017-12-31,22,Sun,16,17,,HOU,W 22-13,22,13,9,35,IND_HOU_2017-12-31
BUF,2017-12-31,22,Sun,16,17,@,MIA,W 22-16,22,16,6,38,BUF_MIA_2017-12-31
CAR,2017-12-24,22,Sun,15,16,,TAM,W 22-19,22,19,3,41,CAR_TAM_2017-12-24
SEA,2017-11-09,22,Thu,9,10,@,ARI,W 22-16,22,16,6,38,SEA_ARI_2017-11-09
IND,2017-10-16,22,Mon,6,6,@,TEN,L 22-36,22,36,-14,58,IND_TEN_2017-10-16
NYG,2017-10-08,22,Sun,5,5,,LAC,L 22-27,22,27,-5,49,NYG_LAC_2017-10-08
MIA,2023-01-01,21,Sun,16,17,@,NWE,L 21-23,21,23,-2,44,MIA_NWE_2023-01-01
NOR,2022-12-18,21,Sun,14,15,,ATL,W 21-18,21,18,3,39,NOR_ATL_2022-12-18
SFO,2022-12-15,21,Thu,14,15,@,SEA,W 21-13,21,13,8,34,SFO_SEA_2022-12-15
PHI,2022-11-14,21,Mon,9,10,,WAS,L 21-32,21,32,-11,53,PHI_WAS_2022-11-14
TAM,2022-11-13,21,Sun,10,10,,SEA,W 21-16,21,16,5,37,TAM_SEA_2022-11-13
CAR,2022-11-06,21,Sun,9,9,@,CIN,L 21-42,21,42,-21,63,CAR_CIN_2022-11-06
ARI,2022-11-06,21,Sun,9,9,,SEA,L 21-31,21,31,-10,52,ARI_SEA_2022-11-06
DEN,2022-10-30,21,Sun,8,8,@,JAX,W 21-17,21,17,4,38,DEN_JAX_2022-10-30
CAR,2022-10-23,21,Sun,7,7,,TAM,W 21-3,21,3,18,24,CAR_TAM_2022-10-23
GNB,2022-10-23,21,Sun,7,7,@,WAS,L 21-23,21,23,-2,44,GNB_WAS_2022-10-23
TAM,2022-10-09,21,Sun,5,5,,ATL,W 21-15,21,15,6,36,TAM_ATL_2022-10-09
TEN,2022-10-09,21,Sun,5,5,@,WAS,W 21-17,21,17,4,38,TEN_WAS_2022-10-09
JAX,2022-10-02,21,Sun,4,4,@,PHI,L 21-29,21,29,-8,50,JAX_PHI_2022-10-02
MIA,2022-09-25,21,Sun,3,3,,BUF,W 21-19,21,19,2,40,MIA_BUF_2022-09-25
ARI,2022-09-11,21,Sun,1,1,,KAN,L 21-44,21,44,-23,65,ARI_KAN_2022-09-11
NYG,2022-09-11,21,Sun,1,1,@,TEN,W 21-20,21,20,1,41,NYG_TEN_2022-09-11
CLE,2022-01-09,21,Sun,17,18,,CIN,W 21-16,21,16,5,37,CLE_CIN_2022-01-09
NWE,2021-12-26,21,Sun,15,16,,BUF,L 21-33,21,33,-12,54,NWE_BUF_2021-12-26
BAL,2021-12-26,21,Sun,15,16,@,CIN,L 21-41,21,41,-20,62,BAL_CIN_2021-12-26
JAX,2021-12-26,21,Sun,15,16,@,NYJ,L 21-26,21,26,-5,47,JAX_NYJ_2021-12-26
DAL,2021-12-19,21,Sun,14,15,@,NYG,W 21-6,21,6,15,27,DAL_NYG_2021-12-19
CAR,2021-12-12,21,Sun,13,14,,ATL,L 21-29,21,29,-8,50,CAR_ATL_2021-12-12
NYG,2021-12-12,21,Sun,13,14,@,LAC,L 21-37,21,37,-16,58,NYG_LAC_2021-12-12
NYJ,2021-11-28,21,Sun,11,12,@,HOU,W 21-14,21,14,7,35,NYJ_HOU_2021-11-28
ATL,2021-11-28,21,Sun,11,12,@,JAX,W 21-14,21,14,7,35,ATL_JAX_2021-11-28
CAR,2021-11-21,21,Sun,11,11,,WAS,L 21-27,21,27,-6,48,CAR_WAS_2021-11-21
NOR,2021-11-14,21,Sun,9,10,@,TEN,L 21-23,21,23,-2,44,NOR_TEN_2021-11-14
ARI,2021-10-28,21,Thu,8,8,,GNB,L 21-24,21,24,-3,45,ARI_GNB_2021-10-28
PHI,2021-10-10,21,Sun,5,5,@,CAR,W 21-18,21,18,3,39,PHI_CAR_2021-10-10
NOR,2021-10-03,21,Sun,4,4,,NYG,L 21-27 (OT),21,27,-6,48,NOR_NYG_2021-10-03
SFO,2021-10-03,21,Sun,4,4,,SEA,L 21-28,21,28,-7,49,SFO_SEA_2021-10-03
JAX,2021-09-30,21,Thu,4,4,@,CIN,L 21-24,21,24,-3,45,JAX_CIN_2021-09-30
PHI,2021-09-27,21,Mon,3,3,@,DAL,L 21-41,21,41,-20,62,PHI_DAL_2021-09-27
WAS,2021-09-26,21,Sun,3,3,@,BUF,L 21-43,21,43,-22,64,WAS_BUF_2021-09-26
HOU,2021-09-19,21,Sun,2,2,@,CLE,L 21-31,21,31,-10,52,HOU_CLE_2021-09-19
JAX,2021-09-12,21,Sun,1,1,@,HOU,L 21-37,21,37,-16,58,JAX_HOU_2021-09-12
KAN,2021-01-03,21,Sun,16,17,,LAC,L 21-38,21,38,-17,59,KAN_LAC_2021-01-03
NOR,2020-12-13,21,Sun,13,14,@,PHI,L 21-24,21,24,-3,45,NOR_PHI_2020-12-13
NOR,2020-12-06,21,Sun,12,13,@,ATL,W 21-16,21,16,5,37,NOR_ATL_2020-12-06
ARI,2020-11-19,21,Thu,10,11,@,SEA,L 21-28,21,28,-7,49,ARI_SEA_2020-11-19
LAC,2020-11-15,21,Sun,9,10,@,MIA,L 21-29,21,29,-8,50,LAC_MIA_2020-11-15
DET,2020-11-01,21,Sun,7,8,,IND,L 21-41,21,41,-20,62,DET_IND_2020-11-01
NWE,2020-11-01,21,Sun,7,8,@,BUF,L 21-24,21,24,-3,45,NWE_BUF_2020-11-01
NYG,2020-10-22,21,Thu,7,7,@,PHI,L 21-22,21,22,-1,43,NYG_PHI_2020-10-22
ARI,2020-10-04,21,Sun,4,4,@,CAR,L 21-31,21,31,-10,52,ARI_CAR_2020-10-04
HOU,2020-09-27,21,Sun,3,3,@,PIT,L 21-28,21,28,-7,49,HOU_PIT_2020-09-27
CAR,2020-09-27,21,Sun,3,3,@,LAC,W 21-16,21,16,5,37,CAR_LAC_2020-09-27
DET,2020-09-20,21,Sun,2,2,@,GNB,L 21-42,21,42,-21,63,DET_GNB_2020-09-20
DEN,2020-09-20,21,Sun,2,2,@,PIT,L 21-26,21,26,-5,47,DEN_PIT_2020-09-20
NWE,2020-09-13,21,Sun,1,1,,MIA,W 21-11,21,11,10,32,NWE_MIA_2020-09-13
LAC,2019-12-29,21,Sun,16,17,@,KAN,L 21-31,21,31,-10,52,LAC_KAN_2019-12-29
CHI,2019-12-29,21,Sun,16,17,@,MIN,W 21-19,21,19,2,40,CHI_MIN_2019-12-29
SEA,2019-12-29,21,Sun,16,17,,SFO,L 21-26,21,26,-5,47,SEA_SFO_2019-12-29
GNB,2019-12-15,21,Sun,14,15,,CHI,W 21-13,21,13,8,34,GNB_CHI_2019-12-15
LAR,2019-12-15,21,Sun,14,15,@,DAL,L 21-44,21,44,-23,65,LAR_DAL_2019-12-15
TEN,2019-12-15,21,Sun,14,15,,HOU,L 21-24,21,24,-3,45,TEN_HOU_2019-12-15
NYJ,2019-12-12,21,Thu,14,15,@,BAL,L 21-42,21,42,-21,63,NYJ_BAL_2019-12-12
MIA,2019-12-08,21,Sun,13,14,@,NYJ,L 21-22,21,22,-1,43,MIA_NYJ_2019-12-08
OAK,2019-12-08,21,Sun,13,14,,TEN,L 21-42,21,42,-21,63,OAK_TEN_2019-12-08
CAR,2019-12-01,21,Sun,12,13,,WAS,L 21-29,21,29,-8,50,CAR_WAS_2019-12-01
CLE,2019-11-14,21,Thu,10,11,,PIT,W 21-7,21,7,14,28,CLE_PIT_2019-11-14
MIA,2019-10-20,21,Sun,6,7,@,BUF,L 21-31,21,31,-10,52,MIA_BUF_2019-10-20
NYG,2019-10-20,21,Sun,7,7,,ARI,L 21-27,21,27,-6,48,NYG_ARI_2019-10-20
CHI,2019-10-06,21,Sun,5,5,@,OAK,L 21-24,21,24,-3,45,CHI_OAK_2019-10-06
BUF,2019-09-22,21,Sun,3,3,,CIN,W 21-17,21,17,4,38,BUF_CIN_2019-09-22
WAS,2019-09-15,21,Sun,2,2,,DAL,L 21-31,21,31,-10,52,WAS_DAL_2019-09-15
GNB,2019-09-15,21,Sun,2,2,,MIN,W 21-16,21,16,5,37,GNB_MIN_2019-09-15
SEA,2019-09-08,21,Sun,1,1,,CIN,W 21-20,21,20,1,41,SEA_CIN_2019-09-08
SEA,2018-12-10,21,Mon,13,14,,MIN,W 21-7,21,7,14,28,SEA_MIN_2018-12-10
HOU,2018-12-09,21,Sun,13,14,,IND,L 21-24,21,24,-3,45,HOU_IND_2018-12-09
PIT,2018-12-09,21,Sun,13,14,@,OAK,L 21-24,21,24,-3,45,PIT_OAK_2018-12-09
CIN,2018-12-09,21,Sun,13,14,@,LAC,L 21-26,21,26,-5,47,CIN_LAC_2018-12-09
MIA,2018-12-02,21,Sun,12,13,,BUF,W 21-17,21,17,4,38,MIA_BUF_2018-12-02
JAX,2018-11-25,21,Sun,11,12,@,BUF,L 21-24,21,24,-3,45,JAX_BUF_2018-11-25
WAS,2018-11-18,21,Sun,10,11,,HOU,L 21-23,21,23,-2,44,WAS_HOU_2018-11-18
ARI,2018-11-18,21,Sun,10,11,,OAK,L 21-23,21,23,-2,44,ARI_OAK_2018-11-18
CIN,2018-11-18,21,Sun,10,11,@,BAL,L 21-24,21,24,-3,45,CIN_BAL_2018-11-18
CAR,2018-11-08,21,Thu,9,10,@,PIT,L 21-52,21,52,-31,73,CAR_PIT_2018-11-08
CLE,2018-11-04,21,Sun,9,9,,KAN,L 21-37,21,37,-16,58,CLE_KAN_2018-11-04
BAL,2018-10-28,21,Sun,8,8,@,CAR,L 21-36,21,36,-15,57,BAL_CAR_2018-10-28
MIA,2018-10-21,21,Sun,7,7,,DET,L 21-32,21,32,-11,53,MIA_DET_2018-10-21
CAR,2018-10-21,21,Sun,6,7,@,PHI,W 21-17,21,17,4,38,CAR_PHI_2018-10-21
BAL,2018-10-14,21,Sun,6,6,@,TEN,W 21-0,21,0,21,21,BAL_TEN_2018-10-14
CIN,2018-10-14,21,Sun,6,6,,PIT,L 21-28,21,28,-7,49,CIN_PIT_2018-10-14
PHI,2018-10-07,21,Sun,5,5,,MIN,L 21-23,21,23,-2,44,PHI_MIN_2018-10-07
CIN,2018-09-23,21,Sun,3,3,@,CAR,L 21-31,21,31,-10,52,CIN_CAR_2018-09-23
CLE,2018-09-20,21,Thu,3,3,,NYJ,W 21-17,21,17,4,38,CLE_NYJ_2018-09-20
NOR,2018-09-16,21,Sun,2,2,,CLE,W 21-18,21,18,3,39,NOR_CLE_2018-09-16
PHI,2018-09-16,21,Sun,2,2,@,TAM,L 21-27,21,27,-6,48,PHI_TAM_2018-09-16
IND,2018-09-16,21,Sun,2,2,@,WAS,W 21-9,21,9,12,30,IND_WAS_2018-09-16
PIT,2018-09-09,21,Sun,1,1,@,CLE,T 21-21 (OT),21,21,0,42,PIT_CLE_2018-09-09
CLE,2018-09-09,21,Sun,1,1,,PIT,T 21-21 (OT),21,21,0,42,CLE_PIT_2018-09-09
SEA,2017-12-24,21,Sun,15,16,@,DAL,W 21-12,21,12,9,33,SEA_DAL_2017-12-24
TAM,2017-12-18,21,Mon,14,15,,ATL,L 21-24,21,24,-3,45,TAM_ATL_2017-12-18
TAM,2017-12-10,21,Sun,13,14,,DET,L 21-24,21,24,-3,45,TAM_DET_2017-12-10
CLE,2017-12-10,21,Sun,13,14,,GNB,L 21-27 (OT),21,27,-6,48,CLE_GNB_2017-12-10
CAR,2017-12-03,21,Sun,12,13,@,NOR,L 21-31,21,31,-10,52,CAR_NOR_2017-12-03
OAK,2017-11-26,21,Sun,11,12,,DEN,W 21-14,21,14,7,35,OAK_DEN_2017-11-26
ARI,2017-11-19,21,Sun,10,11,@,HOU,L 21-31,21,31,-10,52,ARI_HOU_2017-11-19
MIA,2017-11-13,21,Mon,9,10,@,CAR,L 21-45,21,45,-24,66,MIA_CAR_2017-11-13
NYG,2017-11-12,21,Sun,9,10,@,SFO,L 21-31,21,31,-10,52,NYG_SFO_2017-11-12
BUF,2017-11-02,21,Thu,8,9,@,NYJ,L 21-34,21,34,-13,55,BUF_NYJ_2017-11-02
NWE,2017-10-29,21,Sun,8,8,,LAC,W 21-13,21,13,8,34,NWE_LAC_2017-10-29
LAC,2017-10-22,21,Sun,7,7,,DEN,W 21-0,21,0,21,21,LAC_DEN_2017-10-22
LAC,2017-09-11,21,Mon,1,1,@,DEN,L 21-24,21,24,-3,45,LAC_DEN_2017-09-11
PIT,2017-09-10,21,Sun,1,1,@,CLE,W 21-18,21,18,3,39,PIT_CLE_2017-09-10
BUF,2017-09-10,21,Sun,1,1,,NYJ,W 21-12,21,12,9,33,BUF_NYJ_2017-09-10
DET,2023-01-08,20,Sun,17,18,@,GNB,W 20-16,20,16,4,36,DET_GNB_2023-01-08
JAX,2023-01-07,20,Sat,17,18,,TEN,W 20-16,20,16,4,36,JAX_TEN_2023-01-07
ATL,2023-01-01,20,Sun,16,17,,ARI,W 20-19,20,19,1,39,ATL_ARI_2023-01-01
NOR,2023-01-01,20,Sun,16,17,@,PHI,W 20-10,20,10,10,30,NOR_PHI_2023-01-01
LAC,2022-12-26,20,Mon,15,16,@,IND,W 20-3,20,3,17,23,LAC_IND_2022-12-26
MIA,2022-12-25,20,Sun,15,16,,GNB,L 20-26,20,26,-6,46,MIA_GNB_2022-12-25
WAS,2022-12-24,20,Sat,15,16,@,SFO,L 20-37,20,37,-17,57,WAS_SFO_2022-12-24
DET,2022-12-18,20,Sun,14,15,@,NYJ,W 20-17,20,17,3,37,DET_NYJ_2022-12-18
CHI,2022-12-18,20,Sun,14,15,,PHI,L 20-25,20,25,-5,45,CHI_PHI_2022-12-18
NYG,2022-12-18,20,Sun,14,15,@,WAS,W 20-12,20,12,8,32,NYG_WAS_2022-12-18
BUF,2022-12-11,20,Sun,13,14,,NYJ,W 20-12,20,12,8,32,BUF_NYJ_2022-12-11
WAS,2022-12-04,20,Sun,13,13,@,NYG,T 20-20 (OT),20,20,0,40,WAS_NYG_2022-12-04
LAC,2022-12-04,20,Sun,12,13,@,LVR,L 20-27,20,27,-7,47,LAC_LVR_2022-12-04
NYG,2022-12-04,20,Sun,12,13,,WAS,T 20-20 (OT),20,20,0,40,NYG_WAS_2022-12-04
CIN,2022-11-27,20,Sun,11,12,@,TEN,W 20-16,20,16,4,36,CIN_TEN_2022-11-27
NYG,2022-11-24,20,Thu,11,12,@,DAL,L 20-28,20,28,-8,48,NYG_DAL_2022-11-24
LAR,2022-11-20,20,Sun,10,11,@,NOR,L 20-27,20,27,-7,47,LAR_NOR_2022-11-20
LVR,2022-11-13,20,Sun,9,10,,IND,L 20-25,20,25,-5,45,LVR_IND_2022-11-13
PIT,2022-11-13,20,Sun,9,10,,NOR,W 20-10,20,10,10,30,PIT_NOR_2022-11-13
LAC,2022-11-06,20,Sun,8,9,@,ATL,W 20-17,20,17,3,37,LAC_ATL_2022-11-06
NYJ,2022-11-06,20,Sun,9,9,,BUF,W 20-17,20,17,3,37,NYJ_BUF_2022-11-06
LVR,2022-11-06,20,Sun,8,9,@,JAX,L 20-27,20,27,-7,47,LVR_JAX_2022-11-06
KAN,2022-11-06,20,Sun,8,9,,TEN,W 20-17 (OT),20,17,3,37,KAN_TEN_2022-11-06
MIN,2022-11-06,20,Sun,8,9,@,WAS,W 20-17,20,17,3,37,MIN_WAS_2022-11-06
HOU,2022-10-23,20,Sun,6,7,@,LVR,L 20-38,20,38,-18,58,HOU_LVR_2022-10-23
CLE,2022-10-23,20,Sun,7,7,@,BAL,L 20-23,20,23,-3,43,CLE_BAL_2022-10-23
KAN,2022-10-16,20,Sun,6,6,,BUF,L 20-24,20,24,-4,44,KAN_BUF_2022-10-16
BAL,2022-10-16,20,Sun,6,6,@,NYG,L 20-24,20,24,-4,44,BAL_NYG_2022-10-16
PIT,2022-10-16,20,Sun,6,6,,TAM,W 20-18,20,18,2,38,PIT_TAM_2022-10-16
PHI,2022-10-09,20,Sun,5,5,@,ARI,W 20-17,20,17,3,37,PHI_ARI_2022-10-09
CLE,2022-10-02,20,Sun,4,4,@,ATL,L 20-23,20,23,-3,43,CLE_ATL_2022-10-02
BAL,2022-10-02,20,Sun,4,4,,BUF,L 20-23,20,23,-3,43,BAL_BUF_2022-10-02
NYG,2022-10-02,20,Sun,4,4,,CHI,W 20-12,20,12,8,32,NYG_CHI_2022-10-02
PIT,2022-10-02,20,Sun,4,4,,NYJ,L 20-24,20,24,-4,44,PIT_NYJ_2022-10-02
HOU,2022-09-25,20,Sun,3,3,@,CHI,L 20-23,20,23,-3,43,HOU_CHI_2022-09-25
LAR,2022-09-25,20,Sun,3,3,@,ARI,W 20-12,20,12,8,32,LAR_ARI_2022-09-25
IND,2022-09-25,20,Sun,3,3,,KAN,W 20-17,20,17,3,37,IND_KAN_2022-09-25
DAL,2022-09-18,20,Sun,2,2,,CIN,W 20-17,20,17,3,37,DAL_CIN_2022-09-18
TAM,2022-09-18,20,Sun,2,2,@,NOR,W 20-10,20,10,10,30,TAM_NOR_2022-09-18
HOU,2022-09-11,20,Sun,1,1,,IND,T 20-20 (OT),20,20,0,40,HOU_IND_2022-09-11
IND,2022-09-11,20,Sun,1,1,@,HOU,T 20-20 (OT),20,20,0,40,IND_HOU_2022-09-11
MIA,2022-09-11,20,Sun,1,1,,NWE,W 20-7,20,7,13,27,MIA_NWE_2022-09-11
TEN,2022-09-11,20,Sun,1,1,,NYG,L 20-21,20,21,-1,41,TEN_NYG_2022-09-11
CIN,2022-09-11,20,Sun,1,1,,PIT,L 20-23 (OT),20,23,-3,43,CIN_PIT_2022-09-11
ATL,2022-01-09,20,Sun,17,18,,NOR,L 20-30,20,30,-10,50,ATL_NOR_2022-01-09
IND,2022-01-02,20,Sun,16,17,,LVR,L 20-23,20,23,-3,43,IND_LVR_2022-01-02
LAR,2022-01-02,20,Sun,16,17,@,BAL,W 20-19,20,19,1,39,LAR_BAL_2022-01-02
PHI,2022-01-02,20,Sun,16,17,@,WAS,W 20-16,20,16,4,36,PHI_WAS_2022-01-02
MIA,2021-12-27,20,Mon,15,16,@,NOR,W 20-3,20,3,17,23,MIA_NOR_2021-12-27
ATL,2021-12-26,20,Sun,15,16,,DET,W 20-16,20,16,4,36,ATL_DET_2021-12-26
TEN,2021-12-23,20,Thu,15,16,,SFO,W 20-17,20,17,3,37,TEN_SFO_2021-12-23
LAR,2021-12-21,20,Tue,14,15,,SEA,W 20-10,20,10,10,30,LAR_SEA_2021-12-21
WAS,2021-12-12,20,Sun,13,14,,DAL,L 20-27,20,27,-7,47,WAS_DAL_2021-12-12
TEN,2021-12-12,20,Sun,13,14,,JAX,W 20-0,20,0,20,20,TEN_JAX_2021-12-12
MIA,2021-12-05,20,Sun,13,13,,NYG,W 20-9,20,9,11,29,MIA_NYG_2021-12-05
PIT,2021-12-05,20,Sun,12,13,,BAL,W 20-19,20,19,1,39,PIT_BAL_2021-12-05
LAC,2021-11-14,20,Sun,9,10,,MIN,L 20-27,20,27,-7,47,LAC_MIN_2021-11-14
KAN,2021-11-01,20,Mon,8,8,,NYG,W 20-17,20,17,3,37,KAN_NYG_2021-11-01
DAL,2021-10-31,20,Sun,7,8,@,MIN,W 20-16,20,16,4,36,DAL_MIN_2021-10-31
MIA,2021-10-17,20,Sun,6,6,@,JAX,L 20-23,20,23,-3,43,MIA_JAX_2021-10-17
SEA,2021-10-17,20,Sun,6,6,@,PIT,L 20-23 (OT),20,23,-3,43,SEA_PIT_2021-10-17
NYJ,2021-10-10,20,Sun,5,5,@,ATL,L 20-27,20,27,-7,47,NYJ_ATL_2021-10-10
KAN,2021-10-10,20,Sun,5,5,,BUF,L 20-38,20,38,-18,58,KAN_BUF_2021-10-10
NYG,2021-10-10,20,Sun,5,5,@,DAL,L 20-44,20,44,-24,64,NYG_DAL_2021-10-10
CHI,2021-10-10,20,Sun,5,5,@,LVR,W 20-9,20,9,11,29,CHI_LVR_2021-10-10
LAR,2021-10-03,20,Sun,4,4,,ARI,L 20-37,20,37,-17,57,LAR_ARI_2021-10-03
CHI,2021-09-19,20,Sun,2,2,,CIN,W 20-17,20,17,3,37,CHI_CIN_2021-09-19
DAL,2021-09-19,20,Sun,2,2,@,LAC,W 20-17,20,17,3,37,DAL_LAC_2021-09-19
LAC,2021-09-12,20,Sun,1,1,@,WAS,W 20-16,20,16,4,36,LAC_WAS_2021-09-12
WAS,2021-01-03,20,Sun,16,17,@,PHI,W 20-14,20,14,6,34,WAS_PHI_2021-01-03
SEA,2020-12-27,20,Sun,15,16,,LAR,W 20-9,20,9,11,29,SEA_LAR_2020-12-27
CAR,2020-12-27,20,Sun,15,16,@,WAS,W 20-13,20,13,7,33,CAR_WAS_2020-12-27
SFO,2020-12-26,20,Sat,15,16,@,ARI,W 20-12,20,12,8,32,SFO_ARI_2020-12-26
HOU,2020-12-20,20,Sun,14,15,@,IND,L 20-27,20,27,-7,47,HOU_IND_2020-12-20
CLE,2020-12-20,20,Sun,14,15,@,NYG,W 20-6,20,6,14,26,CLE_NYG_2020-12-20
LAR,2020-12-20,20,Sun,14,15,,NYJ,L 20-23,20,23,-3,43,LAR_NYJ_2020-12-20
SEA,2020-12-20,20,Sun,14,15,@,WAS,W 20-15,20,15,5,35,SEA_WAS_2020-12-20
LAC,2020-12-13,20,Sun,13,14,,ATL,W 20-17,20,17,3,37,LAC_ATL_2020-12-13
HOU,2020-12-06,20,Sun,12,13,,IND,L 20-26,20,26,-6,46,HOU_IND_2020-12-06
NWE,2020-11-29,20,Sun,11,12,,ARI,W 20-17,20,17,3,37,NWE_ARI_2020-11-29
MIA,2020-11-29,20,Sun,11,12,@,NYJ,W 20-3,20,3,17,23,MIA_NYJ_2020-11-29
LAR,2020-11-29,20,Sun,11,12,,SFO,L 20-23,20,23,-3,43,LAR_SFO_2020-11-29
CAR,2020-11-22,20,Sun,11,11,,DET,W 20-0,20,0,20,20,CAR_DET_2020-11-22
NWE,2020-11-22,20,Sun,10,11,@,HOU,L 20-27,20,27,-7,47,NWE_HOU_2020-11-22
DEN,2020-11-22,20,Sun,10,11,,MIA,W 20-13,20,13,7,33,DEN_MIA_2020-11-22
WAS,2020-11-22,20,Sun,10,11,,CIN,W 20-9,20,9,11,29,WAS_CIN_2020-11-22
JAX,2020-11-15,20,Sun,9,10,@,GNB,L 20-24,20,24,-4,44,JAX_GNB_2020-11-15
DET,2020-11-08,20,Sun,8,9,@,MIN,L 20-34,20,34,-14,54,DET_MIN_2020-11-08
WAS,2020-11-08,20,Sun,8,9,,NYG,L 20-23,20,23,-3,43,WAS_NYG_2020-11-08
TEN,2020-11-01,20,Sun,7,8,@,CIN,L 20-31,20,31,-11,51,TEN_CIN_2020-11-01
HOU,2020-10-25,20,Sun,7,7,,GNB,L 20-35,20,35,-15,55,HOU_GNB_2020-10-25
LVR,2020-10-25,20,Sun,6,7,,TAM,L 20-45,20,45,-25,65,LVR_TAM_2020-10-25
NYG,2020-10-18,20,Sun,6,6,,WAS,W 20-19,20,19,1,39,NYG_WAS_2020-10-18
CHI,2020-10-08,20,Thu,5,5,,TAM,W 20-19,20,19,1,39,CHI_TAM_2020-10-08
SFO,2020-10-04,20,Sun,4,4,,PHI,L 20-25,20,25,-5,45,SFO_PHI_2020-10-04
BAL,2020-09-28,20,Mon,3,3,,KAN,L 20-34,20,34,-14,54,BAL_KAN_2020-09-28
LVR,2020-09-27,20,Sun,3,3,@,NWE,L 20-36,20,36,-16,56,LVR_NWE_2020-09-27
WAS,2020-09-27,20,Sun,3,3,@,CLE,L 20-34,20,34,-14,54,WAS_CLE_2020-09-27
LAC,2020-09-20,20,Sun,2,2,,KAN,L 20-23 (OT),20,23,-3,43,LAC_KAN_2020-09-20
SFO,2020-09-13,20,Sun,1,1,,ARI,L 20-24,20,24,-4,44,SFO_ARI_2020-09-13
LAR,2020-09-13,20,Sun,1,1,,DAL,W 20-17,20,17,3,37,LAR_DAL_2020-09-13
IND,2020-09-13,20,Sun,1,1,@,JAX,L 20-27,20,27,-7,47,IND_JAX_2020-09-13
HOU,2020-09-10,20,Thu,1,1,@,KAN,L 20-34,20,34,-14,54,HOU_KAN_2020-09-10
DET,2019-12-29,20,Sun,16,17,,GNB,L 20-23,20,23,-3,43,DET_GNB_2019-12-29
IND,2019-12-29,20,Sun,16,17,@,JAX,L 20-38,20,38,-18,58,IND_JAX_2019-12-29
TAM,2019-12-21,20,Sat,15,16,,HOU,L 20-23,20,23,-3,43,TAM_HOU_2019-12-21
MIA,2019-12-15,20,Sun,14,15,@,NYG,L 20-36,20,36,-16,56,MIA_NYG_2019-12-15
JAX,2019-12-15,20,Sun,14,15,@,OAK,W 20-16,20,16,4,36,JAX_OAK_2019-12-15
CAR,2019-12-08,20,Sun,13,14,@,ATL,L 20-40,20,40,-20,60,CAR_ATL_2019-12-08
MIN,2019-12-08,20,Sun,13,14,,DET,W 20-7,20,7,13,27,MIN_DET_2019-12-08
GNB,2019-12-08,20,Sun,13,14,,WAS,W 20-15,20,15,5,35,GNB_WAS_2019-12-08
PIT,2019-12-01,20,Sun,12,13,,CLE,W 20-13,20,13,7,33,PIT_CLE_2019-12-01
LAC,2019-12-01,20,Sun,12,13,@,DEN,L 20-23,20,23,-3,43,LAC_DEN_2019-12-01
BAL,2019-12-01,20,Sun,12,13,,SFO,W 20-17,20,17,3,37,BAL_SFO_2019-12-01
DET,2019-11-28,20,Thu,12,13,,CHI,L 20-24,20,24,-4,44,DET_CHI_2019-11-28
BUF,2019-11-24,20,Sun,11,12,,DEN,W 20-3,20,3,17,23,BUF_DEN_2019-11-24
JAX,2019-11-24,20,Sun,11,12,@,TEN,L 20-42,20,42,-22,62,JAX_TEN_2019-11-24
HOU,2019-11-21,20,Thu,11,12,,IND,W 20-17,20,17,3,37,HOU_IND_2019-11-21
MIA,2019-11-17,20,Sun,10,11,,BUF,L 20-37,20,37,-17,57,MIA_BUF_2019-11-17
CHI,2019-11-10,20,Sun,9,10,,DET,W 20-13,20,13,7,33,CHI_DET_2019-11-10
TEN,2019-11-03,20,Sun,9,9,@,CAR,L 20-30,20,30,-10,50,TEN_CAR_2019-11-03
NWE,2019-11-03,20,Sun,9,9,@,BAL,L 20-37,20,37,-17,57,NWE_BAL_2019-11-03
ATL,2019-10-27,20,Sun,8,8,,SEA,L 20-27,20,27,-7,47,ATL_SEA_2019-10-27
LAC,2019-10-20,20,Sun,7,7,@,TEN,L 20-23,20,23,-3,43,LAC_TEN_2019-10-20
PHI,2019-10-13,20,Sun,6,6,@,MIN,L 20-38,20,38,-18,58,PHI_MIN_2019-10-13
SFO,2019-10-13,20,Sun,5,6,@,LAR,W 20-7,20,7,13,27,SFO_LAR_2019-10-13
DEN,2019-10-06,20,Sun,5,5,@,LAC,W 20-13,20,13,7,33,DEN_LAC_2019-10-06
ARI,2019-09-22,20,Sun,3,3,,CAR,L 20-38,20,38,-18,58,ARI_CAR_2019-09-22
LAR,2019-09-22,20,Sun,3,3,@,CLE,W 20-13,20,13,7,33,LAR_CLE_2019-09-22
LAC,2019-09-22,20,Sun,3,3,,HOU,L 20-27,20,27,-7,47,LAC_HOU_2019-09-22
PIT,2019-09-22,20,Sun,3,3,@,SFO,L 20-24,20,24,-4,44,PIT_SFO_2019-09-22
JAX,2019-09-19,20,Thu,3,3,,TEN,W 20-7,20,7,13,27,JAX_TEN_2019-09-19
PHI,2019-09-15,20,Sun,2,2,@,ATL,L 20-24,20,24,-4,44,PHI_ATL_2019-09-15
TAM,2019-09-12,20,Thu,2,2,@,CAR,W 20-14,20,14,6,34,TAM_CAR_2019-09-12
CIN,2019-09-08,20,Sun,1,1,@,SEA,L 20-21,20,21,-1,41,CIN_SEA_2019-09-08
HOU,2018-12-30,20,Sun,16,17,,JAX,W 20-3,20,3,17,23,HOU_JAX_2018-12-30
TAM,2018-12-23,20,Sun,15,16,@,DAL,L 20-27,20,27,-7,47,TAM_DAL_2018-12-23
BAL,2018-12-16,20,Sun,14,15,,TAM,W 20-12,20,12,8,32,BAL_TAM_2018-12-16
CAR,2018-12-09,20,Sun,13,14,@,CLE,L 20-26,20,26,-6,46,CAR_CLE_2018-12-09
SFO,2018-12-09,20,Sun,13,14,,DEN,W 20-14,20,14,6,34,SFO_DEN_2018-12-09
ATL,2018-12-09,20,Sun,13,14,@,GNB,L 20-34,20,34,-14,54,ATL_GNB_2018-12-09
ARI,2018-12-02,20,Sun,12,13,@,GNB,W 20-17,20,17,3,37,ARI_GNB_2018-12-02
CIN,2018-11-25,20,Sun,11,12,,CLE,L 20-35,20,35,-15,55,CIN_CLE_2018-11-25
DET,2018-11-18,20,Sun,10,11,,CAR,W 20-19,20,19,1,39,DET_CAR_2018-11-18
MIN,2018-11-18,20,Sun,10,11,@,CHI,L 20-25,20,25,-5,45,MIN_CHI_2018-11-18
PIT,2018-11-18,20,Sun,10,11,@,JAX,W 20-16,20,16,4,36,PIT_JAX_2018-11-18
PHI,2018-11-11,20,Sun,9,10,,DAL,L 20-27,20,27,-7,47,PHI_DAL_2018-11-11
LAC,2018-11-11,20,Sun,9,10,@,OAK,W 20-6,20,6,14,26,LAC_OAK_2018-11-11
MIN,2018-10-28,20,Sun,8,8,,NOR,L 20-30,20,30,-10,50,MIN_NOR_2018-10-28
WAS,2018-10-28,20,Sun,7,8,@,NYG,W 20-13,20,13,7,33,WAS_NYG_2018-10-28
NYG,2018-10-22,20,Mon,7,7,@,ATL,L 20-23,20,23,-3,43,NYG_ATL_2018-10-22
WAS,2018-10-21,20,Sun,6,7,,DAL,W 20-17,20,17,3,37,WAS_DAL_2018-10-21
HOU,2018-10-21,20,Sun,7,7,@,JAX,W 20-7,20,7,13,27,HOU_JAX_2018-10-21
LAC,2018-10-21,20,Sun,7,7,,TEN,W 20-19,20,19,1,39,LAC_TEN_2018-10-21
HOU,2018-10-14,20,Sun,6,6,,BUF,W 20-13,20,13,7,33,HOU_BUF_2018-10-14
DEN,2018-10-14,20,Sun,6,6,,LAR,L 20-23,20,23,-3,43,DEN_LAR_2018-10-14
SEA,2018-09-30,20,Sun,4,4,@,ARI,W 20-17,20,17,3,37,SEA_ARI_2018-09-30
PHI,2018-09-23,20,Sun,3,3,,IND,W 20-16,20,16,4,36,PHI_IND_2018-09-23
OAK,2018-09-23,20,Sun,3,3,@,MIA,L 20-28,20,28,-8,48,OAK_MIA_2018-09-23
TEN,2018-09-16,20,Sun,2,2,,HOU,W 20-17,20,17,3,37,TEN_HOU_2018-09-16
NWE,2018-09-16,20,Sun,2,2,@,JAX,L 20-31,20,31,-11,51,NWE_JAX_2018-09-16
DAL,2018-09-16,20,Sun,2,2,,NYG,W 20-13,20,13,7,33,DAL_NYG_2018-09-16
MIA,2018-09-16,20,Sun,2,2,@,NYJ,W 20-12,20,12,8,32,MIA_NYJ_2018-09-16
DEN,2018-09-16,20,Sun,2,2,,OAK,W 20-19,20,19,1,39,DEN_OAK_2018-09-16
BUF,2018-09-16,20,Sun,2,2,,LAC,L 20-31,20,31,-11,51,BUF_LAC_2018-09-16
TEN,2018-09-09,20,Sun,1,1,@,MIA,L 20-27,20,27,-7,47,TEN_MIA_2018-09-09
HOU,2018-09-09,20,Sun,1,1,@,NWE,L 20-27,20,27,-7,47,HOU_NWE_2018-09-09
JAX,2018-09-09,20,Sun,1,1,@,NYG,W 20-15,20,15,5,35,JAX_NYG_2018-09-09
CHI,2017-12-24,20,Sun,15,16,,CLE,W 20-3,20,3,17,23,CHI_CLE_2017-12-24
WAS,2017-12-17,20,Sun,14,15,,ARI,W 20-15,20,15,5,35,WAS_ARI_2017-12-17
DAL,2017-12-17,20,Sun,14,15,@,OAK,W 20-17,20,17,3,37,DAL_OAK_2017-12-17
DET,2017-12-16,20,Sat,14,15,,CHI,W 20-10,20,10,10,30,DET_CHI_2017-12-16
NWE,2017-12-11,20,Mon,13,14,@,MIA,L 20-27,20,27,-7,47,NWE_MIA_2017-12-11
ATL,2017-12-07,20,Thu,13,14,,NOR,W 20-17,20,17,3,37,ATL_NOR_2017-12-07
CIN,2017-12-04,20,Mon,12,13,,PIT,L 20-23,20,23,-3,43,CIN_PIT_2017-12-04
TAM,2017-12-03,20,Sun,12,13,@,GNB,L 20-26 (OT),20,26,-6,46,TAM_GNB_2017-12-03
DET,2017-12-03,20,Sun,12,13,@,BAL,L 20-44,20,44,-24,64,DET_BAL_2017-12-03
TAM,2017-11-26,20,Sun,11,12,@,ATL,L 20-34,20,34,-14,54,TAM_ATL_2017-11-26
TEN,2017-11-26,20,Sun,11,12,@,IND,W 20-16,20,16,4,36,TEN_IND_2017-11-26
NOR,2017-11-26,20,Sun,11,12,@,LAR,L 20-26,20,26,-6,46,NOR_LAR_2017-11-26
WAS,2017-11-23,20,Thu,11,12,,NYG,W 20-10,20,10,10,30,WAS_NYG_2017-11-23
CIN,2017-11-19,20,Sun,10,11,@,DEN,W 20-17,20,17,3,37,CIN_DEN_2017-11-19
MIA,2017-11-19,20,Sun,10,11,,TAM,L 20-30,20,30,-10,50,MIA_TAM_2017-11-19
PIT,2017-11-12,20,Sun,9,10,@,IND,W 20-17,20,17,3,37,PIT_IND_2017-11-12
CIN,2017-11-12,20,Sun,9,10,@,TEN,L 20-24,20,24,-4,44,CIN_TEN_2017-11-12
JAX,2017-11-12,20,Sun,9,10,,LAC,W 20-17 (OT),20,17,3,37,JAX_LAC_2017-11-12
CAR,2017-11-05,20,Sun,9,9,,ATL,W 20-17,20,17,3,37,CAR_ATL_2017-11-05
IND,2017-11-05,20,Sun,9,9,@,HOU,W 20-14,20,14,6,34,IND_HOU_2017-11-05
BAL,2017-11-05,20,Sun,9,9,@,TEN,L 20-23,20,23,-3,43,BAL_TEN_2017-11-05
ARI,2017-11-05,20,Sun,8,9,@,SFO,W 20-10,20,10,10,30,ARI_SFO_2017-11-05
NYJ,2017-10-29,20,Sun,8,8,,ATL,L 20-25,20,25,-5,45,NYJ_ATL_2017-10-29
NOR,2017-10-29,20,Sun,7,8,,CHI,W 20-12,20,12,8,32,NOR_CHI_2017-10-29
PIT,2017-10-29,20,Sun,8,8,@,DET,W 20-15,20,15,5,35,PIT_DET_2017-10-29
MIA,2017-10-15,20,Sun,5,6,@,ATL,W 20-17,20,17,3,37,MIA_ATL_2017-10-15
MIN,2017-10-09,20,Mon,5,5,@,CHI,W 20-17,20,17,3,37,MIN_CHI_2017-10-09
CIN,2017-10-08,20,Sun,5,5,,BUF,W 20-16,20,16,4,36,CIN_BUF_2017-10-08
WAS,2017-10-02,20,Mon,4,4,@,KAN,L 20-29,20,29,-9,49,WAS_KAN_2017-10-02
NOR,2017-10-01,20,Sun,4,4,@,MIA,W 20-0,20,0,20,20,NOR_MIA_2017-10-01
JAX,2017-10-01,20,Sun,4,4,@,NYJ,L 20-23 (OT),20,23,-3,43,JAX_NYJ_2017-10-01
NYJ,2017-09-24,20,Sun,3,3,,MIA,W 20-6,20,6,14,26,NYJ_MIA_2017-09-24
PHI,2017-09-17,20,Sun,2,2,@,KAN,L 20-27,20,27,-7,47,PHI_KAN_2017-09-17
PHI,2017-09-17,20,Sun,2,2,@,KAN,L 20-27,20,27,-7,47,PHI_KAN_2017-09-17
LAR,2017-09-17,20,Sun,2,2,,WAS,L 20-27,20,27,-7,47,LAR_WAS_2017-09-17
NYJ,2017-09-17,20,Sun,2,2,@,OAK,L 20-45,20,45,-25,65,NYJ_OAK_2017-09-17
BAL,2017-09-10,20,Sun,1,1,@,CIN,W 20-0,20,0,20,20,BAL_CIN_2017-09-10
SEA,2023-01-08,19,Sun,17,18,,LAR,W 19-16 (OT),19,16,3,35,SEA_LAR_2023-01-08
ARI,2023-01-01,19,Sun,16,17,@,ATL,L 19-20,19,20,-1,39,ARI_ATL_2023-01-01
TAM,2022-12-25,19,Sun,15,16,@,ARI,W 19-16 (OT),19,16,3,35,TAM_ARI_2022-12-25
HOU,2022-12-24,19,Sat,15,16,@,TEN,W 19-14,19,14,5,33,HOU_TEN_2022-12-24
JAX,2022-12-22,19,Thu,15,16,@,NYJ,W 19-3,19,3,16,22,JAX_NYJ_2022-12-22
CHI,2022-12-04,19,Sun,13,13,,GNB,L 19-28,19,28,-9,47,CHI_GNB_2022-12-04
PIT,2022-12-04,19,Sun,12,13,@,ATL,W 19-16,19,16,3,35,PIT_ATL_2022-12-04
IND,2022-12-04,19,Sun,13,13,@,DAL,L 19-54,19,54,-35,73,IND_DAL_2022-12-04
WAS,2022-11-27,19,Sun,12,12,,ATL,W 19-13,19,13,6,32,WAS_ATL_2022-11-27
TEN,2022-10-23,19,Sun,6,7,,IND,W 19-10,19,10,9,29,TEN_IND_2022-10-23
LAC,2022-10-17,19,Mon,6,6,,DEN,W 19-16 (OT),19,16,3,35,LAC_DEN_2022-10-17
SEA,2022-10-16,19,Sun,6,6,,ARI,W 19-9,19,9,10,28,SEA_ARI_2022-10-16
BAL,2022-10-09,19,Sun,5,5,,CIN,W 19-17,19,17,2,36,BAL_CIN_2022-10-09
BUF,2022-09-25,19,Sun,3,3,@,MIA,L 19-21,19,21,-2,40,BUF_MIA_2022-09-25
NYG,2022-09-18,19,Sun,2,2,,CAR,W 19-16,19,16,3,35,NYG_CAR_2022-09-18
CHI,2022-09-11,19,Sun,1,1,,SFO,W 19-10,19,10,9,29,CHI_SFO_2022-09-11
TAM,2022-09-11,19,Sun,1,1,@,DAL,W 19-3,19,3,16,22,TAM_DAL_2022-09-11
LVR,2022-09-11,19,Sun,1,1,@,LAC,L 19-24,19,24,-5,43,LVR_LAC_2022-09-11
BAL,2022-01-02,19,Sun,16,17,,LAR,L 19-20,19,20,-1,39,BAL_LAR_2022-01-02
PIT,2021-12-19,19,Sun,14,15,,TEN,W 19-13,19,13,6,32,PIT_TEN_2021-12-19
BAL,2021-12-05,19,Sun,12,13,@,PIT,L 19-20,19,20,-1,39,BAL_PIT_2021-12-05
KAN,2021-11-21,19,Sun,11,11,,DAL,W 19-9,19,9,10,28,KAN_DAL_2021-11-21
TAM,2021-11-14,19,Sun,9,10,@,WAS,L 19-29,19,29,-10,48,TAM_WAS_2021-11-14
CAR,2021-10-31,19,Sun,8,8,@,ATL,W 19-13,19,13,6,32,CAR_ATL_2021-10-31
DET,2021-10-24,19,Sun,7,7,@,LAR,L 19-28,19,28,-9,47,DET_LAR_2021-10-24
MIN,2021-10-10,19,Sun,5,5,,DET,W 19-17,19,17,2,36,MIN_DET_2021-10-10
JAX,2021-10-10,19,Sun,5,5,,TEN,L 19-37,19,37,-18,56,JAX_TEN_2021-10-10
DEN,2021-10-10,19,Sun,5,5,@,PIT,L 19-27,19,27,-8,46,DEN_PIT_2021-10-10
TAM,2021-10-03,19,Sun,4,4,@,NWE,W 19-17,19,17,2,36,TAM_NWE_2021-10-03
BAL,2021-09-26,19,Sun,3,3,@,DET,W 19-17,19,17,2,36,BAL_DET_2021-09-26
JAX,2021-09-26,19,Sun,3,3,,ARI,L 19-31,19,31,-12,50,JAX_ARI_2021-09-26
CAR,2021-09-12,19,Sun,1,1,,NYJ,W 19-14,19,14,5,33,CAR_NYJ_2021-09-12
DAL,2021-01-03,19,Sun,16,17,@,NYG,L 19-23,19,23,-4,42,DAL_NYG_2021-01-03
LAC,2020-12-27,19,Sun,15,16,,DEN,W 19-16,19,16,3,35,LAC_DEN_2020-12-27
DEN,2020-12-19,19,Sat,14,15,,BUF,L 19-48,19,48,-29,67,DEN_BUF_2020-12-19
MIA,2020-12-06,19,Sun,12,13,,CIN,W 19-7,19,7,12,26,MIA_CIN_2020-12-06
PIT,2020-12-02,19,Wed,11,12,,BAL,W 19-14,19,14,5,33,PIT_BAL_2020-12-02
NYG,2020-11-29,19,Sun,11,12,@,CIN,W 19-17,19,17,2,36,NYG_CIN_2020-11-29
MIN,2020-11-16,19,Mon,9,10,@,CHI,W 19-13,19,13,6,32,MIN_CHI_2020-11-16
DAL,2020-11-08,19,Sun,9,9,,PIT,L 19-24,19,24,-5,43,DAL_PIT_2020-11-08
WAS,2020-10-18,19,Sun,6,6,@,NYG,L 19-20,19,20,-1,39,WAS_NYG_2020-10-18
TAM,2020-10-08,19,Thu,5,5,@,CHI,L 19-20,19,20,-1,39,TAM_CHI_2020-10-08
IND,2020-10-04,19,Sun,4,4,@,CHI,W 19-11,19,11,8,30,IND_CHI_2020-10-04
PHI,2020-09-20,19,Sun,2,2,,LAR,L 19-37,19,37,-18,56,PHI_LAR_2020-09-20
MIN,2019-12-29,19,Sun,16,17,,CHI,L 19-21,19,21,-2,40,MIN_CHI_2019-12-29
CIN,2019-12-08,19,Sun,13,14,@,CLE,L 19-27,19,27,-8,46,CIN_CLE_2019-12-08
CHI,2019-11-24,19,Sun,11,12,,NYG,W 19-14,19,14,5,33,CHI_NYG_2019-11-24
WAS,2019-11-24,19,Sun,11,12,,DET,W 19-16,19,16,3,35,WAS_DET_2019-11-24
CLE,2019-11-10,19,Sun,9,10,,BUF,W 19-16,19,16,3,35,CLE_BUF_2019-11-10
CLE,2019-11-03,19,Sun,8,9,@,DEN,L 19-24,19,24,-5,43,CLE_DEN_2019-11-03
MIN,2019-10-24,19,Thu,8,8,,WAS,W 19-9,19,9,10,28,MIN_WAS_2019-10-24
IND,2019-10-06,19,Sun,5,5,@,KAN,W 19-13,19,13,6,32,IND_KAN_2019-10-06
IND,2019-09-15,19,Sun,2,2,@,TEN,W 19-17,19,17,2,36,IND_TEN_2019-09-15
CAR,2018-11-18,19,Sun,10,11,@,DET,L 19-20,19,20,-1,39,CAR_DET_2018-11-18
ATL,2018-11-18,19,Sun,10,11,,DAL,L 19-22,19,22,-3,41,ATL_DAL_2018-11-18
HOU,2018-11-04,19,Sun,9,9,@,DEN,W 19-17,19,17,2,36,HOU_DEN_2018-11-04
TEN,2018-10-21,19,Sun,7,7,@,LAC,L 19-20,19,20,-1,39,TEN_LAC_2018-10-21
WAS,2018-10-08,19,Mon,4,5,@,NOR,L 19-43,19,43,-24,62,WAS_NOR_2018-10-08
HOU,2018-10-07,19,Sun,5,5,,DAL,W 19-16 (OT),19,16,3,35,HOU_DAL_2018-10-07
OAK,2018-09-16,19,Sun,2,2,@,DEN,L 19-20,19,20,-1,39,OAK_DEN_2018-09-16
PHI,2017-12-25,19,Mon,15,16,,OAK,W 19-10,19,10,9,29,PHI_OAK_2017-12-25
TAM,2017-12-24,19,Sun,15,16,@,CAR,L 19-22,19,22,-3,41,TAM_CAR_2017-12-24
NYJ,2017-12-17,19,Sun,14,15,@,NOR,L 19-31,19,31,-12,50,NYJ_NOR_2017-12-17
LAC,2017-12-03,19,Sun,12,13,,CLE,W 19-10,19,10,9,29,LAC_CLE_2017-12-03
JAX,2017-11-19,19,Sun,10,11,@,CLE,W 19-7,19,7,12,26,JAX_CLE_2017-11-19
DEN,2017-10-30,19,Mon,7,8,@,KAN,L 19-29,19,29,-10,48,DEN_KAN_2017-10-30
WAS,2017-10-29,19,Sun,7,8,,DAL,L 19-33,19,33,-14,52,WAS_DAL_2017-10-29
PIT,2017-10-15,19,Sun,6,6,@,KAN,W 19-13,19,13,6,32,PIT_KAN_2017-10-15
NWE,2017-10-05,19,Thu,5,5,@,TAM,W 19-14,19,14,5,33,NWE_TAM_2017-10-05
MIA,2017-09-17,19,Sun,1,2,@,LAC,W 19-17,19,17,2,36,MIA_LAC_2017-09-17
NOR,2017-09-11,19,Mon,1,1,@,MIN,L 19-29,19,29,-10,48,NOR_MIN_2017-09-11
DAL,2017-09-10,19,Sun,1,1,,NYG,W 19-3,19,3,16,22,DAL_NYG_2017-09-10
NWE,2022-12-24,18,Sat,15,16,,CIN,L 18-22,18,22,-4,40,NWE_CIN_2022-12-24
ATL,2022-12-18,18,Sun,14,15,@,NOR,L 18-21,18,21,-3,39,ATL_NOR_2022-12-18
NYG,2022-11-20,18,Sun,10,11,,DET,L 18-31,18,31,-13,49,NYG_DET_2022-11-20
TAM,2022-10-16,18,Sun,6,6,@,PIT,L 18-20,18,20,-2,38,TAM_PIT_2022-10-16
NOR,2022-01-02,18,Sun,16,17,,CAR,W 18-10,18,10,8,28,NOR_CAR_2022-01-02
NYJ,2021-12-05,18,Sun,12,13,,PHI,L 18-33,18,33,-15,51,NYJ_PHI_2021-12-05
SFO,2021-10-24,18,Sun,6,7,,IND,L 18-30,18,30,-12,48,SFO_IND_2021-10-24
CAR,2021-10-10,18,Sun,5,5,,PHI,L 18-21,18,21,-3,39,CAR_PHI_2021-10-10
LAR,2021-01-03,18,Sun,16,17,,ARI,W 18-7,18,7,11,25,LAR_ARI_2021-01-03
BUF,2020-10-25,18,Sun,7,7,@,NYJ,W 18-10,18,10,8,28,BUF_NYJ_2020-10-25
DEN,2020-10-18,18,Sun,5,6,@,NWE,W 18-12,18,12,6,30,DEN_NWE_2020-10-18
ATL,2019-11-28,18,Thu,12,13,,NOR,L 18-26,18,26,-8,44,ATL_NOR_2019-11-28
NYG,2019-11-04,18,Mon,9,9,,DAL,L 18-37,18,37,-19,55,NYG_DAL_2019-11-04
NYJ,2019-11-03,18,Sun,8,9,@,MIA,L 18-26,18,26,-8,44,NYJ_MIA_2019-11-03
CIN,2018-12-23,18,Sun,15,16,@,CLE,L 18-26,18,26,-8,44,CIN_CLE_2018-12-23
JAX,2018-10-28,18,Sun,8,8,,PHI,L 18-24,18,24,-6,42,JAX_PHI_2018-10-28
ARI,2018-10-28,18,Sun,8,8,,SFO,W 18-15,18,15,3,33,ARI_SFO_2018-10-28
CLE,2018-10-28,18,Sun,8,8,@,PIT,L 18-33,18,33,-15,51,CLE_PIT_2018-10-28
SFO,2018-10-07,18,Sun,5,5,,ARI,L 18-28,18,28,-10,46,SFO_ARI_2018-10-07
NYG,2018-09-30,18,Sun,4,4,,NOR,L 18-33,18,33,-15,51,NYG_NOR_2018-09-30
CLE,2018-09-16,18,Sun,2,2,@,NOR,L 18-21,18,21,-3,39,CLE_NOR_2018-09-16
PHI,2018-09-06,18,Thu,1,1,,ATL,W 18-12,18,12,6,30,PHI_ATL_2018-09-06
NYG,2017-12-31,18,Sun,16,17,,WAS,W 18-10,18,10,8,28,NYG_WAS_2017-12-31
IND,2017-10-01,18,Sun,4,4,@,SEA,L 18-46,18,46,-28,64,IND_SEA_2017-10-01
ARI,2017-10-01,18,Sun,4,4,,SFO,W 18-15 (OT),18,15,3,33,ARI_SFO_2017-10-01
CLE,2017-09-10,18,Sun,1,1,,PIT,L 18-21,18,21,-3,39,CLE_PIT_2017-09-10
TAM,2023-01-08,17,Sun,17,18,@,ATL,L 17-30,17,30,-13,47,TAM_ATL_2023-01-08
MIN,2023-01-01,17,Sun,16,17,@,GNB,L 17-41,17,41,-24,58,MIN_GNB_2023-01-01
BAL,2022-12-24,17,Sat,15,16,,ATL,W 17-9,17,9,8,26,BAL_ATL_2022-12-24
NOR,2022-12-24,17,Sat,15,16,@,CLE,W 17-10,17,10,7,27,NOR_CLE_2022-12-24
LAC,2022-12-18,17,Sun,14,15,,TEN,W 17-14,17,14,3,31,LAC_TEN_2022-12-18
NYJ,2022-12-18,17,Sun,14,15,,DET,L 17-20,17,20,-3,37,NYJ_DET_2022-12-18
MIA,2022-12-11,17,Sun,13,14,@,LAC,L 17-23,17,23,-6,40,MIA_LAC_2022-12-11
LAR,2022-12-08,17,Thu,13,14,,LVR,W 17-16,17,16,1,33,LAR_LVR_2022-12-08
TAM,2022-12-05,17,Mon,12,13,,NOR,W 17-16,17,16,1,33,TAM_NOR_2022-12-05
MIA,2022-12-04,17,Sun,12,13,@,SFO,L 17-33,17,33,-16,50,MIA_SFO_2022-12-04
IND,2022-11-28,17,Mon,12,12,,PIT,L 17-24,17,24,-7,41,IND_PIT_2022-11-28
TAM,2022-11-27,17,Sun,11,12,@,CLE,L 17-23 (OT),17,23,-6,40,TAM_CLE_2022-11-27
PHI,2022-11-20,17,Sun,10,11,@,IND,W 17-16,17,16,1,33,PHI_IND_2022-11-20
GNB,2022-11-17,17,Thu,11,11,,TEN,L 17-27,17,27,-10,44,GNB_TEN_2022-11-17
TEN,2022-11-13,17,Sun,9,10,,DEN,W 17-10,17,10,7,27,TEN_DEN_2022-11-13
CLE,2022-11-13,17,Sun,9,10,@,MIA,L 17-39,17,39,-22,56,CLE_MIA_2022-11-13
LAR,2022-11-13,17,Sun,9,10,,ARI,L 17-27,17,27,-10,44,LAR_ARI_2022-11-13
JAX,2022-11-13,17,Sun,10,10,@,KAN,L 17-27,17,27,-10,44,JAX_KAN_2022-11-13
TEN,2022-11-06,17,Sun,8,9,@,KAN,L 17-20 (OT),17,20,-3,37,TEN_KAN_2022-11-06
WAS,2022-11-06,17,Sun,9,9,,MIN,L 17-20,17,20,-3,37,WAS_MIN_2022-11-06
ATL,2022-11-06,17,Sun,9,9,,LAC,L 17-20,17,20,-3,37,ATL_LAC_2022-11-06
BUF,2022-11-06,17,Sun,8,9,@,NYJ,L 17-20,17,20,-3,37,BUF_NYJ_2022-11-06
HOU,2022-11-03,17,Thu,8,9,,PHI,L 17-29,17,29,-12,46,HOU_PHI_2022-11-03
JAX,2022-10-30,17,Sun,8,8,,DEN,L 17-21,17,21,-4,38,JAX_DEN_2022-10-30
GNB,2022-10-30,17,Sun,8,8,@,BUF,L 17-27,17,27,-10,44,GNB_BUF_2022-10-30
NYJ,2022-10-30,17,Sun,8,8,,NWE,L 17-22,17,22,-5,39,NYJ_NWE_2022-10-30
TEN,2022-10-30,17,Sun,7,8,@,HOU,W 17-10,17,10,7,27,TEN_HOU_2022-10-30
WAS,2022-10-30,17,Sun,8,8,@,IND,W 17-16,17,16,1,33,WAS_IND_2022-10-30
ATL,2022-10-23,17,Sun,7,7,@,CIN,L 17-35,17,35,-18,52,ATL_CIN_2022-10-23
JAX,2022-10-23,17,Sun,7,7,,NYG,L 17-23,17,23,-6,40,JAX_NYG_2022-10-23
DAL,2022-10-16,17,Sun,6,6,@,PHI,L 17-26,17,26,-9,43,DAL_PHI_2022-10-16
WAS,2022-10-09,17,Sun,5,5,,TEN,L 17-21,17,21,-4,38,WAS_TEN_2022-10-09
CIN,2022-10-09,17,Sun,5,5,@,BAL,L 17-19,17,19,-2,36,CIN_BAL_2022-10-09
ARI,2022-10-09,17,Sun,5,5,,PHI,L 17-20,17,20,-3,37,ARI_PHI_2022-10-09
MIA,2022-10-09,17,Sun,5,5,@,NYJ,L 17-40,17,40,-23,57,MIA_NYJ_2022-10-09
IND,2022-10-02,17,Sun,4,4,,TEN,L 17-24,17,24,-7,41,IND_TEN_2022-10-02
KAN,2022-09-25,17,Sun,3,3,@,IND,L 17-20,17,20,-3,37,KAN_IND_2022-09-25
PIT,2022-09-22,17,Thu,3,3,@,CLE,L 17-29,17,29,-12,46,PIT_CLE_2022-09-22
NWE,2022-09-18,17,Sun,2,2,@,PIT,W 17-14,17,14,3,31,NWE_PIT_2022-09-18
CIN,2022-09-18,17,Sun,2,2,@,DAL,L 17-20,17,20,-3,37,CIN_DAL_2022-09-18
SEA,2022-09-12,17,Mon,1,1,,DEN,W 17-16,17,16,1,33,SEA_DEN_2022-09-12
CHI,2022-01-09,17,Sun,17,18,@,MIN,L 17-31,17,31,-14,48,CHI_MIN_2022-01-09
CAR,2022-01-09,17,Sun,17,18,@,TAM,L 17-41,17,41,-24,58,CAR_TAM_2022-01-09
LVR,2021-12-26,17,Sun,15,16,,DEN,W 17-13,17,13,4,30,LVR_DEN_2021-12-26
SFO,2021-12-23,17,Thu,15,16,@,TEN,L 17-20,17,20,-3,37,SFO_TEN_2021-12-23
WAS,2021-12-21,17,Tue,14,15,@,PHI,L 17-27,17,27,-10,44,WAS_PHI_2021-12-21
MIN,2021-12-20,17,Mon,14,15,@,CHI,W 17-9,17,9,8,26,MIN_CHI_2021-12-20
NWE,2021-12-18,17,Sat,14,15,@,IND,L 17-27,17,27,-10,44,NWE_IND_2021-12-18
WAS,2021-12-05,17,Sun,12,13,@,LVR,W 17-15,17,15,2,32,WAS_LVR_2021-12-05
ATL,2021-12-05,17,Sun,12,13,,TAM,L 17-30,17,30,-13,47,ATL_TAM_2021-12-05
NOR,2021-12-02,17,Thu,12,13,,DAL,L 17-27,17,27,-10,44,NOR_DAL_2021-12-02
WAS,2021-11-29,17,Mon,11,12,,SEA,W 17-15,17,15,2,32,WAS_SEA_2021-11-29
NYJ,2021-11-21,17,Sun,10,11,,MIA,L 17-24,17,24,-7,41,NYJ_MIA_2021-11-21
JAX,2021-11-14,17,Sun,9,10,@,IND,L 17-23,17,23,-6,40,JAX_IND_2021-11-14
NYJ,2021-11-14,17,Sun,9,10,,BUF,L 17-45,17,45,-28,62,NYJ_BUF_2021-11-14
GNB,2021-11-14,17,Sun,10,10,,SEA,W 17-0,17,0,17,17,GNB_SEA_2021-11-14
SFO,2021-11-07,17,Sun,8,9,,ARI,L 17-31,17,31,-14,48,SFO_ARI_2021-11-07
MIA,2021-11-07,17,Sun,9,9,,HOU,W 17-9,17,9,8,26,MIA_HOU_2021-11-07
NYG,2021-11-01,17,Mon,8,8,@,KAN,L 17-20,17,20,-3,37,NYG_KAN_2021-11-01
DEN,2021-10-31,17,Sun,8,8,,WAS,W 17-10,17,10,7,27,DEN_WAS_2021-10-31
BAL,2021-10-24,17,Sun,7,7,,CIN,L 17-41,17,41,-24,58,BAL_CIN_2021-10-24
CLE,2021-10-21,17,Thu,7,7,,DEN,W 17-14,17,14,3,31,CLE_DEN_2021-10-21
DET,2021-10-10,17,Sun,5,5,@,MIN,L 17-19,17,19,-2,36,DET_MIN_2021-10-10
MIA,2021-10-10,17,Sun,5,5,@,TAM,L 17-45,17,45,-28,62,MIA_TAM_2021-10-10
ARI,2021-10-10,17,Sun,5,5,,SFO,W 17-10,17,10,7,27,ARI_SFO_2021-10-10
SEA,2021-10-07,17,Thu,5,5,,LAR,L 17-26,17,26,-9,43,SEA_LAR_2021-10-07
MIA,2021-10-03,17,Sun,4,4,,IND,L 17-27,17,27,-10,44,MIA_IND_2021-10-03
NWE,2021-10-03,17,Sun,4,4,,TAM,L 17-19,17,19,-2,36,NWE_TAM_2021-10-03
PIT,2021-10-03,17,Sun,4,4,@,GNB,L 17-27,17,27,-10,44,PIT_GNB_2021-10-03
DET,2021-09-26,17,Sun,3,3,,BAL,L 17-19,17,19,-2,36,DET_BAL_2021-09-26
SEA,2021-09-26,17,Sun,3,3,@,MIN,L 17-30,17,30,-13,47,SEA_MIN_2021-09-26
ATL,2021-09-26,17,Sun,3,3,@,NYG,W 17-14,17,14,3,31,ATL_NYG_2021-09-26
DET,2021-09-20,17,Mon,2,2,@,GNB,L 17-35,17,35,-18,52,DET_GNB_2021-09-20
PIT,2021-09-19,17,Sun,2,2,,LVR,L 17-26,17,26,-9,43,PIT_LVR_2021-09-19
SFO,2021-09-19,17,Sun,2,2,@,PHI,W 17-11,17,11,6,28,SFO_PHI_2021-09-19
CIN,2021-09-19,17,Sun,2,2,@,CHI,L 17-20,17,20,-3,37,CIN_CHI_2021-09-19
LAC,2021-09-19,17,Sun,2,2,,DAL,L 17-20,17,20,-3,37,LAC_DAL_2021-09-19
MIA,2021-09-12,17,Sun,1,1,@,NWE,W 17-16,17,16,1,33,MIA_NWE_2021-09-12
KAN,2020-12-27,17,Sun,15,16,,ATL,W 17-14,17,14,3,31,KAN_ATL_2020-12-27
PHI,2020-12-27,17,Sun,15,16,@,DAL,L 17-37,17,37,-20,54,PHI_DAL_2020-12-27
JAX,2020-12-27,17,Sun,15,16,,CHI,L 17-41,17,41,-24,58,JAX_CHI_2020-12-27
PIT,2020-12-21,17,Mon,14,15,@,CIN,L 17-27,17,27,-10,44,PIT_CIN_2020-12-21
ATL,2020-12-13,17,Sun,13,14,@,LAC,L 17-20,17,20,-3,37,ATL_LAC_2020-12-13
DAL,2020-12-08,17,Tue,12,13,@,BAL,L 17-34,17,34,-17,51,DAL_BAL_2020-12-08
PIT,2020-12-07,17,Mon,12,13,,WAS,L 17-23,17,23,-6,40,PIT_WAS_2020-12-07
NYG,2020-12-06,17,Sun,12,13,@,SEA,W 17-12,17,12,5,29,NYG_SEA_2020-12-06
PHI,2020-11-30,17,Mon,11,12,,SEA,L 17-23,17,23,-6,40,PHI_SEA_2020-11-30
ARI,2020-11-29,17,Sun,11,12,@,NWE,L 17-20,17,20,-3,37,ARI_NWE_2020-11-29
CIN,2020-11-29,17,Sun,11,12,,NYG,L 17-19,17,19,-2,36,CIN_NYG_2020-11-29
LAC,2020-11-29,17,Sun,11,12,@,BUF,L 17-27,17,27,-10,44,LAC_BUF_2020-11-29
PHI,2020-11-22,17,Sun,10,11,@,CLE,L 17-22,17,22,-5,39,PHI_CLE_2020-11-22
PHI,2020-11-15,17,Sun,9,10,@,NYG,L 17-27,17,27,-10,44,PHI_NYG_2020-11-15
BAL,2020-11-15,17,Sun,9,10,@,NWE,L 17-23,17,23,-6,40,BAL_NWE_2020-11-15
TEN,2020-11-12,17,Thu,9,10,,IND,L 17-34,17,34,-17,51,TEN_IND_2020-11-12
CHI,2020-11-08,17,Sun,9,9,@,TEN,L 17-24,17,24,-7,41,CHI_TEN_2020-11-08
SFO,2020-11-05,17,Thu,9,9,,GNB,L 17-34,17,34,-17,51,SFO_GNB_2020-11-05
LAR,2020-11-01,17,Sun,8,8,@,MIA,L 17-28,17,28,-11,45,LAR_MIA_2020-11-01
CAR,2020-10-29,17,Thu,8,8,,ATL,L 17-25,17,25,-8,42,CAR_ATL_2020-10-29
BUF,2020-10-19,17,Mon,6,6,,KAN,L 17-26,17,26,-9,43,BUF_KAN_2020-10-19
SFO,2020-10-11,17,Sun,5,5,,MIA,L 17-43,17,43,-26,60,SFO_MIA_2020-10-11
LAR,2020-10-04,17,Sun,4,4,,NYG,W 17-9,17,9,8,26,LAR_NYG_2020-10-04
WAS,2020-10-04,17,Sun,4,4,,BAL,L 17-31,17,31,-14,48,WAS_BAL_2020-10-04
CHI,2020-09-20,17,Sun,2,2,,NYG,W 17-13,17,13,4,30,CHI_NYG_2020-09-20
CAR,2020-09-20,17,Sun,2,2,@,TAM,L 17-31,17,31,-14,48,CAR_TAM_2020-09-20
PHI,2020-09-13,17,Sun,1,1,@,WAS,L 17-27,17,27,-10,44,PHI_WAS_2020-09-13
NYJ,2020-09-13,17,Sun,1,1,@,BUF,L 17-27,17,27,-10,44,NYJ_BUF_2020-09-13
DAL,2020-09-13,17,Sun,1,1,@,LAR,L 17-20,17,20,-3,37,DAL_LAR_2020-09-13
NYG,2019-12-29,17,Sun,16,17,,PHI,L 17-34,17,34,-17,51,NYG_PHI_2019-12-29
DET,2019-12-22,17,Sun,15,16,@,DEN,L 17-27,17,27,-10,44,DET_DEN_2019-12-22
PHI,2019-12-22,17,Sun,15,16,,DAL,W 17-9,17,9,8,26,PHI_DAL_2019-12-22
LAC,2019-12-22,17,Sun,15,16,,OAK,L 17-24,17,24,-7,41,LAC_OAK_2019-12-22
BUF,2019-12-21,17,Sat,15,16,@,NWE,L 17-24,17,24,-7,41,BUF_NWE_2019-12-21
DET,2019-12-15,17,Sun,14,15,,TAM,L 17-38,17,38,-21,55,DET_TAM_2019-12-15
BUF,2019-12-15,17,Sun,14,15,@,PIT,W 17-10,17,10,7,27,BUF_PIT_2019-12-15
NYG,2019-12-09,17,Mon,13,14,@,PHI,L 17-23 (OT),17,23,-6,40,NYG_PHI_2019-12-09
ARI,2019-12-08,17,Sun,13,14,,PIT,L 17-23,17,23,-6,40,ARI_PIT_2019-12-08
BUF,2019-12-08,17,Sun,13,14,,BAL,L 17-24,17,24,-7,41,BUF_BAL_2019-12-08
IND,2019-12-01,17,Sun,12,13,,TEN,L 17-31,17,31,-14,48,IND_TEN_2019-12-01
SFO,2019-12-01,17,Sun,12,13,@,BAL,L 17-20,17,20,-3,37,SFO_BAL_2019-12-01
SEA,2019-11-24,17,Sun,11,12,@,PHI,W 17-9,17,9,8,26,SEA_PHI_2019-11-24
IND,2019-11-21,17,Thu,11,12,@,HOU,L 17-20,17,20,-3,37,IND_HOU_2019-11-21
LAC,2019-11-18,17,Mon,11,11,,KAN,L 17-24,17,24,-7,41,LAC_KAN_2019-11-18
NWE,2019-11-17,17,Sun,10,11,@,PHI,W 17-10,17,10,7,27,NWE_PHI_2019-11-17
WAS,2019-11-17,17,Sun,10,11,,NYJ,L 17-34,17,34,-17,51,WAS_NYJ_2019-11-17
LAR,2019-11-17,17,Sun,10,11,,CHI,W 17-7,17,7,10,24,LAR_CHI_2019-11-17
OAK,2019-11-17,17,Sun,10,11,,CIN,W 17-10,17,10,7,27,OAK_CIN_2019-11-17
TAM,2019-11-17,17,Sun,10,11,,NOR,L 17-34,17,34,-17,51,TAM_NOR_2019-11-17
PIT,2019-11-10,17,Sun,9,10,,LAR,W 17-12,17,12,5,29,PIT_LAR_2019-11-10
LAC,2019-10-27,17,Sun,8,8,@,CHI,W 17-16,17,16,1,33,LAC_CHI_2019-10-27
CIN,2019-10-20,17,Sun,7,7,,JAX,L 17-27,17,27,-10,44,CIN_JAX_2019-10-20
WAS,2019-10-13,17,Sun,6,6,@,MIA,W 17-16,17,16,1,33,WAS_MIA_2019-10-13
LAC,2019-10-13,17,Sun,6,6,,PIT,L 17-24,17,24,-7,41,LAC_PIT_2019-10-13
CIN,2019-10-13,17,Sun,6,6,@,BAL,L 17-23,17,23,-6,40,CIN_BAL_2019-10-13
CIN,2019-09-22,17,Sun,3,3,@,BUF,L 17-21,17,21,-4,38,CIN_BUF_2019-09-22
CIN,2019-09-15,17,Sun,2,2,,SFO,L 17-41,17,41,-24,58,CIN_SFO_2019-09-15
ARI,2019-09-15,17,Sun,2,2,@,BAL,L 17-23,17,23,-6,40,ARI_BAL_2019-09-15
TEN,2019-09-15,17,Sun,2,2,,IND,L 17-19,17,19,-2,36,TEN_IND_2019-09-15
BUF,2019-09-08,17,Sun,1,1,@,NYJ,W 17-16,17,16,1,33,BUF_NYJ_2019-09-08
TAM,2019-09-08,17,Sun,1,1,,SFO,L 17-31,17,31,-14,48,TAM_SFO_2019-09-08
NYG,2019-09-08,17,Sun,1,1,@,DAL,L 17-35,17,35,-18,52,NYG_DAL_2019-09-08
TEN,2018-12-30,17,Sun,16,17,,IND,L 17-33,17,33,-16,50,TEN_IND_2018-12-30
MIA,2018-12-30,17,Sun,16,17,@,BUF,L 17-42,17,42,-25,59,MIA_BUF_2018-12-30
JAX,2018-12-23,17,Sun,15,16,@,MIA,W 17-7,17,7,10,24,JAX_MIA_2018-12-23
TEN,2018-12-16,17,Sun,14,15,@,NYG,W 17-0,17,0,17,17,TEN_NYG_2018-12-16
MIA,2018-12-16,17,Sun,14,15,@,MIN,L 17-41,17,41,-24,58,MIA_MIN_2018-12-16
GNB,2018-12-16,17,Sun,14,15,@,CHI,L 17-24,17,24,-7,41,GNB_CHI_2018-12-16
PIT,2018-12-16,17,Sun,14,15,,NWE,W 17-10,17,10,7,27,PIT_NWE_2018-12-16
CLE,2018-12-15,17,Sat,14,15,@,DEN,W 17-16,17,16,1,33,CLE_DEN_2018-12-15
DET,2018-12-09,17,Sun,13,14,@,ARI,W 17-3,17,3,14,20,DET_ARI_2018-12-09
CAR,2018-12-02,17,Sun,12,13,@,TAM,L 17-24,17,24,-7,41,CAR_TAM_2018-12-02
BUF,2018-12-02,17,Sun,12,13,@,MIA,L 17-21,17,21,-4,38,BUF_MIA_2018-12-02
GNB,2018-12-02,17,Sun,12,13,,ARI,L 17-20,17,20,-3,37,GNB_ARI_2018-12-02
TEN,2018-11-26,17,Mon,11,12,@,HOU,L 17-34,17,34,-17,51,TEN_HOU_2018-11-26
OAK,2018-11-25,17,Sun,11,12,@,BAL,L 17-34,17,34,-17,51,OAK_BAL_2018-11-25
GNB,2018-11-25,17,Sun,11,12,@,MIN,L 17-24,17,24,-7,41,GNB_MIN_2018-11-25
PIT,2018-11-25,17,Sun,11,12,@,DEN,L 17-24,17,24,-7,41,PIT_DEN_2018-11-25
ATL,2018-11-22,17,Thu,11,12,@,NOR,L 17-31,17,31,-14,48,ATL_NOR_2018-11-22
SEA,2018-11-04,17,Sun,8,9,,LAC,L 17-25,17,25,-8,42,SEA_LAC_2018-11-04
GNB,2018-11-04,17,Sun,8,9,@,NWE,L 17-31,17,31,-14,48,GNB_NWE_2018-11-04
DEN,2018-11-04,17,Sun,9,9,,HOU,L 17-19,17,19,-2,36,DEN_HOU_2018-11-04
DAL,2018-10-21,17,Sun,7,7,@,WAS,L 17-20,17,20,-3,37,DAL_WAS_2018-10-21
NYJ,2018-10-21,17,Sun,7,7,,MIN,L 17-37,17,37,-20,54,NYJ_MIN_2018-10-21
PHI,2018-10-21,17,Sun,7,7,,CAR,L 17-21,17,21,-4,38,PHI_CAR_2018-10-21
CAR,2018-10-14,17,Sun,5,6,@,WAS,L 17-23,17,23,-6,40,CAR_WAS_2018-10-14
ARI,2018-10-14,17,Sun,6,6,@,MIN,L 17-27,17,27,-10,44,ARI_MIN_2018-10-14
MIA,2018-10-07,17,Sun,5,5,@,CIN,L 17-27,17,27,-10,44,MIA_CIN_2018-10-07
ATL,2018-10-07,17,Sun,5,5,@,PIT,L 17-41,17,41,-24,58,ATL_PIT_2018-10-07
ARI,2018-09-30,17,Sun,4,4,,SEA,L 17-20,17,20,-3,37,ARI_SEA_2018-09-30
GNB,2018-09-23,17,Sun,3,3,@,WAS,L 17-31,17,31,-14,48,GNB_WAS_2018-09-23
NYJ,2018-09-20,17,Thu,3,3,@,CLE,L 17-21,17,21,-4,38,NYJ_CLE_2018-09-20
SEA,2018-09-17,17,Mon,2,2,@,CHI,L 17-24,17,24,-7,41,SEA_CHI_2018-09-17
HOU,2018-09-16,17,Sun,2,2,@,TEN,L 17-20,17,20,-3,37,HOU_TEN_2018-09-16
DET,2018-09-10,17,Mon,1,1,,NYJ,L 17-48,17,48,-31,65,DET_NYJ_2018-09-10
DET,2017-12-24,17,Sun,15,16,@,CIN,L 17-26,17,26,-9,43,DET_CIN_2017-12-24
OAK,2017-12-17,17,Sun,14,15,,DAL,L 17-20,17,20,-3,37,OAK_DAL_2017-12-17
NOR,2017-12-07,17,Thu,13,14,@,ATL,L 17-20,17,20,-3,37,NOR_ATL_2017-12-07
NYG,2017-12-03,17,Sun,12,13,@,OAK,L 17-24,17,24,-7,41,NYG_OAK_2017-12-03
MIA,2017-11-26,17,Sun,11,12,@,NWE,L 17-35,17,35,-18,52,MIA_NWE_2017-11-26
DEN,2017-11-19,17,Sun,10,11,,CIN,L 17-20,17,20,-3,37,DEN_CIN_2017-11-19
TEN,2017-11-16,17,Thu,10,11,@,PIT,L 17-40,17,40,-23,57,TEN_PIT_2017-11-16
IND,2017-11-12,17,Sun,10,10,,PIT,L 17-20,17,20,-3,37,IND_PIT_2017-11-12
LAC,2017-11-12,17,Sun,9,10,@,JAX,L 17-20 (OT),17,20,-3,37,LAC_JAX_2017-11-12
GNB,2017-11-06,17,Mon,8,9,,DET,L 17-30,17,30,-13,47,GNB_DET_2017-11-06
NYG,2017-11-05,17,Sun,8,9,,LAR,L 17-51,17,51,-34,68,NYG_LAR_2017-11-05
WAS,2017-11-05,17,Sun,8,9,@,SEA,W 17-14,17,14,3,31,WAS_SEA_2017-11-05
ATL,2017-11-05,17,Sun,8,9,@,CAR,L 17-20,17,20,-3,37,ATL_CAR_2017-11-05
KAN,2017-11-05,17,Sun,9,9,@,DAL,L 17-28,17,28,-11,45,KAN_DAL_2017-11-05
CAR,2017-10-29,17,Sun,8,8,@,TAM,W 17-3,17,3,14,20,CAR_TAM_2017-10-29
GNB,2017-10-22,17,Sun,7,7,,NOR,L 17-26,17,26,-9,43,GNB_NOR_2017-10-22
CHI,2017-10-22,17,Sun,7,7,,CAR,W 17-3,17,3,14,20,CHI_CAR_2017-10-22
JAX,2017-10-15,17,Sun,6,6,,LAR,L 17-27,17,27,-10,44,JAX_LAR_2017-10-15
NYJ,2017-10-15,17,Sun,6,6,,NWE,L 17-24,17,24,-7,41,NYJ_NWE_2017-10-15
CLE,2017-10-15,17,Sun,6,6,@,HOU,L 17-33,17,33,-16,50,CLE_HOU_2017-10-15
LAC,2017-10-15,17,Sun,6,6,@,OAK,W 17-16,17,16,1,33,LAC_OAK_2017-10-15
ATL,2017-10-15,17,Sun,5,6,,MIA,L 17-20,17,20,-3,37,ATL_MIA_2017-10-15
CHI,2017-10-09,17,Mon,5,5,,MIN,L 17-20,17,20,-3,37,CHI_MIN_2017-10-09
NYJ,2017-10-08,17,Sun,5,5,@,CLE,W 17-14,17,14,3,31,NYJ_CLE_2017-10-08
OAK,2017-10-08,17,Sun,5,5,,BAL,L 17-30,17,30,-13,47,OAK_BAL_2017-10-08
ATL,2017-10-01,17,Sun,4,4,,BUF,L 17-23,17,23,-6,40,ATL_BUF_2017-10-01
ARI,2017-09-25,17,Mon,3,3,,DAL,L 17-28,17,28,-11,45,ARI_DAL_2017-09-25
TAM,2017-09-24,17,Sun,2,3,@,MIN,L 17-34,17,34,-17,51,TAM_MIN_2017-09-24
PIT,2017-09-24,17,Sun,3,3,@,CHI,L 17-23 (OT),17,23,-6,40,PIT_CHI_2017-09-24
DAL,2017-09-17,17,Sun,2,2,@,DEN,L 17-42,17,42,-25,59,DAL_DEN_2017-09-17
LAC,2017-09-17,17,Sun,2,2,,MIA,L 17-19,17,19,-2,36,LAC_MIA_2017-09-17
GNB,2017-09-10,17,Sun,1,1,,SEA,W 17-9,17,9,8,26,GNB_SEA_2017-09-10
CHI,2017-09-10,17,Sun,1,1,,ATL,L 17-23,17,23,-6,40,CHI_ATL_2017-09-10
WAS,2017-09-10,17,Sun,1,1,,PHI,L 17-30,17,30,-13,47,WAS_PHI_2017-09-10
BAL,2023-01-08,16,Sun,17,18,@,CIN,L 16-27,16,27,-11,43,BAL_CIN_2023-01-08
LAR,2023-01-08,16,Sun,17,18,@,SEA,L 16-19 (OT),16,19,-3,35,LAR_SEA_2023-01-08
GNB,2023-01-08,16,Sun,17,18,,DET,L 16-20,16,20,-4,36,GNB_DET_2023-01-08
NYG,2023-01-08,16,Sun,17,18,@,PHI,L 16-22,16,22,-6,38,NYG_PHI_2023-01-08
TEN,2023-01-07,16,Sat,17,18,@,JAX,L 16-20,16,20,-4,36,TEN_JAX_2023-01-07
PIT,2023-01-01,16,Sun,16,17,@,BAL,W 16-13,16,13,3,29,PIT_BAL_2023-01-01
ARI,2022-12-25,16,Sun,15,16,,TAM,L 16-19 (OT),16,19,-3,35,ARI_TAM_2022-12-25
CAR,2022-12-18,16,Sun,14,15,,PIT,L 16-24,16,24,-8,40,CAR_PIT_2022-12-18
BAL,2022-12-11,16,Sun,13,14,@,PIT,W 16-14,16,14,2,30,BAL_PIT_2022-12-11
LVR,2022-12-08,16,Thu,13,14,@,LAR,L 16-17,16,17,-1,33,LVR_LAR_2022-12-08
NOR,2022-12-05,16,Mon,13,13,@,TAM,L 16-17,16,17,-1,33,NOR_TAM_2022-12-05
ATL,2022-12-04,16,Sun,13,13,,PIT,L 16-19,16,19,-3,35,ATL_PIT_2022-12-04
TEN,2022-11-27,16,Sun,11,12,,CIN,L 16-20,16,20,-4,36,TEN_CIN_2022-11-27
DEN,2022-11-20,16,Sun,10,11,,LVR,L 16-22 (OT),16,22,-6,38,DEN_LVR_2022-11-20
IND,2022-11-20,16,Sun,11,11,,PHI,L 16-17,16,17,-1,33,IND_PHI_2022-11-20
SEA,2022-11-13,16,Sun,10,10,@,TAM,L 16-21,16,21,-5,37,SEA_TAM_2022-11-13
LAC,2022-11-13,16,Sun,9,10,@,SFO,L 16-22,16,22,-6,38,LAC_SFO_2022-11-13
HOU,2022-11-13,16,Sun,9,10,@,NYG,L 16-24,16,24,-8,40,HOU_NYG_2022-11-13
TAM,2022-11-06,16,Sun,9,9,,LAR,W 16-13,16,13,3,29,TAM_LAR_2022-11-06
IND,2022-10-30,16,Sun,8,8,,WAS,L 16-17,16,17,-1,33,IND_WAS_2022-10-30
NYJ,2022-10-23,16,Sun,7,7,@,DEN,W 16-9,16,9,7,25,NYJ_DEN_2022-10-23
MIA,2022-10-23,16,Sun,7,7,,PIT,W 16-10,16,10,6,26,MIA_PIT_2022-10-23
DEN,2022-10-17,16,Mon,6,6,@,LAC,L 16-19 (OT),16,19,-3,35,DEN_LAC_2022-10-17
MIA,2022-10-16,16,Sun,6,6,,MIN,L 16-24,16,24,-8,40,MIA_MIN_2022-10-16
CAR,2022-10-02,16,Sun,4,4,,ARI,L 16-26,16,26,-10,42,CAR_ARI_2022-10-02
NYG,2022-09-26,16,Mon,3,3,,DAL,L 16-23,16,23,-7,39,NYG_DAL_2022-09-26
DEN,2022-09-18,16,Sun,2,2,,HOU,W 16-9,16,9,7,25,DEN_HOU_2022-09-18
CAR,2022-09-18,16,Sun,2,2,@,NYG,L 16-19,16,19,-3,35,CAR_NYG_2022-09-18
DEN,2022-09-12,16,Mon,1,1,@,SEA,L 16-17,16,17,-1,33,DEN_SEA_2022-09-12
PIT,2022-01-09,16,Sun,17,18,@,BAL,W 16-13 (OT),16,13,3,29,PIT_BAL_2022-01-09
CIN,2022-01-09,16,Sun,17,18,@,CLE,L 16-21,16,21,-5,37,CIN_CLE_2022-01-09
WAS,2022-01-02,16,Sun,16,17,,PHI,L 16-20,16,20,-4,36,WAS_PHI_2022-01-02
DET,2021-12-26,16,Sun,15,16,@,ATL,L 16-20,16,20,-4,36,DET_ATL_2021-12-26
ARI,2021-12-25,16,Sat,15,16,,IND,L 16-22,16,22,-6,38,ARI_IND_2021-12-25
LVR,2021-12-20,16,Mon,14,15,@,CLE,W 16-14,16,14,2,30,LVR_CLE_2021-12-20
JAX,2021-12-19,16,Sun,14,15,,HOU,L 16-30,16,30,-14,46,JAX_HOU_2021-12-19
BAL,2021-11-28,16,Sun,11,12,,CLE,W 16-10,16,10,6,26,BAL_CLE_2021-11-28
CHI,2021-11-25,16,Thu,11,12,@,DET,W 16-14,16,14,2,30,CHI_DET_2021-11-25
BAL,2021-11-21,16,Sun,10,11,@,CHI,W 16-13,16,13,3,29,BAL_CHI_2021-11-21
PIT,2021-11-14,16,Sun,9,10,,DET,T 16-16 (OT),16,16,0,32,PIT_DET_2021-11-14
DET,2021-11-14,16,Sun,9,10,@,PIT,T 16-16 (OT),16,16,0,32,DET_PIT_2021-11-14
DAL,2021-11-07,16,Sun,8,9,,DEN,L 16-30,16,30,-14,46,DAL_DEN_2021-11-07
LAR,2021-11-07,16,Sun,9,9,,TEN,L 16-28,16,28,-12,44,LAR_TEN_2021-11-07
CIN,2021-11-07,16,Sun,9,9,,CLE,L 16-41,16,41,-25,57,CIN_CLE_2021-11-07
LVR,2021-11-07,16,Sun,8,9,@,NYG,L 16-23,16,23,-7,39,LVR_NYG_2021-11-07
MIN,2021-10-31,16,Sun,7,8,,DAL,L 16-20,16,20,-4,36,MIN_DAL_2021-10-31
IND,2021-09-26,16,Sun,3,3,@,TEN,L 16-25,16,25,-9,41,IND_TEN_2021-09-26
WAS,2021-09-12,16,Sun,1,1,,LAC,L 16-20,16,20,-4,36,WAS_LAC_2021-09-12
NWE,2021-09-12,16,Sun,1,1,,MIA,L 16-17,16,17,-1,33,NWE_MIA_2021-09-12
IND,2021-09-12,16,Sun,1,1,,SEA,L 16-28,16,28,-12,44,IND_SEA_2021-09-12
BUF,2021-09-12,16,Sun,1,1,,PIT,L 16-23,16,23,-7,39,BUF_PIT_2021-09-12
CHI,2021-01-03,16,Sun,16,17,,GNB,L 16-35,16,35,-19,51,CHI_GNB_2021-01-03
DEN,2020-12-27,16,Sun,15,16,@,LAC,L 16-19,16,19,-3,35,DEN_LAC_2020-12-27
CLE,2020-12-27,16,Sun,15,16,@,NYJ,L 16-23,16,23,-7,39,CLE_NYJ_2020-12-27
CAR,2020-12-19,16,Sat,14,15,@,GNB,L 16-24,16,24,-8,40,CAR_GNB_2020-12-19
DEN,2020-12-06,16,Sun,12,13,@,KAN,L 16-22,16,22,-6,38,DEN_KAN_2020-12-06
PHI,2020-12-06,16,Sun,12,13,@,GNB,L 16-30,16,30,-14,46,PHI_GNB_2020-12-06
ATL,2020-12-06,16,Sun,12,13,,NOR,L 16-21,16,21,-5,37,ATL_NOR_2020-12-06
DAL,2020-11-26,16,Thu,11,12,,WAS,L 16-41,16,41,-25,57,DAL_WAS_2020-11-26
SEA,2020-11-15,16,Sun,9,10,@,LAR,L 16-23,16,23,-7,39,SEA_LAR_2020-11-15
LVR,2020-11-01,16,Sun,7,8,@,CLE,W 16-6,16,6,10,22,LVR_CLE_2020-11-01
DEN,2020-10-25,16,Sun,6,7,,KAN,L 16-43,16,43,-27,59,DEN_KAN_2020-10-25
JAX,2020-10-18,16,Sun,6,6,,DET,L 16-34,16,34,-18,50,JAX_DET_2020-10-18
LAR,2020-10-18,16,Sun,6,6,@,SFO,L 16-24,16,24,-8,40,LAR_SFO_2020-10-18
CAR,2020-10-18,16,Sun,6,6,,CHI,L 16-23,16,23,-7,39,CAR_CHI_2020-10-18
BUF,2020-10-13,16,Tue,5,5,@,TEN,L 16-42,16,42,-26,58,BUF_TEN_2020-10-13
ATL,2020-10-11,16,Sun,5,5,,CAR,L 16-23,16,23,-7,39,ATL_CAR_2020-10-11
ATL,2020-10-05,16,Mon,4,4,@,GNB,L 16-30,16,30,-14,46,ATL_GNB_2020-10-05
LAC,2020-09-27,16,Sun,3,3,,CAR,L 16-21,16,21,-5,37,LAC_CAR_2020-09-27
HOU,2020-09-20,16,Sun,2,2,,BAL,L 16-33,16,33,-17,49,HOU_BAL_2020-09-20
TEN,2020-09-14,16,Mon,1,1,@,DEN,W 16-14,16,14,2,30,TEN_DEN_2020-09-14
NYG,2020-09-14,16,Mon,1,1,,PIT,L 16-26,16,26,-10,42,NYG_PIT_2020-09-14
LAC,2020-09-13,16,Sun,1,1,@,CIN,W 16-13,16,13,3,29,LAC_CIN_2020-09-13
WAS,2019-12-29,16,Sun,16,17,@,DAL,L 16-47,16,47,-31,63,WAS_DAL_2019-12-29
DEN,2019-12-29,16,Sun,16,17,,OAK,W 16-15,16,15,1,31,DEN_OAK_2019-12-29
NYJ,2019-12-22,16,Sun,15,16,,PIT,W 16-10,16,10,6,26,NYJ_PIT_2019-12-22
OAK,2019-12-15,16,Sun,14,15,,JAX,L 16-20,16,20,-4,36,OAK_JAX_2019-12-15
NWE,2019-12-08,16,Sun,13,14,,KAN,L 16-23,16,23,-7,39,NWE_KAN_2019-12-08
PIT,2019-11-24,16,Sun,11,12,@,CIN,W 16-10,16,10,6,26,PIT_CIN_2019-11-24
DET,2019-11-24,16,Sun,11,12,@,WAS,L 16-19,16,19,-3,35,DET_WAS_2019-11-24
CAR,2019-11-10,16,Sun,9,10,@,GNB,L 16-24,16,24,-8,40,CAR_GNB_2019-11-10
BUF,2019-11-10,16,Sun,9,10,@,CLE,L 16-19,16,19,-3,35,BUF_CLE_2019-11-10
MIA,2019-11-10,16,Sun,9,10,@,IND,W 16-12,16,12,4,28,MIA_IND_2019-11-10
CHI,2019-10-27,16,Sun,7,8,,LAC,L 16-17,16,17,-1,33,CHI_LAC_2019-10-27
SEA,2019-10-20,16,Sun,7,7,,BAL,L 16-30,16,30,-14,46,SEA_BAL_2019-10-20
DEN,2019-10-13,16,Sun,6,6,,TEN,W 16-0,16,0,16,16,DEN_TEN_2019-10-13
MIA,2019-10-13,16,Sun,5,6,,WAS,L 16-17,16,17,-1,33,MIA_WAS_2019-10-13
NWE,2019-09-29,16,Sun,4,4,@,BUF,W 16-10,16,10,6,26,NWE_BUF_2019-09-29
CAR,2019-09-29,16,Sun,4,4,@,HOU,W 16-10,16,10,6,26,CAR_HOU_2019-09-29
CHI,2019-09-29,16,Sun,4,4,,MIN,W 16-6,16,6,10,22,CHI_MIN_2019-09-29
DEN,2019-09-22,16,Sun,3,3,@,GNB,L 16-27,16,27,-11,43,DEN_GNB_2019-09-22
CHI,2019-09-15,16,Sun,2,2,@,DEN,W 16-14,16,14,2,30,CHI_DEN_2019-09-15
MIN,2019-09-15,16,Sun,2,2,@,GNB,L 16-21,16,21,-5,37,MIN_GNB_2019-09-15
DEN,2019-09-09,16,Mon,1,1,@,OAK,L 16-24,16,24,-8,40,DEN_OAK_2019-09-09
NYJ,2019-09-08,16,Sun,1,1,,BUF,L 16-17,16,17,-1,33,NYJ_BUF_2019-09-08
PIT,2018-12-30,16,Sun,16,17,,CIN,W 16-13,16,13,3,29,PIT_CIN_2018-12-30
WAS,2018-12-22,16,Sat,15,16,@,TEN,L 16-25,16,25,-9,41,WAS_TEN_2018-12-22
OAK,2018-12-16,16,Sun,14,15,@,CIN,L 16-30,16,30,-14,46,OAK_CIN_2018-12-16
WAS,2018-12-16,16,Sun,14,15,@,JAX,W 16-13,16,13,3,29,WAS_JAX_2018-12-16
DEN,2018-12-15,16,Sat,14,15,,CLE,L 16-17,16,17,-1,33,DEN_CLE_2018-12-15
WAS,2018-12-09,16,Sun,13,14,,NYG,L 16-40,16,40,-24,56,WAS_NYG_2018-12-09
DET,2018-12-02,16,Sun,12,13,,LAR,L 16-30,16,30,-14,46,DET_LAR_2018-12-02
ATL,2018-12-02,16,Sun,12,13,,BAL,L 16-26,16,26,-10,42,ATL_BAL_2018-12-02
SFO,2018-12-02,16,Sun,12,13,@,SEA,L 16-43,16,43,-27,59,SFO_SEA_2018-12-02
DET,2018-11-22,16,Thu,11,12,,CHI,L 16-23,16,23,-7,39,DET_CHI_2018-11-22
JAX,2018-11-18,16,Sun,10,11,,PIT,L 16-20,16,20,-4,36,JAX_PIT_2018-11-18
ATL,2018-11-11,16,Sun,9,10,@,CLE,L 16-28,16,28,-12,44,ATL_CLE_2018-11-11
WAS,2018-11-11,16,Sun,9,10,@,TAM,W 16-3,16,3,13,19,WAS_TAM_2018-11-11
BAL,2018-11-04,16,Sun,9,9,,PIT,L 16-23,16,23,-7,39,BAL_PIT_2018-11-04
DAL,2018-10-07,16,Sun,5,5,@,HOU,L 16-19 (OT),16,19,-3,35,DAL_HOU_2018-10-07
DEN,2018-10-07,16,Sun,5,5,@,NYJ,L 16-34,16,34,-18,50,DEN_NYJ_2018-10-07
CHI,2018-09-23,16,Sun,3,3,@,ARI,W 16-14,16,14,2,30,CHI_ARI_2018-09-23
IND,2018-09-23,16,Sun,3,3,@,PHI,L 16-20,16,20,-4,36,IND_PHI_2018-09-23
CAR,2018-09-09,16,Sun,1,1,,DAL,W 16-8,16,8,8,24,CAR_DAL_2018-09-09
SFO,2018-09-09,16,Sun,1,1,@,MIN,L 16-24,16,24,-8,40,SFO_MIN_2018-09-09
MIA,2017-12-31,16,Sun,16,17,,BUF,L 16-22,16,22,-6,38,MIA_BUF_2017-12-31
BUF,2017-12-24,16,Sun,15,16,@,NWE,L 16-37,16,37,-21,53,BUF_NWE_2017-12-24
MIN,2017-12-23,16,Sat,15,16,@,GNB,W 16-0,16,0,16,16,MIN_GNB_2017-12-23
IND,2017-12-23,16,Sat,15,16,@,BAL,L 16-23,16,23,-7,39,IND_BAL_2017-12-23
MIA,2017-12-17,16,Sun,14,15,@,BUF,L 16-24,16,24,-8,40,MIA_BUF_2017-12-17
HOU,2017-12-10,16,Sun,13,14,,SFO,L 16-26,16,26,-10,42,HOU_SFO_2017-12-10
ARI,2017-12-03,16,Sun,12,13,,LAR,L 16-32,16,32,-16,48,ARI_LAR_2017-12-03
HOU,2017-11-27,16,Mon,11,12,@,BAL,L 16-23,16,23,-7,39,HOU_BAL_2017-11-27
CLE,2017-11-26,16,Sun,11,12,@,CIN,L 16-30,16,30,-14,46,CLE_CIN_2017-11-26
BUF,2017-11-26,16,Sun,11,12,@,KAN,W 16-10,16,10,6,26,BUF_KAN_2017-11-26
IND,2017-11-26,16,Sun,11,12,,TEN,L 16-20,16,20,-4,36,IND_TEN_2017-11-26
CHI,2017-11-12,16,Sun,9,10,,GNB,L 16-23,16,23,-7,39,CHI_GNB_2017-11-12
DEN,2017-11-12,16,Sun,9,10,,NWE,L 16-41,16,41,-25,57,DEN_NWE_2017-11-12
ARI,2017-11-09,16,Thu,9,10,,SEA,L 16-22,16,22,-6,38,ARI_SEA_2017-11-09
CLE,2017-10-29,16,Sun,8,8,,MIN,L 16-33,16,33,-17,49,CLE_MIN_2017-10-29
BAL,2017-10-22,16,Sun,7,7,@,MIN,L 16-24,16,24,-8,40,BAL_MIN_2017-10-22
OAK,2017-10-15,16,Sun,6,6,,LAC,L 16-17,16,17,-1,33,OAK_LAC_2017-10-15
BUF,2017-10-08,16,Sun,5,5,@,CIN,L 16-20,16,20,-4,36,BUF_CIN_2017-10-08
MIA,2017-10-08,16,Sun,4,5,,TEN,W 16-10,16,10,6,26,MIA_TEN_2017-10-08
SEA,2017-10-08,16,Sun,5,5,@,LAR,W 16-10,16,10,6,26,SEA_LAR_2017-10-08
DEN,2017-10-01,16,Sun,4,4,,OAK,W 16-10,16,10,6,26,DEN_OAK_2017-10-01
DEN,2017-09-24,16,Sun,3,3,@,BUF,L 16-26,16,26,-10,42,DEN_BUF_2017-09-24
ARI,2017-09-17,16,Sun,2,2,@,IND,W 16-13 (OT),16,13,3,29,ARI_IND_2017-09-17
JAX,2017-09-17,16,Sun,2,2,,TEN,L 16-37,16,37,-21,53,JAX_TEN_2017-09-17
TEN,2017-09-10,16,Sun,1,1,,OAK,L 16-26,16,26,-10,42,TEN_OAK_2017-09-10
ARI,2022-12-18,15,Sun,14,15,@,DEN,L 15-24,15,24,-9,39,ARI_DEN_2022-12-18
HOU,2022-11-27,15,Sun,11,12,@,MIA,L 15-30,15,30,-15,45,HOU_MIA_2022-11-27
ATL,2022-11-10,15,Thu,10,10,@,CAR,L 15-25,15,25,-10,40,ATL_CAR_2022-11-10
DET,2022-11-06,15,Sun,8,9,,GNB,W 15-9,15,9,6,24,DET_GNB_2022-11-06
CLE,2022-10-16,15,Sun,6,6,,NWE,L 15-38,15,38,-23,53,CLE_NWE_2022-10-16
CAR,2022-10-09,15,Sun,5,5,,SFO,L 15-37,15,37,-22,52,CAR_SFO_2022-10-09
ATL,2022-10-09,15,Sun,5,5,@,TAM,L 15-21,15,21,-6,36,ATL_TAM_2022-10-09
MIA,2022-09-29,15,Thu,4,4,@,CIN,L 15-27,15,27,-12,42,MIA_CIN_2022-09-29
ATL,2022-01-02,15,Sun,16,17,@,BUF,L 15-29,15,29,-14,44,ATL_BUF_2022-01-02
CIN,2021-12-19,15,Sun,14,15,@,DEN,W 15-10,15,10,5,25,CIN_DEN_2021-12-19
LVR,2021-12-05,15,Sun,12,13,,WAS,L 15-17,15,17,-2,32,LVR_WAS_2021-12-05
SEA,2021-11-29,15,Mon,11,12,@,WAS,L 15-17,15,17,-2,32,SEA_WAS_2021-11-29
BUF,2021-11-21,15,Sun,10,11,,IND,L 15-41,15,41,-26,56,BUF_IND_2021-11-21
PIT,2021-10-31,15,Sun,7,8,@,CLE,W 15-10,15,10,5,25,PIT_CLE_2021-10-31
WAS,2020-12-20,15,Sun,14,15,,SEA,L 15-20,15,20,-5,35,WAS_SEA_2020-12-20
SFO,2020-12-13,15,Sun,13,14,,WAS,L 15-23,15,23,-8,38,SFO_WAS_2020-12-13
PIT,2020-12-13,15,Sun,13,14,@,BUF,L 15-26,15,26,-11,41,PIT_BUF_2020-12-13
WAS,2020-09-20,15,Sun,2,2,@,ARI,L 15-30,15,30,-15,45,WAS_ARI_2020-09-20
OAK,2019-12-29,15,Sun,16,17,@,DEN,L 15-16,15,16,-1,31,OAK_DEN_2019-12-29
CLE,2019-12-22,15,Sun,15,16,,BAL,L 15-31,15,31,-16,46,CLE_BAL_2019-12-22
WAS,2019-12-08,15,Sun,13,14,@,GNB,L 15-20,15,20,-5,35,WAS_GNB_2019-12-08
DAL,2019-11-28,15,Thu,12,13,,BUF,L 15-26,15,26,-11,41,DAL_BUF_2019-11-28
IND,2019-10-27,15,Sun,7,8,,DEN,W 15-13,15,13,2,28,IND_DEN_2019-10-27
NYJ,2019-10-27,15,Sun,7,8,@,JAX,L 15-29,15,29,-14,44,NYJ_JAX_2019-10-27
WAS,2019-09-23,15,Mon,3,3,,CHI,L 15-31,15,31,-16,46,WAS_CHI_2019-09-23
CHI,2018-12-09,15,Sun,13,14,,LAR,W 15-6,15,6,9,21,CHI_LAR_2018-12-09
SFO,2018-10-28,15,Sun,8,8,@,ARI,L 15-18,15,18,-3,33,SFO_ARI_2018-10-28
NYG,2018-09-09,15,Sun,1,1,,JAX,L 15-20,15,20,-5,35,NYG_JAX_2018-09-09
TEN,2017-12-31,15,Sun,16,17,,JAX,W 15-10,15,10,5,25,TEN_JAX_2017-12-31
ARI,2017-12-17,15,Sun,14,15,@,WAS,L 15-20,15,20,-5,35,ARI_WAS_2017-12-17
OAK,2017-12-10,15,Sun,13,14,@,KAN,L 15-26,15,26,-11,41,OAK_KAN_2017-12-10
SFO,2017-12-03,15,Sun,12,13,@,CHI,W 15-14,15,14,1,29,SFO_CHI_2017-12-03
TAM,2017-11-12,15,Sun,9,10,,NYJ,W 15-10,15,10,5,25,TAM_NYJ_2017-11-12
DET,2017-10-29,15,Sun,7,8,,PIT,L 15-20,15,20,-5,35,DET_PIT_2017-10-29
SFO,2017-10-01,15,Sun,4,4,@,ARI,L 15-18 (OT),15,18,-3,33,SFO_ARI_2017-10-01
CLE,2023-01-08,14,Sun,17,18,@,PIT,L 14-28,14,28,-14,42,CLE_PIT_2023-01-08
DEN,2022-12-25,14,Sun,15,16,@,LAR,L 14-51,14,51,-37,65,DEN_LAR_2022-12-25
TEN,2022-12-24,14,Sat,15,16,,HOU,L 14-19,14,19,-5,33,TEN_HOU_2022-12-24
TEN,2022-12-18,14,Sun,14,15,@,LAC,L 14-17,14,17,-3,31,TEN_LAC_2022-12-18
PIT,2022-12-11,14,Sun,13,14,,BAL,L 14-16,14,16,-2,30,PIT_BAL_2022-12-11
HOU,2022-12-04,14,Sun,12,13,,CLE,L 14-27,14,27,-13,41,HOU_CLE_2022-12-04
JAX,2022-12-04,14,Sun,12,13,@,DET,L 14-40,14,40,-26,54,JAX_DET_2022-12-04
LAR,2022-10-30,14,Sun,7,8,,SFO,L 14-31,14,31,-17,45,LAR_SFO_2022-10-30
NWE,2022-10-24,14,Mon,7,7,,CHI,L 14-33,14,33,-19,47,NWE_CHI_2022-10-24
SFO,2022-10-16,14,Sun,6,6,@,ATL,L 14-28,14,28,-14,42,SFO_ATL_2022-10-16
NOR,2022-09-25,14,Sun,3,3,@,CAR,L 14-22,14,22,-8,36,NOR_CAR_2022-09-25
GNB,2022-09-25,14,Sun,3,3,@,TAM,W 14-12,14,12,2,26,GNB_TAM_2022-09-25
PIT,2022-09-18,14,Sun,2,2,,NWE,L 14-17,14,17,-3,31,PIT_NWE_2022-09-18
CLE,2022-01-03,14,Mon,16,17,@,PIT,L 14-26,14,26,-12,40,CLE_PIT_2022-01-03
WAS,2021-12-26,14,Sun,15,16,@,DAL,L 14-56,14,56,-42,70,WAS_DAL_2021-12-26
CLE,2021-12-20,14,Mon,14,15,,LVR,L 14-16,14,16,-2,30,CLE_LVR_2021-12-20
CAR,2021-12-19,14,Sun,14,15,@,BUF,L 14-31,14,31,-17,45,CAR_BUF_2021-12-19
NWE,2021-12-06,14,Mon,13,13,@,BUF,W 14-10,14,10,4,24,NWE_BUF_2021-12-06
JAX,2021-11-28,14,Sun,11,12,,ATL,L 14-21,14,21,-7,35,JAX_ATL_2021-11-28
HOU,2021-11-28,14,Sun,11,12,,NYJ,L 14-21,14,21,-7,35,HOU_NYJ_2021-11-28
DET,2021-11-25,14,Thu,11,12,,CHI,L 14-16,14,16,-2,30,DET_CHI_2021-11-25
LVR,2021-11-14,14,Sun,9,10,,KAN,L 14-41,14,41,-27,55,LVR_KAN_2021-11-14
DEN,2021-10-21,14,Thu,7,7,@,CLE,L 14-17,14,17,-3,31,DEN_CLE_2021-10-21
CLE,2021-10-17,14,Sun,6,6,,ARI,L 14-37,14,37,-23,51,CLE_ARI_2021-10-17
CHI,2021-10-17,14,Sun,6,6,,GNB,L 14-24,14,24,-10,38,CHI_GNB_2021-10-17
LVR,2021-10-04,14,Mon,4,4,@,LAC,L 14-28,14,28,-14,42,LVR_LAC_2021-10-04
DET,2021-10-03,14,Sun,4,4,@,CHI,L 14-24,14,24,-10,38,DET_CHI_2021-10-03
CLE,2021-10-03,14,Sun,4,4,@,MIN,W 14-7,14,7,7,21,CLE_MIN_2021-10-03
NYG,2021-09-26,14,Sun,3,3,,ATL,L 14-17,14,17,-3,31,NYG_ATL_2021-09-26
NYJ,2021-09-12,14,Sun,1,1,@,CAR,L 14-19,14,19,-5,33,NYJ_CAR_2021-09-12
CHI,2021-09-12,14,Sun,1,1,@,LAR,L 14-34,14,34,-20,48,CHI_LAR_2021-09-12
JAX,2021-01-03,14,Sun,16,17,@,IND,L 14-28,14,28,-14,42,JAX_IND_2021-01-03
NYJ,2021-01-03,14,Sun,16,17,@,NWE,L 14-28,14,28,-14,42,NYJ_NWE_2021-01-03
PHI,2021-01-03,14,Sun,16,17,,WAS,L 14-20,14,20,-6,34,PHI_WAS_2021-01-03
TEN,2020-12-27,14,Sun,15,16,@,GNB,L 14-40,14,40,-26,54,TEN_GNB_2020-12-27
ATL,2020-12-27,14,Sun,15,16,@,KAN,L 14-17,14,17,-3,31,ATL_KAN_2020-12-27
JAX,2020-12-20,14,Sun,14,15,@,BAL,L 14-40,14,40,-26,54,JAX_BAL_2020-12-20
MIN,2020-12-13,14,Sun,13,14,@,TAM,L 14-26,14,26,-12,40,MIN_TAM_2020-12-13
BAL,2020-12-02,14,Wed,11,12,@,PIT,L 14-19,14,19,-5,33,BAL_PIT_2020-12-02
JAX,2020-10-11,14,Sun,5,5,@,HOU,L 14-30,14,30,-16,44,JAX_HOU_2020-10-11
DEN,2020-09-14,14,Mon,1,1,,TEN,L 14-16,14,16,-2,30,DEN_TEN_2020-09-14
HOU,2019-12-29,14,Sun,16,17,,TEN,L 14-35,14,35,-21,49,HOU_TEN_2019-12-29
NYG,2019-11-24,14,Sun,11,12,@,CHI,L 14-19,14,19,-5,33,NYG_CHI_2019-11-24
CHI,2019-11-03,14,Sun,8,9,@,PHI,L 14-22,14,22,-8,36,CHI_PHI_2019-11-03
MIA,2019-10-28,14,Mon,7,8,@,PIT,L 14-27,14,27,-13,41,MIA_PIT_2019-10-28
NYG,2019-10-10,14,Thu,6,6,@,NWE,L 14-35,14,35,-21,49,NYG_NWE_2019-10-10
BUF,2019-10-06,14,Sun,5,5,@,TEN,W 14-7,14,7,7,21,BUF_TEN_2019-10-06
OAK,2019-09-22,14,Sun,3,3,@,MIN,L 14-34,14,34,-20,48,OAK_MIN_2019-09-22
NYJ,2019-09-22,14,Sun,3,3,@,NWE,L 14-30,14,30,-16,44,NYJ_NWE_2019-09-22
NYG,2019-09-15,14,Sun,2,2,,BUF,L 14-28,14,28,-14,42,NYG_BUF_2019-09-15
DEN,2019-09-15,14,Sun,2,2,,CHI,L 14-16,14,16,-2,30,DEN_CHI_2019-09-15
CAR,2019-09-12,14,Thu,2,2,,TAM,L 14-20,14,20,-6,34,CAR_TAM_2019-09-12
NOR,2018-12-30,14,Sun,16,17,,CAR,L 14-33,14,33,-19,47,NOR_CAR_2018-12-30
DEN,2018-12-24,14,Mon,15,16,@,OAK,L 14-27,14,27,-13,41,DEN_OAK_2018-12-24
CHI,2018-12-23,14,Sun,15,16,@,SFO,W 14-9,14,9,5,23,CHI_SFO_2018-12-23
ARI,2018-12-16,14,Sun,14,15,@,ATL,L 14-40,14,40,-26,54,ARI_ATL_2018-12-16
BUF,2018-12-16,14,Sun,14,15,,DET,W 14-13,14,13,1,27,BUF_DET_2018-12-16
TAM,2018-12-09,14,Sun,13,14,,NOR,L 14-28,14,28,-14,42,TAM_NOR_2018-12-09
DEN,2018-12-09,14,Sun,13,14,@,SFO,L 14-20,14,20,-6,34,DEN_SFO_2018-12-09
ARI,2018-11-11,14,Sun,9,10,@,KAN,L 14-26,14,26,-12,40,ARI_KAN_2018-11-11
CIN,2018-11-11,14,Sun,9,10,,NOR,L 14-51,14,51,-37,65,CIN_NOR_2018-11-11
DAL,2018-11-05,14,Mon,8,9,,TEN,L 14-28,14,28,-14,42,DAL_TEN_2018-11-05
WAS,2018-11-04,14,Sun,8,9,,ATL,L 14-38,14,38,-24,52,WAS_ATL_2018-11-04
DET,2018-10-28,14,Sun,7,8,,SEA,L 14-28,14,28,-14,42,DET_SEA_2018-10-28
CLE,2018-10-14,14,Sun,6,6,,LAC,L 14-38,14,38,-24,52,CLE_LAC_2018-10-14
JAX,2018-10-07,14,Sun,5,5,@,KAN,L 14-30,14,30,-16,44,JAX_KAN_2018-10-07
PIT,2018-09-30,14,Sun,4,4,,BAL,L 14-26,14,26,-12,40,PIT_BAL_2018-09-30
ARI,2018-09-23,14,Sun,3,3,,CHI,L 14-16,14,16,-2,30,ARI_CHI_2018-09-23
DEN,2018-09-23,14,Sun,3,3,@,BAL,L 14-27,14,27,-13,41,DEN_BAL_2018-09-23
LAC,2017-12-24,14,Sun,15,16,@,NYJ,W 14-7,14,7,7,21,LAC_NYJ_2017-12-24
MIN,2017-12-03,14,Sun,12,13,@,ATL,W 14-9,14,9,5,23,MIN_ATL_2017-12-03
CHI,2017-12-03,14,Sun,12,13,,SFO,L 14-15,14,15,-1,29,CHI_SFO_2017-12-03
WAS,2017-11-30,14,Thu,12,13,@,DAL,L 14-38,14,38,-24,52,WAS_DAL_2017-11-30
DEN,2017-11-26,14,Sun,11,12,@,OAK,L 14-21,14,21,-7,35,DEN_OAK_2017-11-26
HOU,2017-11-05,14,Sun,8,9,,IND,L 14-20,14,20,-6,34,HOU_IND_2017-11-05
SEA,2017-11-05,14,Sun,8,9,,WAS,L 14-17,14,17,-3,31,SEA_WAS_2017-11-05
OAK,2017-10-29,14,Sun,8,8,@,BUF,L 14-34,14,34,-20,48,OAK_BUF_2017-10-29
CIN,2017-10-22,14,Sun,6,7,@,PIT,L 14-29,14,29,-15,43,CIN_PIT_2017-10-22
CLE,2017-10-08,14,Sun,5,5,,NYJ,L 14-17,14,17,-3,31,CLE_NYJ_2017-10-08
TAM,2017-10-05,14,Thu,4,5,,NWE,L 14-19,14,19,-5,33,TAM_NWE_2017-10-05
TEN,2017-10-01,14,Sun,4,4,@,HOU,L 14-57,14,57,-43,71,TEN_HOU_2017-10-01
DET,2017-10-01,14,Sun,4,4,@,MIN,W 14-7,14,7,7,21,DET_MIN_2017-10-01
CHI,2017-09-28,14,Thu,4,4,@,GNB,L 14-35,14,35,-21,49,CHI_GNB_2017-09-28
CHI,2023-01-08,13,Sun,17,18,,MIN,L 13-29,13,29,-16,42,CHI_MIN_2023-01-08
ARI,2023-01-08,13,Sun,17,18,@,SFO,L 13-38,13,38,-25,51,ARI_SFO_2023-01-08
LVR,2023-01-07,13,Sat,17,18,,KAN,L 13-31,13,31,-18,44,LVR_KAN_2023-01-07
BAL,2023-01-01,13,Sun,16,17,,PIT,L 13-16,13,16,-3,29,BAL_PIT_2023-01-01
TEN,2022-12-29,13,Thu,16,17,,DAL,L 13-27,13,27,-14,40,TEN_DAL_2022-12-29
CHI,2022-12-24,13,Sat,15,16,,BUF,L 13-35,13,35,-22,48,CHI_BUF_2022-12-24
PIT,2022-12-24,13,Sat,15,16,,LVR,W 13-10,13,10,3,23,PIT_LVR_2022-12-24
CLE,2022-12-17,13,Sat,14,15,,BAL,W 13-3,13,3,10,16,CLE_BAL_2022-12-17
SEA,2022-12-15,13,Thu,14,15,,SFO,L 13-21,13,21,-8,34,SEA_SFO_2022-12-15
ARI,2022-12-12,13,Mon,13,14,,NWE,L 13-27,13,27,-14,40,ARI_NWE_2022-12-12
SFO,2022-11-27,13,Sun,11,12,,NOR,W 13-0,13,0,13,13,SFO_NOR_2022-11-27
ATL,2022-11-27,13,Sun,12,12,@,WAS,L 13-19,13,19,-6,32,ATL_WAS_2022-11-27
BAL,2022-11-20,13,Sun,10,11,,CAR,W 13-3,13,3,10,16,BAL_CAR_2022-11-20
NOR,2022-11-07,13,Mon,9,9,,BAL,L 13-27,13,27,-14,40,NOR_BAL_2022-11-07
LAR,2022-11-06,13,Sun,8,9,@,TAM,L 13-16,13,16,-3,29,LAR_TAM_2022-11-06
CIN,2022-10-31,13,Mon,8,8,@,CLE,L 13-32,13,32,-19,45,CIN_CLE_2022-10-31
PIT,2022-10-30,13,Sun,8,8,@,PHI,L 13-35,13,35,-22,48,PIT_PHI_2022-10-30
NYG,2022-10-30,13,Sun,8,8,@,SEA,L 13-27,13,27,-14,40,NYG_SEA_2022-10-30
HOU,2022-10-09,13,Sun,5,5,@,JAX,W 13-6,13,6,7,19,HOU_JAX_2022-10-09
BAL,2022-01-09,13,Sun,17,18,,PIT,L 13-16 (OT),13,16,-3,29,BAL_PIT_2022-01-09
DEN,2022-01-02,13,Sun,16,17,@,LAC,L 13-34,13,34,-21,47,DEN_LAC_2022-01-02
DEN,2021-12-26,13,Sun,15,16,@,LVR,L 13-17,13,17,-4,30,DEN_LVR_2021-12-26
TEN,2021-12-19,13,Sun,14,15,@,PIT,L 13-19,13,19,-6,32,TEN_PIT_2021-12-19
ATL,2021-12-19,13,Sun,14,15,@,SFO,L 13-31,13,31,-18,44,ATL_SFO_2021-12-19
HOU,2021-12-12,13,Sun,13,14,,SEA,L 13-33,13,33,-20,46,HOU_SEA_2021-12-12
LAC,2021-11-28,13,Sun,11,12,@,DEN,L 13-28,13,28,-15,41,LAC_DEN_2021-11-28
TEN,2021-11-28,13,Sun,12,12,@,NWE,L 13-36,13,36,-23,49,TEN_NWE_2021-11-28
NYG,2021-11-28,13,Sun,11,12,,PHI,W 13-7,13,7,6,20,NYG_PHI_2021-11-28
LVR,2021-11-21,13,Sun,10,11,,CIN,L 13-32,13,32,-19,45,LVR_CIN_2021-11-21
SEA,2021-11-21,13,Sun,10,11,,ARI,L 13-23,13,23,-10,36,SEA_ARI_2021-11-21
CLE,2021-11-21,13,Sun,11,11,,DET,W 13-10,13,10,3,23,CLE_DET_2021-11-21
TEN,2021-11-21,13,Sun,11,11,,HOU,L 13-22,13,22,-9,35,TEN_HOU_2021-11-21
CHI,2021-11-21,13,Sun,10,11,,BAL,L 13-16,13,16,-3,29,CHI_BAL_2021-11-21
