Team,Date,Pen,Day,G#,Week,,Opp,Result,Pen,Yds,OppPen,OppYds,CombPen,CombPenYds,Season,game_id
CLE,2019-09-08,18,Sun,1,1,,TEN,L 13-43,18,182,6,54,24,236,2019,2019_01_CLE_TEN
MIA,2017-11-19,17,Sun,10,11,,TAM,L 20-30,17,123,9,82,26,205,2017,2017_11_MIA_TAM
JAX,2019-12-01,16,Sun,12,13,,TAM,L 11-28,16,121,8,44,24,165,2019,2019_13_JAX_TAM
ATL,2019-09-22,16,Sun,3,3,@,IND,L 24-27,16,128,4,39,20,167,2019,2019_03_ATL_IND
NYJ,2018-12-23,16,Sun,15,16,,GNB,L 38-44 (OT),16,172,10,86,26,258,2018,2018_16_NYJ_GNB
SEA,2017-11-05,16,Sun,8,9,,WAS,L 14-17,16,138,7,62,23,200,2017,2017_09_SEA_WAS
WAS,2018-12-09,15,Sun,13,14,,NYG,L 16-40,15,135,2,18,17,153,2018,2018_14_WAS_NYG
ATL,2018-09-06,15,Thu,1,1,@,PHI,L 12-18,15,135,11,101,26,236,2018,2018_01_ATL_PHI
SEA,2017-10-22,15,Sun,6,7,@,NYG,W 24-7,15,110,7,28,22,138,2017,2017_07_SEA_NYG
KAN,2017-09-07,15,Thu,1,1,@,NWE,W 42-27,15,139,6,55,21,194,2017,2017_01_KAN_NWE
LVR,2021-11-25,14,Thu,11,12,@,DAL,W 36-33 (OT),14,110,14,166,28,276,2021,2021_12_LVR_DAL
DAL,2021-11-25,14,Thu,11,12,,LVR,L 33-36 (OT),14,166,14,110,28,276,2021,2021_12_DAL_LVR
PHI,2021-09-12,14,Sun,1,1,@,ATL,W 32-6,14,89,12,99,26,188,2021,2021_01_PHI_ATL
LVR,2021-01-03,14,Sun,16,17,@,DEN,W 32-31,14,111,4,28,18,139,2020,2020_17_LVR_DEN
NWE,2018-12-16,14,Sun,14,15,@,PIT,L 10-17,14,106,4,40,18,146,2018,2018_15_NWE_PIT
SEA,2018-12-16,14,Sun,14,15,@,SFO,L 23-26 (OT),14,148,8,66,22,214,2018,2018_15_SEA_SFO
LAC,2018-11-18,14,Sun,10,11,,DEN,L 22-23,14,120,7,43,21,163,2018,2018_11_LAC_DEN
CHI,2018-11-04,14,Sun,8,9,@,BUF,W 41-9,14,129,10,163,24,292,2018,2018_09_CHI_BUF
CLE,2018-10-21,14,Sun,7,7,@,TAM,L 23-26 (OT),14,114,8,65,22,179,2018,2018_07_CLE_TAM
SFO,2018-09-23,14,Sun,3,3,@,KAN,L 27-38,14,147,6,48,20,195,2018,2018_03_SFO_KAN
MIA,2017-12-31,14,Sun,16,17,,BUF,L 16-22,14,145,6,45,20,190,2017,2017_17_MIA_BUF
HOU,2017-12-17,14,Sun,14,15,@,JAX,L 7-45,14,127,8,54,22,181,2017,2017_15_HOU_JAX
OAK,2017-12-17,14,Sun,14,15,,DAL,L 17-20,14,105,7,100,21,205,2017,2017_15_OAK_DAL
DEN,2017-11-05,14,Sun,8,9,@,PHI,L 23-51,14,105,5,35,19,140,2017,2017_09_DEN_PHI
LVR,2022-12-18,13,Sun,14,15,,NWE,W 30-24,13,90,6,30,19,120,2022,2022_15_LVR_NWE
DAL,2022-11-24,13,Thu,11,12,,NYG,W 28-20,13,86,7,66,20,152,2022,2022_12_DAL_NYG
JAX,2022-10-23,13,Sun,7,7,,NYG,L 17-23,13,81,8,67,21,148,2022,2022_07_JAX_NYG
DEN,2022-09-18,13,Sun,2,2,,HOU,W 16-9,13,100,8,94,21,194,2022,2022_02_DEN_HOU
JAX,2022-09-11,13,Sun,1,1,@,WAS,L 22-28,13,90,6,63,19,153,2022,2022_01_JAX_WAS
PHI,2021-09-27,13,Mon,3,3,@,DAL,L 21-41,13,86,4,37,17,123,2021,2021_03_PHI_DAL
CLE,2020-12-06,13,Sun,12,13,@,TEN,W 41-35,13,92,5,52,18,144,2020,2020_13_CLE_TEN
PIT,2019-11-10,13,Sun,9,10,,LAR,W 17-12,13,107,10,95,23,202,2019,2019_10_PIT_LAR
CLE,2019-10-27,13,Sun,7,8,@,NWE,L 13-27,13,85,4,32,17,117,2019,2019_08_CLE_NWE
LAR,2019-09-29,13,Sun,4,4,,TAM,L 40-55,13,106,12,99,25,205,2019,2019_04_LAR_TAM
OAK,2018-12-09,13,Sun,13,14,,PIT,W 24-21,13,130,2,14,15,144,2018,2018_14_OAK_PIT
ATL,2018-12-09,13,Sun,13,14,@,GNB,L 20-34,13,101,6,37,19,138,2018,2018_14_ATL_GNB
SFO,2018-12-02,13,Sun,12,13,@,SEA,L 16-43,13,128,10,100,23,228,2018,2018_13_SFO_SEA
BUF,2018-12-02,13,Sun,12,13,@,MIA,L 17-21,13,120,8,89,21,209,2018,2018_13_BUF_MIA
CIN,2018-11-25,13,Sun,11,12,,CLE,L 20-35,13,96,7,61,20,157,2018,2018_12_CIN_CLE
BUF,2018-11-25,13,Sun,11,12,,JAX,W 24-21,13,80,10,90,23,170,2018,2018_12_BUF_JAX
KAN,2018-11-19,13,Mon,11,11,@,LAR,L 51-54,13,135,8,60,21,195,2018,2018_11_KAN_LAR
PIT,2018-09-24,13,Mon,3,3,@,TAM,W 30-27,13,155,9,80,22,235,2018,2018_03_PIT_TAM
DEN,2018-09-23,13,Sun,3,3,@,BAL,L 14-27,13,120,7,52,20,172,2018,2018_03_DEN_BAL
CHI,2017-12-16,13,Sat,14,15,@,DET,L 10-20,13,97,8,58,21,155,2017,2017_15_CHI_DET
CIN,2017-12-04,13,Mon,12,13,,PIT,L 20-23,13,173,7,66,20,239,2017,2017_13_CIN_PIT
NOR,2017-10-15,13,Sun,5,6,,DET,W 52-38,13,118,7,46,20,164,2017,2017_06_NOR_DET
SFO,2017-10-01,13,Sun,4,4,@,ARI,L 15-18 (OT),13,113,10,80,23,193,2017,2017_04_SFO_ARI
KAN,2017-09-24,13,Sun,3,3,@,LAC,W 24-10,13,122,8,61,21,183,2017,2017_03_KAN_LAC
PIT,2017-09-10,13,Sun,1,1,@,CLE,W 21-18,13,144,4,61,17,205,2017,2017_01_PIT_CLE
PHI,2022-12-04,12,Sun,12,13,,TEN,W 35-10,12,80,7,82,19,162,2022,2022_13_PHI_TEN
ARI,2022-11-06,12,Sun,9,9,,SEA,L 21-31,12,77,6,34,18,111,2022,2022_09_ARI_SEA
DEN,2022-10-30,12,Sun,8,8,@,JAX,W 21-17,12,80,5,54,17,134,2022,2022_08_DEN_JAX
NWE,2022-10-16,12,Sun,6,6,@,CLE,W 38-15,12,92,7,63,19,155,2022,2022_06_NWE_CLE
SEA,2022-10-09,12,Sun,5,5,@,NOR,L 32-39,12,85,6,57,18,142,2022,2022_05_SEA_NOR
ARI,2022-09-18,12,Sun,2,2,@,LVR,W 29-23 (OT),12,120,10,68,22,188,2022,2022_02_ARI_LVR
DEN,2022-09-12,12,Mon,1,1,@,SEA,L 16-17,12,106,5,77,17,183,2022,2022_01_DEN_SEA
SFO,2022-09-11,12,Sun,1,1,@,CHI,L 10-19,12,99,3,24,15,123,2022,2022_01_SFO_CHI
LAC,2021-11-21,12,Sun,10,11,,PIT,W 41-37,12,75,8,38,20,113,2021,2021_11_LAC_PIT
CHI,2021-11-08,12,Mon,9,9,@,PIT,L 27-29,12,115,5,30,17,145,2021,2021_09_CHI_PIT
BUF,2021-11-07,12,Sun,8,9,@,JAX,L 6-9,12,118,8,54,20,172,2021,2021_09_BUF_JAX
LAR,2021-11-07,12,Sun,9,9,,TEN,L 16-28,12,115,4,19,16,134,2021,2021_09_LAR_TEN
KAN,2021-11-01,12,Mon,8,8,,NYG,W 20-17,12,103,10,88,22,191,2021,2021_08_KAN_NYG
JAX,2021-10-31,12,Sun,7,8,@,SEA,L 7-31,12,93,5,40,17,133,2021,2021_08_JAX_SEA
DAL,2021-10-17,12,Sun,6,6,@,NWE,W 35-29 (OT),12,115,5,47,17,162,2021,2021_06_DAL_NWE
LAC,2021-09-19,12,Sun,2,2,,DAL,L 17-20,12,99,8,76,20,175,2021,2021_02_LAC_DAL
ATL,2021-09-12,12,Sun,1,1,,PHI,L 6-32,12,99,14,89,26,188,2021,2021_01_ATL_PHI
MIN,2021-09-12,12,Sun,1,1,@,CIN,L 24-27 (OT),12,116,3,15,15,131,2021,2021_01_MIN_CIN
PHI,2020-12-27,12,Sun,15,16,@,DAL,L 17-37,12,115,5,73,17,188,2020,2020_16_PHI_DAL
GNB,2020-12-13,12,Sun,13,14,@,DET,W 31-24,12,68,4,30,16,98,2020,2020_14_GNB_DET
CAR,2020-11-08,12,Sun,9,9,@,KAN,L 31-33,12,82,8,75,20,157,2020,2020_09_CAR_KAN
BAL,2020-10-18,12,Sun,6,6,@,PHI,W 30-28,12,132,3,20,15,152,2020,2020_06_BAL_PHI
TAM,2019-12-29,12,Sun,16,17,,ATL,L 22-28 (OT),12,97,5,53,17,150,2019,2019_17_TAM_ATL
OAK,2019-12-01,12,Sun,12,13,@,KAN,L 9-40,12,99,0,0,12,99,2019,2019_13_OAK_KAN
NOR,2019-11-24,12,Sun,11,12,,CAR,W 34-31,12,123,3,25,15,148,2019,2019_12_NOR_CAR
SEA,2019-11-24,12,Sun,11,12,@,PHI,W 17-9,12,90,2,15,14,105,2019,2019_12_SEA_PHI
BUF,2019-11-24,12,Sun,11,12,,DEN,W 20-3,12,90,7,70,19,160,2019,2019_12_BUF_DEN
NOR,2019-11-10,12,Sun,9,10,,ATL,L 9-26,12,90,7,48,19,138,2019,2019_10_NOR_ATL
OAK,2019-11-07,12,Thu,9,10,,LAC,W 26-24,12,97,8,70,20,167,2019,2019_10_OAK_LAC
DEN,2019-10-06,12,Sun,5,5,@,LAC,W 20-13,12,122,4,43,16,165,2019,2019_05_DEN_LAC
ARI,2019-10-06,12,Sun,5,5,@,CIN,W 26-23,12,96,7,60,19,156,2019,2019_05_ARI_CIN
MIN,2019-10-06,12,Sun,5,5,@,NYG,W 28-10,12,112,5,45,17,157,2019,2019_05_MIN_NYG
TAM,2019-09-29,12,Sun,4,4,@,LAR,W 55-40,12,99,13,106,25,205,2019,2019_04_TAM_LAR
JAX,2019-09-29,12,Sun,4,4,@,DEN,W 26-24,12,104,5,48,17,152,2019,2019_04_JAX_DEN
WAS,2019-09-29,12,Sun,4,4,@,NYG,L 3-24,12,58,5,45,17,103,2019,2019_04_WAS_NYG
NYJ,2019-09-16,12,Mon,2,2,,CLE,L 3-23,12,89,9,85,21,174,2019,2019_02_NYJ_CLE
TAM,2019-09-12,12,Thu,2,2,@,CAR,W 20-14,12,66,5,50,17,116,2019,2019_02_TAM_CAR
WAS,2019-09-08,12,Sun,1,1,@,PHI,L 27-32,12,96,6,55,18,151,2019,2019_01_WAS_PHI
IND,2018-12-30,12,Sun,16,17,@,TEN,W 33-17,12,96,9,75,21,171,2018,2018_17_IND_TEN
CIN,2018-12-02,12,Sun,12,13,,DEN,L 10-24,12,100,7,60,19,160,2018,2018_13_CIN_DEN
NYG,2018-12-02,12,Sun,12,13,,CHI,W 30-27 (OT),12,107,8,58,20,165,2018,2018_13_NYG_CHI
LAC,2018-11-04,12,Sun,8,9,@,SEA,W 25-17,12,105,10,83,22,188,2018,2018_09_LAC_SEA
BUF,2018-10-14,12,Sun,6,6,@,HOU,L 13-20,12,104,6,50,18,154,2018,2018_06_BUF_HOU
GNB,2018-10-07,12,Sun,5,5,@,DET,L 23-31,12,112,8,71,20,183,2018,2018_05_GNB_DET
BUF,2018-09-23,12,Sun,3,3,@,MIN,W 27-6,12,84,6,59,18,143,2018,2018_03_BUF_MIN
PIT,2018-09-16,12,Sun,2,2,,KAN,L 37-42,12,90,12,76,24,166,2018,2018_02_PIT_KAN
KAN,2018-09-16,12,Sun,2,2,@,PIT,W 42-37,12,76,12,90,24,166,2018,2018_02_KAN_PIT
PIT,2018-09-09,12,Sun,1,1,@,CLE,T 21-21 (OT),12,116,11,87,23,203,2018,2018_01_PIT_CLE
MIN,2017-12-31,12,Sun,16,17,,CHI,W 23-10,12,103,10,116,22,219,2017,2017_17_MIN_CHI
JAX,2017-12-24,12,Sun,15,16,@,SFO,L 33-44,12,99,8,68,20,167,2017,2017_16_JAX_SFO
TAM,2017-12-24,12,Sun,15,16,@,CAR,L 19-22,12,72,6,50,18,122,2017,2017_16_TAM_CAR
DEN,2017-12-14,12,Thu,14,15,@,IND,W 25-13,12,80,4,39,16,119,2017,2017_15_DEN_IND
CIN,2017-11-12,12,Sun,9,10,@,TEN,L 20-24,12,84,5,55,17,139,2017,2017_10_CIN_TEN
SEA,2017-11-09,12,Thu,9,10,@,ARI,W 22-16,12,108,9,58,21,166,2017,2017_10_SEA_ARI
CLE,2017-10-22,12,Sun,7,7,,TEN,L 9-12 (OT),12,81,5,35,17,116,2017,2017_07_CLE_TEN
NYJ,2017-10-22,12,Sun,7,7,@,MIA,L 28-31,12,124,9,76,21,200,2017,2017_07_NYJ_MIA
NWE,2017-10-05,12,Thu,5,5,@,TAM,W 19-14,12,108,9,70,21,178,2017,2017_05_NWE_TAM
IND,2022-12-17,11,Sat,14,15,@,MIN,L 36-39 (OT),11,103,9,74,20,177,2022,2022_15_IND_MIN
NYJ,2022-10-23,11,Sun,7,7,@,DEN,W 16-9,11,85,4,34,15,119,2022,2022_07_NYJ_DEN
LVR,2022-10-10,11,Mon,5,5,@,KAN,L 29-30,11,99,5,72,16,171,2022,2022_05_LVR_KAN
MIA,2022-10-09,11,Sun,5,5,@,NYJ,L 17-40,11,102,5,105,16,207,2022,2022_05_MIA_NYJ
WAS,2022-10-02,11,Sun,4,4,@,DAL,L 10-25,11,136,4,20,15,156,2022,2022_04_WAS_DAL
SEA,2022-10-02,11,Sun,4,4,@,DET,W 48-45,11,76,8,59,19,135,2022,2022_04_SEA_DET
PHI,2021-12-26,11,Sun,15,16,,NYG,W 34-10,11,79,6,40,17,119,2021,2021_16_PHI_NYG
ARI,2021-12-25,11,Sat,15,16,,IND,L 16-22,11,85,5,40,16,125,2021,2021_16_ARI_IND
MIN,2021-12-09,11,Thu,13,14,,PIT,W 36-28,11,102,10,85,21,187,2021,2021_14_MIN_PIT
MIA,2021-11-11,11,Thu,10,10,,BAL,W 22-10,11,97,4,20,15,117,2021,2021_10_MIA_BAL
DAL,2021-10-31,11,Sun,7,8,@,MIN,W 20-16,11,96,7,57,18,153,2021,2021_08_DAL_MIN
TAM,2021-10-31,11,Sun,8,8,@,NOR,L 27-36,11,99,2,10,13,109,2021,2021_08_TAM_NOR
TEN,2021-10-31,11,Sun,8,8,@,IND,W 34-31 (OT),11,161,9,75,20,236,2021,2021_08_TEN_IND
MIN,2021-10-17,11,Sun,6,6,@,CAR,W 34-28 (OT),11,98,6,28,17,126,2021,2021_06_MIN_CAR
NOR,2021-09-19,11,Sun,2,2,@,CAR,L 7-26,11,115,5,49,16,164,2021,2021_02_NOR_CAR
NYG,2021-09-16,11,Thu,2,2,@,WAS,L 29-30,11,81,9,80,20,161,2021,2021_02_NYG_WAS
TAM,2021-09-09,11,Thu,1,1,,DAL,W 31-29,11,106,8,55,19,161,2021,2021_01_TAM_DAL
DET,2020-12-26,11,Sat,15,16,,TAM,L 7-47,11,117,8,65,19,182,2020,2020_16_DET_TAM
LVR,2020-11-29,11,Sun,11,12,@,ATL,L 6-43,11,141,6,49,17,190,2020,2020_12_LVR_ATL
PHI,2020-11-15,11,Sun,9,10,@,NYG,L 17-27,11,74,7,64,18,138,2020,2020_10_PHI_NYG
BUF,2020-10-25,11,Sun,7,7,@,NYJ,W 18-10,11,106,6,49,17,155,2020,2020_07_BUF_NYJ
TAM,2020-10-08,11,Thu,5,5,@,CHI,L 19-20,11,109,6,66,17,175,2020,2020_05_TAM_CHI
NYJ,2020-10-01,11,Thu,4,4,,DEN,L 28-37,11,118,8,94,19,212,2020,2020_04_NYJ_DEN
PHI,2020-09-27,11,Sun,3,3,,CIN,T 23-23 (OT),11,93,9,73,20,166,2020,2020_03_PHI_CIN
ARI,2020-09-20,11,Sun,2,2,,WAS,W 30-15,11,97,6,42,17,139,2020,2020_02_ARI_WAS
KAN,2020-09-20,11,Sun,2,2,@,LAC,W 23-20 (OT),11,90,6,40,17,130,2020,2020_02_KAN_LAC
NOR,2019-12-22,11,Sun,15,16,@,TEN,W 38-28,11,70,6,56,17,126,2019,2019_16_NOR_TEN
ATL,2019-12-15,11,Sun,14,15,@,SFO,W 29-22,11,98,7,67,18,165,2019,2019_15_ATL_SFO
JAX,2019-11-24,11,Sun,11,12,@,TEN,L 20-42,11,104,6,54,17,158,2019,2019_12_JAX_TEN
WAS,2019-11-17,11,Sun,10,11,,NYJ,L 17-34,11,66,6,55,17,121,2019,2019_11_WAS_NYJ
DET,2019-11-17,11,Sun,10,11,,DAL,L 27-35,11,89,6,45,17,134,2019,2019_11_DET_DAL
ARI,2019-11-10,11,Sun,10,10,@,TAM,L 27-30,11,87,9,94,20,181,2019,2019_10_ARI_TAM
TEN,2019-11-03,11,Sun,9,9,@,CAR,L 20-30,11,99,6,77,17,176,2019,2019_09_TEN_CAR
OAK,2019-10-27,11,Sun,7,8,@,HOU,L 24-27,11,100,7,50,18,150,2019,2019_08_OAK_HOU
JAX,2019-10-20,11,Sun,7,7,@,CIN,W 27-17,11,130,6,50,17,180,2019,2019_07_JAX_CIN
KAN,2019-10-13,11,Sun,6,6,,HOU,L 24-31,11,79,10,70,21,149,2019,2019_06_KAN_HOU
PIT,2019-10-06,11,Sun,5,5,,BAL,L 23-26 (OT),11,76,11,92,22,168,2019,2019_05_PIT_BAL
KAN,2019-10-06,11,Sun,5,5,,IND,L 13-19,11,125,7,50,18,175,2019,2019_05_KAN_IND
DAL,2019-10-06,11,Sun,5,5,,GNB,L 24-34,11,124,9,78,20,202,2019,2019_05_DAL_GNB
BAL,2019-10-06,11,Sun,5,5,@,PIT,W 26-23 (OT),11,92,11,76,22,168,2019,2019_05_BAL_PIT
BUF,2019-10-06,11,Sun,5,5,@,TEN,W 14-7,11,78,8,60,19,138,2019,2019_05_BUF_TEN
OAK,2019-09-29,11,Sun,4,4,@,IND,W 31-24,11,80,5,35,16,115,2019,2019_04_OAK_IND
NOR,2019-09-22,11,Sun,3,3,@,SEA,W 33-27,11,70,7,53,18,123,2019,2019_03_NOR_SEA
NOR,2019-09-15,11,Sun,2,2,@,LAR,L 9-27,11,87,8,65,19,152,2019,2019_02_NOR_LAR
SFO,2019-09-08,11,Sun,1,1,@,TAM,W 31-17,11,87,8,87,19,174,2019,2019_01_SFO_TAM
MIN,2019-09-08,11,Sun,1,1,,ATL,W 28-12,11,100,9,78,20,178,2019,2019_01_MIN_ATL
NYG,2018-12-30,11,Sun,16,17,,DAL,L 35-36,11,78,6,46,17,124,2018,2018_17_NYG_DAL
CHI,2018-12-30,11,Sun,16,17,@,MIN,W 24-10,11,102,3,30,14,132,2018,2018_17_CHI_MIN
DEN,2018-12-30,11,Sun,16,17,,LAC,L 9-23,11,99,6,51,17,150,2018,2018_17_DEN_LAC
DEN,2018-12-24,11,Mon,15,16,@,OAK,L 14-27,11,91,6,50,17,141,2018,2018_16_DEN_OAK
MIN,2018-12-23,11,Sun,15,16,@,DET,W 27-9,11,78,7,55,18,133,2018,2018_16_MIN_DET
PHI,2018-12-23,11,Sun,15,16,,HOU,W 32-30,11,105,10,61,21,166,2018,2018_16_PHI_HOU
SFO,2018-12-09,11,Sun,13,14,,DEN,W 20-14,11,87,11,62,22,149,2018,2018_14_SFO_DEN
BAL,2018-12-09,11,Sun,13,14,@,KAN,L 24-27 (OT),11,112,7,53,18,165,2018,2018_14_BAL_KAN
DEN,2018-12-09,11,Sun,13,14,@,SFO,L 14-20,11,62,11,87,22,149,2018,2018_14_DEN_SFO
DAL,2018-12-09,11,Sun,13,14,,PHI,W 29-23 (OT),11,110,5,49,16,159,2018,2018_14_DAL_PHI
KAN,2018-12-02,11,Sun,12,13,@,OAK,W 40-33,11,94,8,74,19,168,2018,2018_13_KAN_OAK
NYJ,2018-12-02,11,Sun,12,13,@,TEN,L 22-26,11,96,8,75,19,171,2018,2018_13_NYJ_TEN
NYG,2018-11-25,11,Sun,11,12,@,PHI,L 22-25,11,91,7,46,18,137,2018,2018_12_NYG_PHI
NWE,2018-11-25,11,Sun,11,12,@,NYJ,W 27-13,11,105,8,47,19,152,2018,2018_12_NWE_NYJ
JAX,2018-11-18,11,Sun,10,11,,PIT,L 16-20,11,111,3,15,14,126,2018,2018_11_JAX_PIT
KAN,2018-11-04,11,Sun,9,9,@,CLE,W 37-21,11,86,4,20,15,106,2018,2018_09_KAN_CLE
TAM,2018-10-28,11,Sun,7,8,@,CIN,L 34-37,11,75,4,46,15,121,2018,2018_08_TAM_CIN
NYG,2018-10-28,11,Sun,8,8,,WAS,L 13-20,11,102,8,90,19,192,2018,2018_08_NYG_WAS
KAN,2018-10-07,11,Sun,5,5,,JAX,W 30-14,11,105,5,45,16,150,2018,2018_05_KAN_JAX
TAM,2018-09-30,11,Sun,4,4,@,CHI,L 10-48,11,99,4,38,15,137,2018,2018_04_TAM_CHI
IND,2018-09-23,11,Sun,3,3,@,PHI,L 16-20,11,77,10,110,21,187,2018,2018_03_IND_PHI
GNB,2018-09-23,11,Sun,3,3,@,WAS,L 17-31,11,115,6,66,17,181,2018,2018_03_GNB_WAS
NOR,2018-09-23,11,Sun,3,3,@,ATL,W 43-37 (OT),11,120,5,54,16,174,2018,2018_03_NOR_ATL
HOU,2018-09-16,11,Sun,2,2,@,TEN,L 17-20,11,88,8,70,19,158,2018,2018_02_HOU_TEN
OAK,2018-09-10,11,Mon,1,1,,LAR,L 13-33,11,155,8,70,19,225,2018,2018_01_OAK_LAR
CLE,2018-09-09,11,Sun,1,1,,PIT,T 21-21 (OT),11,87,12,116,23,203,2018,2018_01_CLE_PIT
JAX,2018-09-09,11,Sun,1,1,@,NYG,W 20-15,11,119,6,43,17,162,2018,2018_01_JAX_NYG
PHI,2018-09-06,11,Thu,1,1,,ATL,W 18-12,11,101,15,135,26,236,2018,2018_01_PHI_ATL
MIA,2017-12-24,11,Sun,15,16,@,KAN,L 13-29,11,75,5,40,16,115,2017,2017_16_MIA_KAN
SEA,2017-12-24,11,Sun,15,16,@,DAL,W 21-12,11,142,7,75,18,217,2017,2017_16_SEA_DAL
MIN,2017-12-17,11,Sun,14,15,,CIN,W 34-7,11,93,5,44,16,137,2017,2017_15_MIN_CIN
SFO,2017-12-10,11,Sun,13,14,@,HOU,W 26-16,11,87,8,81,19,168,2017,2017_14_SFO_HOU
NOR,2017-12-07,11,Thu,13,14,@,ATL,L 17-20,11,87,4,35,15,122,2017,2017_14_NOR_ATL
HOU,2017-12-03,11,Sun,12,13,@,TEN,L 13-24,11,85,7,63,18,148,2017,2017_13_HOU_TEN
PHI,2017-11-26,11,Sun,11,12,,CHI,W 31-3,11,70,9,56,20,126,2017,2017_12_PHI_CHI
MIA,2017-11-05,11,Sun,8,9,,OAK,L 24-27,11,107,10,105,21,212,2017,2017_09_MIA_OAK
BUF,2017-11-02,11,Thu,8,9,@,NYJ,L 21-34,11,99,10,66,21,165,2017,2017_09_BUF_NYJ
BUF,2017-10-29,11,Sun,7,8,,OAK,W 34-14,11,95,6,50,17,145,2017,2017_08_BUF_OAK
CLE,2017-10-15,11,Sun,6,6,@,HOU,L 17-33,11,72,4,44,15,116,2017,2017_06_CLE_HOU
LAC,2017-10-08,11,Sun,5,5,@,NYG,W 27-22,11,87,10,67,21,154,2017,2017_05_LAC_NYG
TEN,2017-10-08,11,Sun,5,5,@,MIA,L 10-16,11,77,5,23,16,100,2017,2017_05_TEN_MIA
CAR,2017-10-08,11,Sun,5,5,@,DET,W 27-24,11,100,1,10,12,110,2017,2017_05_CAR_DET
MIA,2017-10-01,11,Sun,3,4,,NOR,L 0-20,11,90,8,71,19,161,2017,2017_04_MIA_NOR
SEA,2017-09-24,11,Sun,3,3,@,TEN,L 27-33,11,98,5,45,16,143,2017,2017_03_SEA_TEN
IND,2017-09-24,11,Sun,3,3,,CLE,W 31-28,11,99,10,113,21,212,2017,2017_03_IND_CLE
MIN,2017-09-17,11,Sun,2,2,@,PIT,L 9-26,11,131,10,72,21,203,2017,2017_02_MIN_PIT
CLE,2017-09-17,11,Sun,2,2,@,BAL,L 10-24,11,65,7,45,18,110,2017,2017_02_CLE_BAL
BAL,2017-09-10,11,Sun,1,1,@,CIN,W 20-0,11,85,9,66,20,151,2017,2017_01_BAL_CIN
TEN,2022-12-29,10,Thu,16,17,,DAL,L 13-27,10,124,3,35,13,159,2022,2022_17_TEN_DAL
NWE,2022-12-24,10,Sat,15,16,,CIN,L 18-22,10,82,8,62,18,144,2022,2022_16_NWE_CIN
CAR,2022-12-24,10,Sat,15,16,,DET,W 37-23,10,74,4,30,14,104,2022,2022_16_CAR_DET
KAN,2022-12-18,10,Sun,14,15,@,HOU,W 30-24 (OT),10,102,4,33,14,135,2022,2022_15_KAN_HOU
BAL,2022-11-20,10,Sun,10,11,,CAR,W 13-3,10,93,9,66,19,159,2022,2022_11_BAL_CAR
LVR,2022-11-13,10,Sun,9,10,,IND,L 20-25,10,74,4,25,14,99,2022,2022_10_LVR_IND
NOR,2022-11-13,10,Sun,10,10,@,PIT,L 10-20,10,74,3,40,13,114,2022,2022_10_NOR_PIT
ARI,2022-11-13,10,Sun,10,10,@,LAR,W 27-17,10,67,5,29,15,96,2022,2022_10_ARI_LAR
CAR,2022-11-10,10,Thu,10,10,,ATL,W 25-15,10,89,4,37,14,126,2022,2022_10_CAR_ATL
KAN,2022-11-06,10,Sun,8,9,,TEN,W 20-17 (OT),10,69,8,51,18,120,2022,2022_09_KAN_TEN
MIN,2022-10-30,10,Sun,7,8,,ARI,W 34-26,10,86,10,67,20,153,2022,2022_08_MIN_ARI
ARI,2022-10-30,10,Sun,8,8,@,MIN,L 26-34,10,67,10,86,20,153,2022,2022_08_ARI_MIN
SFO,2022-10-23,10,Sun,7,7,,KAN,L 23-44,10,80,8,84,18,164,2022,2022_07_SFO_KAN
DEN,2022-10-17,10,Mon,6,6,@,LAC,L 16-19 (OT),10,151,9,89,19,240,2022,2022_06_DEN_LAC
MIA,2022-10-16,10,Sun,6,6,,MIN,L 16-24,10,97,2,20,12,117,2022,2022_06_MIA_MIN
BAL,2022-10-16,10,Sun,6,6,@,NYG,L 20-24,10,74,3,25,13,99,2022,2022_06_BAL_NYG
DAL,2022-10-16,10,Sun,6,6,@,PHI,L 17-26,10,72,2,10,12,82,2022,2022_06_DAL_PHI
NOR,2022-10-02,10,Sun,4,4,,MIN,L 25-28,10,102,5,35,15,137,2022,2022_04_NOR_MIN
LVR,2022-09-18,10,Sun,2,2,,ARI,L 23-29 (OT),10,68,12,120,22,188,2022,2022_02_LVR_ARI
SEA,2022-09-18,10,Sun,2,2,@,SFO,L 7-27,10,106,1,26,11,132,2022,2022_02_SEA_SFO
PHI,2022-09-11,10,Sun,1,1,@,DET,W 38-35,10,61,7,65,17,126,2022,2022_01_PHI_DET
DAL,2022-09-11,10,Sun,1,1,,TAM,L 3-19,10,73,5,25,15,98,2022,2022_01_DAL_TAM
LAC,2022-01-09,10,Sun,17,18,@,LVR,L 32-35 (OT),10,108,4,38,14,146,2021,2021_18_LAC_LVR
CLE,2022-01-03,10,Mon,16,17,@,PIT,L 14-26,10,77,5,51,15,128,2021,2021_17_CLE_PIT
KAN,2022-01-02,10,Sun,16,17,@,CIN,L 31-34,10,83,5,62,15,145,2021,2021_17_KAN_CIN
DAL,2022-01-02,10,Sun,16,17,,ARI,L 22-25,10,88,7,45,17,133,2021,2021_17_DAL_ARI
HOU,2021-12-26,10,Sun,15,16,,LAC,W 41-29,10,70,5,49,15,119,2021,2021_16_HOU_LAC
BAL,2021-12-12,10,Sun,13,14,@,CLE,L 22-24,10,129,4,42,14,171,2021,2021_14_BAL_CLE
PIT,2021-12-09,10,Thu,13,14,@,MIN,L 28-36,10,85,11,102,21,187,2021,2021_14_PIT_MIN
BAL,2021-12-05,10,Sun,12,13,@,PIT,L 19-20,10,55,5,81,15,136,2021,2021_13_BAL_PIT
SFO,2021-12-05,10,Sun,12,13,@,SEA,L 23-30,10,86,6,40,16,126,2021,2021_13_SFO_SEA
DET,2021-11-25,10,Thu,11,12,,CHI,L 14-16,10,67,5,50,15,117,2021,2021_12_DET_CHI
CLE,2021-11-21,10,Sun,11,11,,DET,W 13-10,10,82,7,67,17,149,2021,2021_11_CLE_DET
MIN,2021-11-14,10,Sun,9,10,@,LAC,W 27-20,10,118,7,52,17,170,2021,2021_10_MIN_LAC
CLE,2021-11-07,10,Sun,9,9,@,CIN,W 41-16,10,84,4,31,14,115,2021,2021_09_CLE_CIN
CAR,2021-11-07,10,Sun,9,9,,NWE,L 6-24,10,83,6,35,16,118,2021,2021_09_CAR_NWE
NOR,2021-11-07,10,Sun,8,9,,ATL,L 25-27,10,74,6,76,16,150,2021,2021_09_NOR_ATL
NYG,2021-11-01,10,Mon,8,8,@,KAN,L 17-20,10,88,12,103,22,191,2021,2021_08_NYG_KAN
LVR,2021-10-10,10,Sun,5,5,,CHI,L 9-20,10,82,8,70,18,152,2021,2021_05_LVR_CHI
BUF,2021-10-10,10,Sun,5,5,@,KAN,W 38-20,10,103,7,55,17,158,2021,2021_05_BUF_KAN
HOU,2021-10-03,10,Sun,4,4,@,BUF,L 0-40,10,100,3,30,13,130,2021,2021_04_HOU_BUF
PIT,2021-09-26,10,Sun,3,3,,CIN,L 10-24,10,73,10,89,20,162,2021,2021_03_PIT_CIN
CIN,2021-09-26,10,Sun,3,3,@,PIT,W 24-10,10,89,10,73,20,162,2021,2021_03_CIN_PIT
SEA,2021-09-19,10,Sun,2,2,,TEN,L 30-33 (OT),10,100,5,45,15,145,2021,2021_02_SEA_TEN
DEN,2021-09-19,10,Sun,2,2,@,JAX,W 23-13,10,101,7,70,17,171,2021,2021_02_DEN_JAX
LVR,2021-09-13,10,Mon,1,1,,BAL,W 33-27 (OT),10,62,5,71,15,133,2021,2021_01_LVR_BAL
JAX,2021-09-12,10,Sun,1,1,@,HOU,L 21-37,10,82,5,50,15,132,2021,2021_01_JAX_HOU
BAL,2020-12-27,10,Sun,15,16,,NYG,W 27-13,10,65,5,35,15,100,2020,2020_16_BAL_NYG
JAX,2020-12-27,10,Sun,15,16,,CHI,L 17-41,10,115,4,40,14,155,2020,2020_16_JAX_CHI
NOR,2020-12-20,10,Sun,14,15,,KAN,L 29-32,10,93,5,54,15,147,2020,2020_15_NOR_KAN
JAX,2020-12-13,10,Sun,13,14,,TEN,L 10-31,10,80,7,78,17,158,2020,2020_14_JAX_TEN
NOR,2020-12-06,10,Sun,12,13,@,ATL,W 21-16,10,79,1,15,11,94,2020,2020_13_NOR_ATL
JAX,2020-12-06,10,Sun,12,13,@,MIN,L 24-27 (OT),10,83,6,41,16,124,2020,2020_13_JAX_MIN
KAN,2020-11-29,10,Sun,11,12,@,TAM,W 27-24,10,82,8,57,18,139,2020,2020_12_KAN_TAM
HOU,2020-11-26,10,Thu,11,12,@,DET,W 41-25,10,74,4,44,14,118,2020,2020_12_HOU_DET
KAN,2020-11-22,10,Sun,10,11,@,LVR,W 35-31,10,89,8,72,18,161,2020,2020_11_KAN_LVR
ARI,2020-11-19,10,Thu,10,11,@,SEA,L 21-28,10,115,8,79,18,194,2020,2020_11_ARI_SEA
CHI,2020-10-18,10,Sun,6,6,@,CAR,W 23-16,10,92,8,69,18,161,2020,2020_06_CHI_CAR
BUF,2020-10-13,10,Tue,5,5,@,TEN,L 16-42,10,56,6,46,16,102,2020,2020_05_BUF_TEN
KAN,2020-10-11,10,Sun,5,5,,LVR,L 32-40,10,94,8,59,18,153,2020,2020_05_KAN_LVR
ARI,2020-10-11,10,Sun,5,5,@,NYJ,W 30-10,10,59,6,30,16,89,2020,2020_05_ARI_NYJ
CAR,2020-10-04,10,Sun,4,4,,ARI,W 31-21,10,72,5,29,15,101,2020,2020_04_CAR_ARI
DAL,2020-09-27,10,Sun,3,3,@,SEA,L 31-38,10,59,5,30,15,89,2020,2020_03_DAL_SEA
CHI,2020-09-27,10,Sun,3,3,@,ATL,W 30-26,10,80,7,75,17,155,2020,2020_03_CHI_ATL
NOR,2020-09-21,10,Mon,2,2,@,LVR,L 24-34,10,129,3,13,13,142,2020,2020_02_NOR_LVR
PIT,2020-09-20,10,Sun,2,2,,DEN,W 26-21,10,89,4,30,14,119,2020,2020_02_PIT_DEN
DAL,2019-12-29,10,Sun,16,17,,WAS,W 47-16,10,81,2,10,12,91,2019,2019_17_DAL_WAS
OAK,2019-12-29,10,Sun,16,17,@,DEN,L 15-16,10,107,9,61,19,168,2019,2019_17_OAK_DEN
LAR,2019-12-29,10,Sun,16,17,,ARI,W 31-24,10,91,8,63,18,154,2019,2019_17_LAR_ARI
CIN,2019-12-22,10,Sun,15,16,@,MIA,L 35-38 (OT),10,77,6,47,16,124,2019,2019_16_CIN_MIA
SFO,2019-12-08,10,Sun,13,14,@,NOR,W 48-46,10,67,5,50,15,117,2019,2019_14_SFO_NOR
KAN,2019-12-08,10,Sun,13,14,@,NWE,W 23-16,10,136,5,25,15,161,2019,2019_14_KAN_NWE
JAX,2019-12-08,10,Sun,13,14,,LAC,L 10-45,10,101,6,65,16,166,2019,2019_14_JAX_LAC
PHI,2019-12-01,10,Sun,12,13,@,MIA,L 31-37,10,91,7,59,17,150,2019,2019_13_PHI_MIA
PIT,2019-12-01,10,Sun,12,13,,CLE,W 20-13,10,65,5,34,15,99,2019,2019_13_PIT_CLE
NYJ,2019-12-01,10,Sun,12,13,@,CIN,L 6-22,10,106,2,15,12,121,2019,2019_13_NYJ_CIN
CHI,2019-11-28,10,Thu,12,13,@,DET,W 24-20,10,89,9,85,19,174,2019,2019_13_CHI_DET
PIT,2019-11-24,10,Sun,11,12,@,CIN,W 16-10,10,77,7,79,17,156,2019,2019_12_PIT_CIN
SFO,2019-11-17,10,Sun,10,11,,ARI,W 36-26,10,127,10,104,20,231,2019,2019_11_SFO_ARI
ARI,2019-11-17,10,Sun,11,11,@,SFO,L 26-36,10,104,10,127,20,231,2019,2019_11_ARI_SFO
LAR,2019-11-10,10,Sun,9,10,@,PIT,L 12-17,10,95,13,107,23,202,2019,2019_10_LAR_PIT
GNB,2019-11-10,10,Sun,10,10,,CAR,W 24-16,10,64,5,46,15,110,2019,2019_10_GNB_CAR
DAL,2019-11-04,10,Mon,8,9,@,NYG,W 37-18,10,104,8,71,18,175,2019,2019_09_DAL_NYG
NYJ,2019-11-03,10,Sun,8,9,@,MIA,L 18-26,10,105,6,51,16,156,2019,2019_09_NYJ_MIA
TAM,2019-11-03,10,Sun,8,9,@,SEA,L 34-40 (OT),10,82,4,45,14,127,2019,2019_09_TAM_SEA
OAK,2019-11-03,10,Sun,8,9,,DET,W 31-24,10,96,5,35,15,131,2019,2019_09_OAK_DET
IND,2019-10-27,10,Sun,7,8,,DEN,W 15-13,10,103,10,88,20,191,2019,2019_08_IND_DEN
DEN,2019-10-27,10,Sun,8,8,@,IND,L 13-15,10,88,10,103,20,191,2019,2019_08_DEN_IND
NYJ,2019-10-27,10,Sun,7,8,@,JAX,L 15-29,10,83,9,70,19,153,2019,2019_08_NYJ_JAX
ARI,2019-10-20,10,Sun,7,7,@,NYG,W 27-21,10,85,6,75,16,160,2019,2019_07_ARI_NYG
HOU,2019-10-20,10,Sun,7,7,@,IND,L 23-30,10,54,6,45,16,99,2019,2019_07_HOU_IND
SEA,2019-10-13,10,Sun,6,6,@,CLE,W 32-28,10,65,9,83,19,148,2019,2019_06_SEA_CLE
BAL,2019-10-13,10,Sun,6,6,,CIN,W 23-17,10,81,4,20,14,101,2019,2019_06_BAL_CIN
HOU,2019-10-13,10,Sun,6,6,@,KAN,W 31-24,10,70,11,79,21,149,2019,2019_06_HOU_KAN
CHI,2019-10-06,10,Sun,5,5,@,OAK,L 21-24,10,75,6,69,16,144,2019,2019_05_CHI_OAK
LAC,2019-09-29,10,Sun,4,4,@,MIA,W 30-10,10,89,5,53,15,142,2019,2019_04_LAC_MIA
ATL,2019-09-15,10,Sun,2,2,,PHI,W 24-20,10,58,7,60,17,118,2019,2019_02_ATL_PHI
SEA,2019-09-15,10,Sun,2,2,@,PIT,W 28-26,10,93,5,78,15,171,2019,2019_02_SEA_PIT
KAN,2019-09-15,10,Sun,2,2,@,OAK,W 28-10,10,114,7,52,17,166,2019,2019_02_KAN_OAK
BAL,2019-09-15,10,Sun,2,2,,ARI,W 23-17,10,62,8,70,18,132,2019,2019_02_BAL_ARI
DEN,2019-09-15,10,Sun,2,2,,CHI,L 14-16,10,81,7,65,17,146,2019,2019_02_DEN_CHI
JAX,2019-09-08,10,Sun,1,1,,KAN,L 26-40,10,71,5,55,15,126,2019,2019_01_JAX_KAN
CHI,2019-09-05,10,Thu,1,1,,GNB,L 3-10,10,107,10,71,20,178,2019,2019_01_CHI_GNB
GNB,2019-09-05,10,Thu,1,1,@,CHI,W 10-3,10,71,10,107,20,178,2019,2019_01_GNB_CHI
BAL,2018-12-30,10,Sun,16,17,,CLE,W 26-24,10,65,4,35,14,100,2018,2018_17_BAL_CLE
DAL,2018-12-23,10,Sun,15,16,,TAM,W 27-20,10,67,9,72,19,139,2018,2018_16_DAL_TAM
HOU,2018-12-23,10,Sun,15,16,@,PHI,L 30-32,10,61,11,105,21,166,2018,2018_16_HOU_PHI
GNB,2018-12-23,10,Sun,15,16,@,NYJ,W 44-38 (OT),10,86,16,172,26,258,2018,2018_16_GNB_NYJ
JAX,2018-12-23,10,Sun,15,16,@,MIA,W 17-7,10,97,10,95,20,192,2018,2018_16_JAX_MIA
MIA,2018-12-23,10,Sun,15,16,,JAX,L 7-17,10,95,10,97,20,192,2018,2018_16_MIA_JAX
CAR,2018-12-23,10,Sun,15,16,,ATL,L 10-24,10,86,4,41,14,127,2018,2018_16_CAR_ATL
NYG,2018-12-16,10,Sun,14,15,,TEN,L 0-17,10,58,4,35,14,93,2018,2018_15_NYG_TEN
KAN,2018-12-13,10,Thu,14,15,,LAC,L 28-29,10,66,7,50,17,116,2018,2018_15_KAN_LAC
TAM,2018-12-09,10,Sun,13,14,,NOR,L 14-28,10,84,6,51,16,135,2018,2018_14_TAM_NOR
CAR,2018-12-09,10,Sun,13,14,@,CLE,L 20-26,10,68,7,52,17,120,2018,2018_14_CAR_CLE
WAS,2018-12-03,10,Mon,12,13,@,PHI,L 13-28,10,69,5,38,15,107,2018,2018_13_WAS_PHI
SEA,2018-12-02,10,Sun,12,13,,SFO,W 43-16,10,100,13,128,23,228,2018,2018_13_SEA_SFO
MIA,2018-11-25,10,Sun,11,12,@,IND,L 24-27,10,75,7,52,17,127,2018,2018_12_MIA_IND
JAX,2018-11-25,10,Sun,11,12,@,BUF,L 21-24,10,90,13,80,23,170,2018,2018_12_JAX_BUF
SFO,2018-11-12,10,Mon,10,10,,NYG,L 23-27,10,97,8,78,18,175,2018,2018_10_SFO_NYG
LAR,2018-11-11,10,Sun,10,10,,SEA,W 36-31,10,102,7,56,17,158,2018,2018_10_LAR_SEA
SEA,2018-11-04,10,Sun,8,9,,LAC,L 17-25,10,83,12,105,22,188,2018,2018_09_SEA_LAC
BUF,2018-11-04,10,Sun,9,9,,CHI,L 9-41,10,163,14,129,24,292,2018,2018_09_BUF_CHI
WAS,2018-11-04,10,Sun,8,9,,ATL,L 14-38,10,147,7,50,17,197,2018,2018_09_WAS_ATL
IND,2018-10-28,10,Sun,8,8,@,OAK,W 42-28,10,77,10,79,20,156,2018,2018_08_IND_OAK
DEN,2018-10-28,10,Sun,8,8,@,KAN,L 23-30,10,83,7,50,17,133,2018,2018_08_DEN_KAN
OAK,2018-10-28,10,Sun,7,8,,IND,L 28-42,10,79,10,77,20,156,2018,2018_08_OAK_IND
BAL,2018-10-14,10,Sun,6,6,@,TEN,W 21-0,10,70,4,35,14,105,2018,2018_06_BAL_TEN
LAR,2018-10-14,10,Sun,6,6,@,DEN,W 23-20,10,81,6,61,16,142,2018,2018_06_LAR_DEN
LAC,2018-10-14,10,Sun,6,6,@,CLE,W 38-14,10,72,6,53,16,125,2018,2018_06_LAC_CLE
CLE,2018-10-07,10,Sun,5,5,,BAL,W 12-9 (OT),10,66,4,41,14,107,2018,2018_05_CLE_BAL
KAN,2018-10-01,10,Mon,4,4,@,DEN,W 27-23,10,93,3,25,13,118,2018,2018_04_KAN_DEN
MIA,2018-09-30,10,Sun,4,4,@,NWE,L 7-38,10,89,6,57,16,146,2018,2018_04_MIA_NWE
IND,2018-09-30,10,Sun,4,4,,HOU,L 34-37 (OT),10,85,10,54,20,139,2018,2018_04_IND_HOU
HOU,2018-09-30,10,Sun,4,4,@,IND,W 37-34 (OT),10,54,10,85,20,139,2018,2018_04_HOU_IND
ATL,2018-09-30,10,Sun,4,4,,CIN,L 36-37,10,95,6,55,16,150,2018,2018_04_ATL_CIN
SEA,2018-09-23,10,Sun,3,3,,DAL,W 24-13,10,67,7,55,17,122,2018,2018_03_SEA_DAL
PHI,2018-09-23,10,Sun,3,3,,IND,W 20-16,10,110,11,77,21,187,2018,2018_03_PHI_IND
DET,2018-09-16,10,Sun,2,2,@,SFO,L 27-30,10,105,9,86,19,191,2018,2018_02_DET_SFO
BUF,2018-09-09,10,Sun,1,1,@,BAL,L 3-47,10,100,9,78,19,178,2018,2018_01_BUF_BAL
DAL,2018-09-09,10,Sun,1,1,@,CAR,L 8-16,10,85,9,80,19,165,2018,2018_01_DAL_CAR
CHI,2017-12-31,10,Sun,16,17,@,MIN,L 10-23,10,116,12,103,22,219,2017,2017_17_CHI_MIN
NYG,2017-12-24,10,Sun,15,16,@,ARI,L 0-23,10,101,6,45,16,146,2017,2017_16_NYG_ARI
ATL,2017-12-24,10,Sun,15,16,@,NOR,L 13-23,10,91,3,30,13,121,2017,2017_16_ATL_NOR
CHI,2017-12-10,10,Sun,13,14,@,CIN,W 33-7,10,74,7,56,17,130,2017,2017_14_CHI_CIN
PHI,2017-12-10,10,Sun,13,14,@,LAR,W 43-35,10,67,7,102,17,169,2017,2017_14_PHI_LAR
ARI,2017-11-26,10,Sun,11,12,,JAX,W 27-24,10,98,5,45,15,143,2017,2017_12_ARI_JAX
CAR,2017-11-26,10,Sun,11,12,@,NYJ,W 35-27,10,84,7,68,17,152,2017,2017_12_CAR_NYJ
ARI,2017-11-19,10,Sun,10,11,@,HOU,L 21-31,10,90,6,42,16,132,2017,2017_11_ARI_HOU
LAR,2017-11-12,10,Sun,9,10,,HOU,W 33-7,10,86,8,60,18,146,2017,2017_10_LAR_HOU
OAK,2017-11-05,10,Sun,9,9,@,MIA,W 27-24,10,105,11,107,21,212,2017,2017_09_OAK_MIA
NYJ,2017-11-02,10,Thu,9,9,,BUF,W 34-21,10,66,11,99,21,165,2017,2017_09_NYJ_BUF
SEA,2017-10-29,10,Sun,7,8,,HOU,W 41-38,10,120,8,93,18,213,2017,2017_08_SEA_HOU
LAC,2017-10-29,10,Sun,8,8,@,NWE,L 13-21,10,77,6,80,16,157,2017,2017_08_LAC_NWE
DEN,2017-10-22,10,Sun,6,7,@,LAC,L 0-21,10,68,9,81,19,149,2017,2017_07_DEN_LAC
ARI,2017-10-22,10,Sun,7,7,@,LAR,L 0-33,10,65,6,45,16,110,2017,2017_07_ARI_LAR
OAK,2017-10-19,10,Thu,7,7,,KAN,W 31-30,10,97,8,108,18,205,2017,2017_07_OAK_KAN
PHI,2017-10-12,10,Thu,6,6,@,CAR,W 28-23,10,126,1,1,11,127,2017,2017_06_PHI_CAR
SFO,2017-10-08,10,Sun,5,5,@,IND,L 23-26 (OT),10,77,7,62,17,139,2017,2017_05_SFO_IND
NYG,2017-10-08,10,Sun,5,5,,LAC,L 22-27,10,67,11,87,21,154,2017,2017_05_NYG_LAC
NYJ,2017-10-01,10,Sun,4,4,,JAX,W 23-20 (OT),10,70,6,47,16,117,2017,2017_04_NYJ_JAX
ARI,2017-10-01,10,Sun,4,4,,SFO,W 18-15 (OT),10,80,13,113,23,193,2017,2017_04_ARI_SFO
DEN,2017-09-24,10,Sun,3,3,@,BUF,L 16-26,10,79,8,69,18,148,2017,2017_03_DEN_BUF
CLE,2017-09-24,10,Sun,3,3,@,IND,L 28-31,10,113,11,99,21,212,2017,2017_03_CLE_IND
BAL,2017-09-24,10,Sun,3,3,@,JAX,L 7-44,10,88,9,70,19,158,2017,2017_03_BAL_JAX
NYJ,2017-09-24,10,Sun,3,3,,MIA,W 20-6,10,94,8,51,18,145,2017,2017_03_NYJ_MIA
HOU,2017-09-24,10,Sun,3,3,@,NWE,L 33-36,10,60,5,69,15,129,2017,2017_03_HOU_NWE
NYG,2017-09-24,10,Sun,3,3,@,PHI,L 24-27,10,137,9,103,19,240,2017,2017_03_NYG_PHI
CHI,2017-09-24,10,Sun,3,3,,PIT,W 23-17 (OT),10,73,6,40,16,113,2017,2017_03_CHI_PIT
WAS,2017-09-24,10,Sun,3,3,,OAK,W 27-10,10,77,4,35,14,112,2017,2017_03_WAS_OAK
SFO,2017-09-21,10,Thu,3,3,,LAR,L 39-41,10,55,7,52,17,107,2017,2017_03_SFO_LAR
GNB,2017-09-17,10,Sun,2,2,@,ATL,L 23-34,10,70,6,34,16,104,2017,2017_02_GNB_ATL
PIT,2017-09-17,10,Sun,2,2,,MIN,W 26-9,10,72,11,131,21,203,2017,2017_02_PIT_MIN
JAX,2017-09-17,10,Sun,2,2,,TEN,L 16-37,10,99,7,70,17,169,2017,2017_02_JAX_TEN
SFO,2017-09-10,10,Sun,1,1,,CAR,L 3-23,10,74,5,40,15,114,2017,2017_01_SFO_CAR
DET,2017-09-10,10,Sun,1,1,,ARI,W 35-23,10,100,6,55,16,155,2017,2017_01_DET_ARI
JAX,2017-09-10,10,Sun,1,1,@,HOU,W 29-7,10,89,9,94,19,183,2017,2017_01_JAX_HOU
CLE,2023-01-08,9,Sun,17,18,@,PIT,L 14-28,9,65,4,20,13,85,2022,2022_18_CLE_PIT
MIA,2023-01-01,9,Sun,16,17,@,NWE,L 21-23,9,71,6,39,15,110,2022,2022_17_MIA_NWE
SFO,2023-01-01,9,Sun,16,17,@,LVR,W 37-34 (OT),9,71,6,49,15,120,2022,2022_17_SFO_LVR
BUF,2022-12-24,9,Sat,15,16,@,CHI,W 35-13,9,72,2,15,11,87,2022,2022_16_BUF_CHI
NYJ,2022-12-22,9,Thu,15,16,,JAX,L 3-19,9,64,3,25,12,89,2022,2022_16_NYJ_JAX
MIN,2022-12-17,9,Sat,14,15,,IND,W 39-36 (OT),9,74,11,103,20,177,2022,2022_15_MIN_IND
CLE,2022-12-11,9,Sun,13,14,@,CIN,L 10-23,9,98,4,36,13,134,2022,2022_14_CLE_CIN
JAX,2022-12-11,9,Sun,13,14,@,TEN,W 36-22,9,70,5,50,14,120,2022,2022_14_JAX_TEN
TAM,2022-11-27,9,Sun,11,12,@,CLE,L 17-23 (OT),9,70,5,42,14,112,2022,2022_12_TAM_CLE
CIN,2022-11-27,9,Sun,11,12,@,TEN,W 20-16,9,80,8,57,17,137,2022,2022_12_CIN_TEN
LVR,2022-11-20,9,Sun,10,11,@,DEN,W 22-16 (OT),9,98,5,45,14,143,2022,2022_11_LVR_DEN
CAR,2022-11-20,9,Sun,11,11,@,BAL,L 3-13,9,66,10,93,19,159,2022,2022_11_CAR_BAL
TEN,2022-11-13,9,Sun,9,10,,DEN,W 17-10,9,60,8,50,17,110,2022,2022_10_TEN_DEN
CHI,2022-11-13,9,Sun,10,10,,DET,L 30-31,9,86,2,15,11,101,2022,2022_10_CHI_DET
DAL,2022-11-13,9,Sun,9,10,@,GNB,L 28-31 (OT),9,83,6,40,15,123,2022,2022_10_DAL_GNB
CAR,2022-10-30,9,Sun,8,8,@,ATL,L 34-37 (OT),9,74,7,64,16,138,2022,2022_08_CAR_ATL
PIT,2022-10-30,9,Sun,8,8,@,PHI,L 13-35,9,60,8,60,17,120,2022,2022_08_PIT_PHI
GNB,2022-10-23,9,Sun,7,7,@,WAS,L 21-23,9,69,7,54,16,123,2022,2022_07_GNB_WAS
LAC,2022-10-17,9,Mon,6,6,,DEN,W 19-16 (OT),9,89,10,151,19,240,2022,2022_06_LAC_DEN
SFO,2022-10-09,9,Sun,5,5,@,CAR,W 37-15,9,50,5,33,14,83,2022,2022_05_SFO_CAR
WAS,2022-10-09,9,Sun,5,5,,TEN,L 17-21,9,71,8,69,17,140,2022,2022_05_WAS_TEN
BAL,2022-10-02,9,Sun,4,4,,BUF,L 20-23,9,70,4,31,13,101,2022,2022_04_BAL_BUF
HOU,2022-10-02,9,Sun,4,4,,LAC,L 24-34,9,67,6,61,15,128,2022,2022_04_HOU_LAC
TEN,2022-09-19,9,Mon,2,2,@,BUF,L 7-41,9,87,8,49,17,136,2022,2022_02_TEN_BUF
NOR,2022-09-18,9,Sun,2,2,,TAM,L 10-20,9,60,8,101,17,161,2022,2022_02_NOR_TAM
CLE,2022-09-11,9,Sun,1,1,@,CAR,W 26-24,9,71,8,96,17,167,2022,2022_01_CLE_CAR
CHI,2021-12-20,9,Mon,14,15,,MIN,L 9-17,9,91,7,54,16,145,2021,2021_15_CHI_MIN
HOU,2021-12-19,9,Sun,14,15,@,JAX,W 30-16,9,65,4,40,13,105,2021,2021_15_HOU_JAX
LVR,2021-12-12,9,Sun,13,14,@,KAN,L 9-48,9,85,8,63,17,148,2021,2021_14_LVR_KAN
JAX,2021-12-12,9,Sun,13,14,@,TEN,L 0-20,9,79,2,15,11,94,2021,2021_14_JAX_TEN
LAC,2021-11-28,9,Sun,11,12,@,DEN,L 13-28,9,75,5,35,14,110,2021,2021_12_LAC_DEN
ATL,2021-11-18,9,Thu,10,11,,NWE,L 0-25,9,72,5,59,14,131,2021,2021_11_ATL_NWE
SFO,2021-11-15,9,Mon,9,10,,LAR,W 31-10,9,53,5,35,14,88,2021,2021_10_SFO_LAR
NOR,2021-11-14,9,Sun,9,10,@,TEN,L 21-23,9,65,8,49,17,114,2021,2021_10_NOR_TEN
NYJ,2021-11-14,9,Sun,9,10,,BUF,L 17-45,9,69,7,50,16,119,2021,2021_10_NYJ_BUF
CAR,2021-11-14,9,Sun,10,10,@,ARI,W 34-10,9,115,4,58,13,173,2021,2021_10_CAR_ARI
LVR,2021-11-14,9,Sun,9,10,,KAN,L 14-41,9,68,4,34,13,102,2021,2021_10_LVR_KAN
ARI,2021-11-07,9,Sun,9,9,@,SFO,W 31-17,9,84,3,35,12,119,2021,2021_09_ARI_SFO
IND,2021-10-31,9,Sun,8,8,,TEN,L 31-34 (OT),9,75,11,161,20,236,2021,2021_08_IND_TEN
MIA,2021-10-31,9,Sun,8,8,@,BUF,L 11-26,9,58,9,80,18,138,2021,2021_08_MIA_BUF
BUF,2021-10-31,9,Sun,7,8,,MIA,W 26-11,9,80,9,58,18,138,2021,2021_08_BUF_MIA
KAN,2021-10-24,9,Sun,7,7,@,TEN,L 3-27,9,77,6,31,15,108,2021,2021_07_KAN_TEN
CLE,2021-10-21,9,Thu,7,7,,DEN,W 17-14,9,60,2,15,11,75,2021,2021_07_CLE_DEN
DET,2021-10-17,9,Sun,6,6,,CIN,L 11-34,9,77,4,31,13,108,2021,2021_06_DET_CIN
CLE,2021-10-17,9,Sun,6,6,,ARI,L 14-37,9,88,5,45,14,133,2021,2021_06_CLE_ARI
CAR,2021-10-10,9,Sun,5,5,,PHI,L 18-21,9,69,6,60,15,129,2021,2021_05_CAR_PHI
PHI,2021-10-03,9,Sun,4,4,,KAN,L 30-42,9,49,7,46,16,95,2021,2021_04_PHI_KAN
NYJ,2021-09-26,9,Sun,3,3,@,DEN,L 0-26,9,90,6,50,15,140,2021,2021_03_NYJ_DEN
DET,2021-09-20,9,Mon,2,2,@,GNB,L 17-35,9,78,5,50,14,128,2021,2021_02_DET_GNB
TAM,2021-09-19,9,Sun,2,2,,ATL,W 48-25,9,83,6,49,15,132,2021,2021_02_TAM_ATL
MIA,2021-09-19,9,Sun,2,2,,BUF,L 0-35,9,83,6,53,15,136,2021,2021_02_MIA_BUF
HOU,2021-09-19,9,Sun,2,2,@,CLE,L 21-31,9,78,5,62,14,140,2021,2021_02_HOU_CLE
WAS,2021-09-16,9,Thu,2,2,,NYG,W 30-29,9,80,11,81,20,161,2021,2021_02_WAS_NYG
IND,2020-12-27,9,Sun,15,16,@,PIT,L 24-28,9,83,6,49,15,132,2020,2020_16_IND_PIT
PHI,2020-12-20,9,Sun,14,15,@,ARI,L 26-33,9,69,9,83,18,152,2020,2020_15_PHI_ARI
ARI,2020-12-20,9,Sun,14,15,,PHI,W 33-26,9,83,9,69,18,152,2020,2020_15_ARI_PHI
WAS,2020-12-07,9,Mon,12,13,@,PIT,W 23-17,9,62,6,45,15,107,2020,2020_13_WAS_PIT
PHI,2020-11-30,9,Mon,11,12,,SEA,L 17-23,9,79,8,83,17,162,2020,2020_12_PHI_SEA
TEN,2020-11-29,9,Sun,11,12,@,IND,W 45-26,9,63,6,50,15,113,2020,2020_12_TEN_IND
BUF,2020-11-29,9,Sun,11,12,,LAC,W 27-17,9,85,5,91,14,176,2020,2020_12_BUF_LAC
LAC,2020-11-22,9,Sun,10,11,,NYJ,W 34-28,9,78,8,88,17,166,2020,2020_11_LAC_NYJ
BUF,2020-11-15,9,Sun,10,10,@,ARI,L 30-32,9,69,7,40,16,109,2020,2020_10_BUF_ARI
DET,2020-11-15,9,Sun,9,10,,WAS,W 30-27,9,55,6,58,15,113,2020,2020_10_DET_WAS
IND,2020-11-12,9,Thu,9,10,@,TEN,W 34-17,9,73,3,30,12,103,2020,2020_10_IND_TEN
MIN,2020-11-08,9,Sun,8,9,,DET,W 34-20,9,69,3,37,12,106,2020,2020_09_MIN_DET
GNB,2020-11-01,9,Sun,7,8,,MIN,L 22-28,9,85,7,36,16,121,2020,2020_08_GNB_MIN
BAL,2020-11-01,9,Sun,7,8,,PIT,L 24-28,9,110,3,30,12,140,2020,2020_08_BAL_PIT
NYG,2020-10-22,9,Thu,7,7,@,PHI,L 21-22,9,62,7,75,16,137,2020,2020_07_NYG_PHI
PHI,2020-10-11,9,Sun,5,5,@,PIT,L 29-38,9,84,8,86,17,170,2020,2020_05_PHI_PIT
TAM,2020-09-27,9,Sun,3,3,@,DEN,W 28-10,9,71,4,30,13,101,2020,2020_03_TAM_DEN
CIN,2020-09-27,9,Sun,3,3,@,PHI,T 23-23 (OT),9,73,11,93,20,166,2020,2020_03_CIN_PHI
IND,2020-09-20,9,Sun,2,2,,MIN,W 28-11,9,93,6,45,15,138,2020,2020_02_IND_MIN
SEA,2020-09-20,9,Sun,2,2,,NWE,W 35-30,9,68,2,12,11,80,2020,2020_02_SEA_NWE
CAR,2020-09-20,9,Sun,2,2,@,TAM,L 17-31,9,77,5,37,14,114,2020,2020_02_CAR_TAM
NYJ,2020-09-13,9,Sun,1,1,@,BUF,L 17-27,9,95,7,79,16,174,2020,2020_01_NYJ_BUF
TAM,2020-09-13,9,Sun,1,1,@,NOR,L 23-34,9,103,6,119,15,222,2020,2020_01_TAM_NOR
ARI,2020-09-13,9,Sun,1,1,@,SFO,W 24-20,9,102,5,53,14,155,2020,2020_01_ARI_SFO
DEN,2019-12-29,9,Sun,16,17,,OAK,W 16-15,9,61,10,107,19,168,2019,2019_17_DEN_OAK
GNB,2019-12-29,9,Sun,16,17,@,DET,W 23-20,9,97,4,50,13,147,2019,2019_17_GNB_DET
KAN,2019-12-22,9,Sun,15,16,@,CHI,W 26-3,9,71,7,50,16,121,2019,2019_16_KAN_CHI
ATL,2019-12-22,9,Sun,15,16,,JAX,W 24-12,9,64,6,36,15,100,2019,2019_16_ATL_JAX
TAM,2019-12-15,9,Sun,14,15,@,DET,W 38-17,9,70,2,10,11,80,2019,2019_15_TAM_DET
HOU,2019-12-08,9,Sun,13,14,,DEN,L 24-38,9,44,7,50,16,94,2019,2019_14_HOU_DEN
BAL,2019-12-08,9,Sun,13,14,@,BUF,W 24-17,9,99,5,49,14,148,2019,2019_14_BAL_BUF
DET,2019-11-28,9,Thu,12,13,,CHI,L 20-24,9,85,10,89,19,174,2019,2019_13_DET_CHI
NOR,2019-11-28,9,Thu,12,13,@,ATL,W 26-18,9,121,4,18,13,139,2019,2019_13_NOR_ATL
SFO,2019-11-24,9,Sun,11,12,,GNB,W 37-8,9,78,5,50,14,128,2019,2019_12_SFO_GNB
LAC,2019-11-18,9,Mon,11,11,,KAN,L 17-24,9,60,8,102,17,162,2019,2019_11_LAC_KAN
NOR,2019-11-17,9,Sun,10,11,@,TAM,W 34-17,9,76,7,55,16,131,2019,2019_11_NOR_TAM
SEA,2019-11-11,9,Mon,10,10,@,SFO,W 27-24 (OT),9,75,5,40,14,115,2019,2019_10_SEA_SFO
KAN,2019-11-10,9,Sun,10,10,@,TEN,L 32-35,9,80,8,64,17,144,2019,2019_10_KAN_TEN
TAM,2019-11-10,9,Sun,9,10,,ARI,W 30-27,9,94,11,87,20,181,2019,2019_10_TAM_ARI
CHI,2019-11-03,9,Sun,8,9,@,PHI,L 14-22,9,70,8,75,17,145,2019,2019_09_CHI_PHI
ARI,2019-10-31,9,Thu,9,9,,SFO,L 25-28,9,65,8,75,17,140,2019,2019_09_ARI_SFO
PIT,2019-10-28,9,Mon,7,8,,MIA,W 27-14,9,70,5,45,14,115,2019,2019_08_PIT_MIA
JAX,2019-10-27,9,Sun,8,8,,NYJ,W 29-15,9,70,10,83,19,153,2019,2019_08_JAX_NYJ
TAM,2019-10-27,9,Sun,7,8,@,TEN,L 23-27,9,87,6,77,15,164,2019,2019_08_TAM_TEN
CAR,2019-10-27,9,Sun,7,8,@,SFO,L 13-51,9,70,4,31,13,101,2019,2019_08_CAR_SFO
LAR,2019-10-27,9,Sun,8,8,,CIN,W 24-10,9,59,6,40,15,99,2019,2019_08_LAR_CIN
SEA,2019-10-27,9,Sun,8,8,@,ATL,W 27-20,9,60,5,40,14,100,2019,2019_08_SEA_ATL
BUF,2019-10-20,9,Sun,6,7,,MIA,W 31-21,9,83,6,55,15,138,2019,2019_07_BUF_MIA
DAL,2019-10-13,9,Sun,6,6,@,NYJ,L 22-24,9,68,8,105,17,173,2019,2019_06_DAL_NYJ
CLE,2019-10-13,9,Sun,6,6,,SEA,L 28-32,9,83,10,65,19,148,2019,2019_06_CLE_SEA
TAM,2019-10-13,9,Sun,6,6,,CAR,L 26-37,9,70,3,30,12,100,2019,2019_06_TAM_CAR
GNB,2019-10-06,9,Sun,5,5,@,DAL,W 34-24,9,78,11,124,20,202,2019,2019_05_GNB_DAL
JAX,2019-10-06,9,Sun,5,5,@,CAR,L 27-34,9,84,8,70,17,154,2019,2019_05_JAX_CAR
HOU,2019-10-06,9,Sun,5,5,,ATL,W 53-32,9,89,7,63,16,152,2019,2019_05_HOU_ATL
PHI,2019-10-06,9,Sun,5,5,,NYJ,W 31-6,9,76,9,52,18,128,2019,2019_05_PHI_NYJ
NYJ,2019-10-06,9,Sun,4,5,@,PHI,L 6-31,9,52,9,76,18,128,2019,2019_05_NYJ_PHI
NOR,2019-09-29,9,Sun,4,4,,DAL,W 12-10,9,80,6,64,15,144,2019,2019_04_NOR_DAL
PHI,2019-09-26,9,Thu,4,4,@,GNB,W 34-27,9,93,5,50,14,143,2019,2019_04_PHI_GNB
WAS,2019-09-23,9,Mon,3,3,,CHI,L 15-31,9,61,9,59,18,120,2019,2019_03_WAS_CHI
CHI,2019-09-23,9,Mon,3,3,@,WAS,W 31-15,9,59,9,61,18,120,2019,2019_03_CHI_WAS
DET,2019-09-22,9,Sun,3,3,@,PHI,W 27-24,9,61,4,30,13,91,2019,2019_03_DET_PHI
TEN,2019-09-19,9,Thu,3,3,@,JAX,L 7-20,9,101,4,30,13,131,2019,2019_03_TEN_JAX
CLE,2019-09-16,9,Mon,2,2,@,NYJ,W 23-3,9,85,12,89,21,174,2019,2019_02_CLE_NYJ
JAX,2019-09-15,9,Sun,2,2,@,HOU,L 12-13,9,70,7,47,16,117,2019,2019_02_JAX_HOU
BUF,2019-09-15,9,Sun,2,2,@,NYG,W 28-14,9,65,7,40,16,105,2019,2019_02_BUF_NYG
LAC,2019-09-15,9,Sun,2,2,@,DET,L 10-13,9,70,8,71,17,141,2019,2019_02_LAC_DET
SFO,2019-09-15,9,Sun,2,2,@,CIN,W 41-17,9,75,7,60,16,135,2019,2019_02_SFO_CIN
OAK,2019-09-09,9,Mon,1,1,,DEN,W 24-16,9,62,6,44,15,106,2019,2019_01_OAK_DEN
DET,2019-09-08,9,Sun,1,1,@,ARI,T 27-27 (OT),9,59,7,35,16,94,2019,2019_01_DET_ARI
ATL,2019-09-08,9,Sun,1,1,@,MIN,L 12-28,9,78,11,100,20,178,2019,2019_01_ATL_MIN
MIA,2019-09-08,9,Sun,1,1,,BAL,L 10-59,9,64,4,40,13,104,2019,2019_01_MIA_BAL
ATL,2018-12-30,9,Sun,16,17,@,TAM,W 34-32,9,85,3,30,12,115,2018,2018_17_ATL_TAM
CIN,2018-12-30,9,Sun,16,17,@,PIT,L 13-16,9,85,9,70,18,155,2018,2018_17_CIN_PIT
TEN,2018-12-30,9,Sun,16,17,,IND,L 17-33,9,75,12,96,21,171,2018,2018_17_TEN_IND
PIT,2018-12-30,9,Sun,16,17,,CIN,W 16-13,9,70,9,85,18,155,2018,2018_17_PIT_CIN
NOR,2018-12-23,9,Sun,15,16,,PIT,W 31-28,9,91,6,79,15,170,2018,2018_16_NOR_PIT
TAM,2018-12-23,9,Sun,15,16,@,DAL,L 20-27,9,72,10,67,19,139,2018,2018_16_TAM_DAL
NOR,2018-12-17,9,Mon,14,15,@,CAR,W 12-9,9,80,4,48,13,128,2018,2018_15_NOR_CAR
CIN,2018-12-16,9,Sun,14,15,,OAK,W 30-16,9,85,8,90,17,175,2018,2018_15_CIN_OAK
DAL,2018-12-16,9,Sun,14,15,@,IND,L 0-23,9,74,6,55,15,129,2018,2018_15_DAL_IND
NYJ,2018-12-15,9,Sat,14,15,,HOU,L 22-29,9,60,5,43,14,103,2018,2018_15_NYJ_HOU
IND,2018-12-09,9,Sun,13,14,@,HOU,W 24-21,9,59,7,35,16,94,2018,2018_14_IND_HOU
LAR,2018-12-09,9,Sun,13,14,@,CHI,L 6-15,9,57,6,45,15,102,2018,2018_14_LAR_CHI
TAM,2018-12-02,9,Sun,12,13,,CAR,W 24-17,9,69,7,104,16,173,2018,2018_13_TAM_CAR
BAL,2018-12-02,9,Sun,12,13,@,ATL,W 26-16,9,88,8,82,17,170,2018,2018_13_BAL_ATL
TAM,2018-11-25,9,Sun,11,12,,SFO,W 27-9,9,70,8,68,17,138,2018,2018_12_TAM_SFO
CAR,2018-11-04,9,Sun,8,9,,TAM,W 42-28,9,84,8,49,17,133,2018,2018_09_CAR_TAM
ARI,2018-10-28,9,Sun,8,8,,SFO,W 18-15,9,62,5,59,14,121,2018,2018_08_ARI_SFO
BAL,2018-10-28,9,Sun,8,8,@,CAR,L 21-36,9,68,4,30,13,98,2018,2018_08_BAL_CAR
MIN,2018-10-14,9,Sun,6,6,,ARI,W 27-17,9,52,5,30,14,82,2018,2018_06_MIN_ARI
PIT,2018-10-14,9,Sun,6,6,@,CIN,W 28-21,9,69,6,30,15,99,2018,2018_06_PIT_CIN
LAC,2018-10-07,9,Sun,5,5,,OAK,W 26-10,9,82,7,55,16,137,2018,2018_05_LAC_OAK
SFO,2018-10-07,9,Sun,5,5,,ARI,L 18-28,9,65,5,46,14,111,2018,2018_05_SFO_ARI
MIA,2018-10-07,9,Sun,5,5,@,CIN,L 17-27,9,85,6,47,15,132,2018,2018_05_MIA_CIN
JAX,2018-09-30,9,Sun,4,4,,NYJ,W 31-12,9,89,6,43,15,132,2018,2018_04_JAX_NYJ
TAM,2018-09-24,9,Mon,3,3,,PIT,L 27-30,9,80,13,155,22,235,2018,2018_03_TAM_PIT
MIA,2018-09-23,9,Sun,3,3,,OAK,W 28-20,9,74,8,38,17,112,2018,2018_03_MIA_OAK
ARI,2018-09-16,9,Sun,2,2,@,LAR,L 0-34,9,47,5,49,14,96,2018,2018_02_ARI_LAR
SFO,2018-09-16,9,Sun,2,2,,DET,W 30-27,9,86,10,105,19,191,2018,2018_02_SFO_DET
CIN,2018-09-13,9,Thu,2,2,,BAL,W 34-23,9,92,7,51,16,143,2018,2018_02_CIN_BAL
ARI,2018-09-09,9,Sun,1,1,,WAS,L 6-24,9,67,9,63,18,130,2018,2018_01_ARI_WAS
CAR,2018-09-09,9,Sun,1,1,,DAL,W 16-8,9,80,10,85,19,165,2018,2018_01_CAR_DAL
WAS,2018-09-09,9,Sun,1,1,@,ARI,W 24-6,9,63,9,67,18,130,2018,2018_01_WAS_ARI
BAL,2018-09-09,9,Sun,1,1,,BUF,W 47-3,9,78,10,100,19,178,2018,2018_01_BAL_BUF
NYJ,2017-12-31,9,Sun,16,17,@,NWE,L 6-26,9,84,4,49,13,133,2017,2017_17_NYJ_NWE
CLE,2017-12-31,9,Sun,16,17,@,PIT,L 24-28,9,77,3,15,12,92,2017,2017_17_CLE_PIT
DET,2017-12-24,9,Sun,15,16,@,CIN,L 17-26,9,74,5,60,14,134,2017,2017_16_DET_CIN
SEA,2017-12-17,9,Sun,14,15,,LAR,L 7-42,9,60,3,25,12,85,2017,2017_15_SEA_LAR
LAC,2017-12-16,9,Sat,14,15,@,KAN,L 13-30,9,61,7,71,16,132,2017,2017_15_LAC_KAN
NWE,2017-12-11,9,Mon,13,14,@,MIA,L 20-27,9,78,8,102,17,180,2017,2017_14_NWE_MIA
NWE,2017-12-03,9,Sun,12,13,@,BUF,W 23-3,9,66,3,34,12,100,2017,2017_13_NWE_BUF
DEN,2017-12-03,9,Sun,12,13,@,MIA,L 9-35,9,57,7,85,16,142,2017,2017_13_DEN_MIA
LAR,2017-11-26,9,Sun,11,12,,NOR,W 26-20,9,90,7,112,16,202,2017,2017_12_LAR_NOR
IND,2017-11-26,9,Sun,11,12,,TEN,L 16-20,9,67,2,15,11,82,2017,2017_12_IND_TEN
CHI,2017-11-26,9,Sun,11,12,@,PHI,L 3-31,9,56,11,70,20,126,2017,2017_12_CHI_PHI
DEN,2017-11-26,9,Sun,11,12,@,OAK,L 14-21,9,75,7,68,16,143,2017,2017_12_DEN_OAK
MIN,2017-11-23,9,Thu,11,12,@,DET,W 30-23,9,74,8,54,17,128,2017,2017_12_MIN_DET
SEA,2017-11-20,9,Mon,10,11,,ATL,L 31-34,9,106,7,69,16,175,2017,2017_11_SEA_ATL
TAM,2017-11-19,9,Sun,10,11,@,MIA,W 30-20,9,82,17,123,26,205,2017,2017_11_TAM_MIA
WAS,2017-11-19,9,Sun,10,11,@,NOR,L 31-34 (OT),9,67,7,54,16,121,2017,2017_11_WAS_NOR
KAN,2017-11-19,9,Sun,10,11,@,NYG,L 9-12 (OT),9,87,5,48,14,135,2017,2017_11_KAN_NYG
TEN,2017-11-16,9,Thu,10,11,@,PIT,L 17-40,9,65,7,61,16,126,2017,2017_11_TEN_PIT
PIT,2017-11-12,9,Sun,9,10,@,IND,W 20-17,9,70,9,82,18,152,2017,2017_10_PIT_IND
JAX,2017-11-12,9,Sun,9,10,,LAC,W 20-17 (OT),9,106,7,77,16,183,2017,2017_10_JAX_LAC
IND,2017-11-12,9,Sun,10,10,,PIT,L 17-20,9,82,9,70,18,152,2017,2017_10_IND_PIT
ARI,2017-11-09,9,Thu,9,10,,SEA,L 16-22,9,58,12,108,21,166,2017,2017_10_ARI_SEA
PHI,2017-10-23,9,Mon,7,7,,WAS,W 34-24,9,55,5,55,14,110,2017,2017_07_PHI_WAS
LAC,2017-10-22,9,Sun,7,7,,DEN,W 21-0,9,81,10,68,19,149,2017,2017_07_LAC_DEN
MIA,2017-10-22,9,Sun,6,7,,NYJ,W 31-28,9,76,12,124,21,200,2017,2017_07_MIA_NYJ
TAM,2017-10-15,9,Sun,5,6,@,ARI,L 33-38,9,49,7,61,16,110,2017,2017_06_TAM_ARI
MIN,2017-10-09,9,Mon,5,5,@,CHI,W 20-17,9,69,8,55,17,124,2017,2017_05_MIN_CHI
NYJ,2017-10-08,9,Sun,5,5,@,CLE,W 17-14,9,80,6,60,15,140,2017,2017_05_NYJ_CLE
TAM,2017-10-05,9,Thu,4,5,,NWE,L 14-19,9,70,12,108,21,178,2017,2017_05_TAM_NWE
BUF,2017-10-01,9,Sun,4,4,@,ATL,W 23-17,9,55,4,45,13,100,2017,2017_04_BUF_ATL
LAC,2017-10-01,9,Sun,4,4,,PHI,L 24-26,9,39,9,58,18,97,2017,2017_04_LAC_PHI
PHI,2017-10-01,9,Sun,4,4,@,LAC,W 26-24,9,58,9,39,18,97,2017,2017_04_PHI_LAC
DAL,2017-09-25,9,Mon,3,3,@,ARI,W 28-17,9,76,6,50,15,126,2017,2017_03_DAL_ARI
DET,2017-09-24,9,Sun,3,3,,ATL,L 26-30,9,98,8,68,17,166,2017,2017_03_DET_ATL
PHI,2017-09-24,9,Sun,3,3,,NYG,W 27-24,9,103,10,137,19,240,2017,2017_03_PHI_NYG
JAX,2017-09-24,9,Sun,3,3,,BAL,W 44-7,9,70,10,88,19,158,2017,2017_03_JAX_BAL
NWE,2017-09-17,9,Sun,2,2,@,NOR,W 36-20,9,66,5,35,14,101,2017,2017_02_NWE_NOR
OAK,2017-09-17,9,Sun,2,2,,NYJ,W 45-20,9,79,5,47,14,126,2017,2017_02_OAK_NYJ
SEA,2017-09-17,9,Sun,2,2,,SFO,W 12-9,9,71,6,66,15,137,2017,2017_02_SEA_SFO
HOU,2017-09-14,9,Thu,2,2,@,CIN,W 13-9,9,61,7,45,16,106,2017,2017_02_HOU_CIN
HOU,2017-09-10,9,Sun,1,1,,JAX,L 7-29,9,94,10,89,19,183,2017,2017_01_HOU_JAX
CIN,2017-09-10,9,Sun,1,1,,BAL,L 0-20,9,66,11,85,20,151,2017,2017_01_CIN_BAL
MIN,2023-01-08,8,Sun,17,18,@,CHI,W 29-13,8,36,2,20,10,56,2022,2022_18_MIN_CHI
NYG,2023-01-08,8,Sun,17,18,@,PHI,L 16-22,8,66,4,30,12,96,2022,2022_18_NYG_PHI
ARI,2023-01-01,8,Sun,16,17,@,ATL,L 19-20,8,50,5,70,13,120,2022,2022_17_ARI_ATL
TAM,2023-01-01,8,Sun,16,17,,CAR,W 30-24,8,51,8,58,16,109,2022,2022_17_TAM_CAR
PHI,2023-01-01,8,Sun,16,17,,NOR,L 10-20,8,49,3,20,11,69,2022,2022_17_PHI_NOR
CAR,2023-01-01,8,Sun,16,17,@,TAM,L 24-30,8,58,8,51,16,109,2022,2022_17_CAR_TAM
MIA,2022-12-25,8,Sun,15,16,,GNB,L 20-26,8,62,5,40,13,102,2022,2022_16_MIA_GNB
CIN,2022-12-24,8,Sat,15,16,@,NWE,W 22-18,8,62,10,82,18,144,2022,2022_16_CIN_NWE
LAR,2022-12-19,8,Mon,14,15,@,GNB,L 12-24,8,76,4,80,12,156,2022,2022_15_LAR_GNB
MIA,2022-12-17,8,Sat,14,15,@,BUF,L 29-32,8,51,7,51,15,102,2022,2022_15_MIA_BUF
SEA,2022-12-15,8,Thu,14,15,,SFO,L 13-21,8,79,7,60,15,139,2022,2022_15_SEA_SFO
NWE,2022-12-12,8,Mon,13,14,@,ARI,W 27-13,8,80,8,48,16,128,2022,2022_14_NWE_ARI
ARI,2022-12-12,8,Mon,13,14,,NWE,L 13-27,8,48,8,80,16,128,2022,2022_14_ARI_NWE
TAM,2022-12-11,8,Sun,13,14,@,SFO,L 7-35,8,62,2,15,10,77,2022,2022_14_TAM_SFO
MIA,2022-12-04,8,Sun,12,13,@,SFO,L 17-33,8,68,4,45,12,113,2022,2022_13_MIA_SFO
TEN,2022-11-27,8,Sun,11,12,,CIN,L 16-20,8,57,9,80,17,137,2022,2022_12_TEN_CIN
PIT,2022-11-20,8,Sun,10,11,,CIN,L 30-37,8,70,6,44,14,114,2022,2022_11_PIT_CIN
BUF,2022-11-20,8,Sun,10,11,,CLE,W 31-23,8,89,6,42,14,131,2022,2022_11_BUF_CLE
NYG,2022-11-20,8,Sun,10,11,,DET,L 18-31,8,63,5,45,13,108,2022,2022_11_NYG_DET
NWE,2022-11-20,8,Sun,10,11,,NYJ,W 10-3,8,55,3,15,11,70,2022,2022_11_NWE_NYJ
IND,2022-11-20,8,Sun,11,11,,PHI,L 16-17,8,90,7,55,15,145,2022,2022_11_IND_PHI
DEN,2022-11-13,8,Sun,9,10,@,TEN,L 10-17,8,50,9,60,17,110,2022,2022_10_DEN_TEN
GNB,2022-11-06,8,Sun,9,9,@,DET,L 9-15,8,81,7,62,15,143,2022,2022_09_GNB_DET
TEN,2022-11-06,8,Sun,8,9,@,KAN,L 17-20 (OT),8,51,10,69,18,120,2022,2022_09_TEN_KAN
GNB,2022-10-30,8,Sun,8,8,@,BUF,L 17-27,8,58,4,35,12,93,2022,2022_08_GNB_BUF
PHI,2022-10-30,8,Sun,7,8,,PIT,W 35-13,8,60,9,60,17,120,2022,2022_08_PHI_PIT
DET,2022-10-23,8,Sun,6,7,@,DAL,L 6-24,8,59,7,55,15,114,2022,2022_07_DET_DAL
NYG,2022-10-23,8,Sun,7,7,@,JAX,W 23-17,8,67,13,81,21,148,2022,2022_07_NYG_JAX
KAN,2022-10-23,8,Sun,7,7,@,SFO,W 44-23,8,84,10,80,18,164,2022,2022_07_KAN_SFO
NOR,2022-10-20,8,Thu,7,7,@,ARI,L 34-42,8,49,4,20,12,69,2022,2022_07_NOR_ARI
TEN,2022-10-09,8,Sun,5,5,@,WAS,W 21-17,8,69,9,71,17,140,2022,2022_05_TEN_WAS
IND,2022-10-06,8,Thu,5,5,@,DEN,W 12-9 (OT),8,64,7,49,15,113,2022,2022_05_IND_DEN
PIT,2022-10-02,8,Sun,4,4,,NYJ,L 20-24,8,55,7,64,15,119,2022,2022_04_PIT_NYJ
DET,2022-10-02,8,Sun,4,4,,SEA,L 45-48,8,59,11,76,19,135,2022,2022_04_DET_SEA
NYG,2022-09-26,8,Mon,3,3,,DAL,L 16-23,8,57,8,70,16,127,2022,2022_03_NYG_DAL
DAL,2022-09-26,8,Mon,3,3,@,NYG,W 23-16,8,70,8,57,16,127,2022,2022_03_DAL_NYG
GNB,2022-09-25,8,Sun,3,3,@,TAM,W 14-12,8,65,6,40,14,105,2022,2022_03_GNB_TAM
PHI,2022-09-19,8,Mon,2,2,,MIN,W 24-7,8,60,5,25,13,85,2022,2022_02_PHI_MIN
BUF,2022-09-19,8,Mon,2,2,,TEN,W 41-7,8,49,9,87,17,136,2022,2022_02_BUF_TEN
NYG,2022-09-18,8,Sun,2,2,,CAR,W 19-16,8,62,5,38,13,100,2022,2022_02_NYG_CAR
NYJ,2022-09-18,8,Sun,2,2,@,CLE,W 31-30,8,57,5,38,13,95,2022,2022_02_NYJ_CLE
HOU,2022-09-18,8,Sun,2,2,@,DEN,L 9-16,8,94,13,100,21,194,2022,2022_02_HOU_DEN
TAM,2022-09-18,8,Sun,2,2,@,NOR,W 20-10,8,101,9,60,17,161,2022,2022_02_TAM_NOR
MIA,2022-09-18,8,Sun,2,2,@,BAL,W 42-38,8,51,1,5,9,56,2022,2022_02_MIA_BAL
NOR,2022-09-11,8,Sun,1,1,@,ATL,W 27-26,8,99,8,55,16,154,2022,2022_01_NOR_ATL
PIT,2022-09-11,8,Sun,1,1,@,CIN,W 23-20 (OT),8,59,4,27,12,86,2022,2022_01_PIT_CIN
CAR,2022-09-11,8,Sun,1,1,,CLE,L 24-26,8,96,9,71,17,167,2022,2022_01_CAR_CLE
ATL,2022-09-11,8,Sun,1,1,,NOR,L 26-27,8,55,8,99,16,154,2022,2022_01_ATL_NOR
NYG,2022-09-11,8,Sun,1,1,@,TEN,W 21-20,8,45,7,50,15,95,2022,2022_01_NYG_TEN
NWE,2022-01-09,8,Sun,17,18,@,MIA,L 24-33,8,78,5,33,13,111,2021,2021_18_NWE_MIA
CHI,2021-12-26,8,Sun,15,16,@,SEA,W 25-24,8,73,7,88,15,161,2021,2021_16_CHI_SEA
SEA,2021-12-21,8,Tue,14,15,@,LAR,L 10-20,8,65,4,34,12,99,2021,2021_15_SEA_LAR
GNB,2021-12-19,8,Sun,14,15,@,BAL,W 31-30,8,76,8,56,16,132,2021,2021_15_GNB_BAL
BUF,2021-12-19,8,Sun,14,15,,CAR,W 31-14,8,67,5,55,13,122,2021,2021_15_BUF_CAR
BAL,2021-12-19,8,Sun,14,15,,GNB,L 30-31,8,56,8,76,16,132,2021,2021_15_BAL_GNB
NWE,2021-12-18,8,Sat,14,15,@,IND,L 17-27,8,50,2,13,10,63,2021,2021_15_NWE_IND
SEA,2021-12-12,8,Sun,13,14,@,HOU,W 33-13,8,69,6,52,14,121,2021,2021_14_SEA_HOU
KAN,2021-12-12,8,Sun,13,14,,LVR,W 48-9,8,63,9,85,17,148,2021,2021_14_KAN_LVR
ARI,2021-12-05,8,Sun,12,13,@,CHI,W 33-22,8,63,6,45,14,108,2021,2021_13_ARI_CHI
WAS,2021-11-21,8,Sun,10,11,@,CAR,W 27-21,8,69,7,65,15,134,2021,2021_11_WAS_CAR
GNB,2021-11-21,8,Sun,11,11,@,MIN,L 31-34,8,92,3,25,11,117,2021,2021_11_GNB_MIN
MIA,2021-11-21,8,Sun,11,11,@,NYJ,W 24-17,8,62,7,48,15,110,2021,2021_11_MIA_NYJ
PIT,2021-11-21,8,Sun,10,11,@,LAC,L 37-41,8,38,12,75,20,113,2021,2021_11_PIT_LAC
JAX,2021-11-21,8,Sun,10,11,,SFO,L 10-30,8,56,1,12,9,68,2021,2021_11_JAX_SFO
DET,2021-11-14,8,Sun,9,10,@,PIT,T 16-16 (OT),8,84,7,59,15,143,2021,2021_10_DET_PIT
DAL,2021-11-14,8,Sun,9,10,,ATL,W 43-3,8,80,6,41,14,121,2021,2021_10_DAL_ATL
JAX,2021-11-14,8,Sun,9,10,@,IND,L 17-23,8,79,7,47,15,126,2021,2021_10_JAX_IND
TEN,2021-11-14,8,Sun,10,10,,NOR,W 23-21,8,49,9,65,17,114,2021,2021_10_TEN_NOR
JAX,2021-11-07,8,Sun,8,9,,BUF,W 9-6,8,54,12,118,20,172,2021,2021_09_JAX_BUF
HOU,2021-11-07,8,Sun,9,9,@,MIA,L 9-17,8,60,2,13,10,73,2021,2021_09_HOU_MIA
BAL,2021-11-07,8,Sun,8,9,,MIN,W 34-31 (OT),8,61,8,107,16,168,2021,2021_09_BAL_MIN
MIN,2021-11-07,8,Sun,8,9,@,BAL,L 31-34 (OT),8,107,8,61,16,168,2021,2021_09_MIN_BAL
DET,2021-10-31,8,Sun,8,8,,PHI,L 6-44,8,50,2,15,10,65,2021,2021_08_DET_PHI
CAR,2021-10-31,8,Sun,8,8,@,ATL,W 19-13,8,76,3,15,11,91,2021,2021_08_CAR_ATL
NYJ,2021-10-31,8,Sun,7,8,,CIN,W 34-31,8,46,5,51,13,97,2021,2021_08_NYJ_CIN
PIT,2021-10-31,8,Sun,7,8,@,CLE,W 15-10,8,65,5,30,13,95,2021,2021_08_PIT_CLE
NYG,2021-10-24,8,Sun,7,7,,CAR,W 25-3,8,60,7,37,15,97,2021,2021_07_NYG_CAR
HOU,2021-10-24,8,Sun,7,7,@,ARI,L 5-31,8,80,7,54,15,134,2021,2021_07_HOU_ARI
DET,2021-10-24,8,Sun,7,7,@,LAR,L 19-28,8,77,4,35,12,112,2021,2021_07_DET_LAR
BUF,2021-10-18,8,Mon,6,6,@,TEN,L 31-34,8,60,7,91,15,151,2021,2021_06_BUF_TEN
JAX,2021-10-17,8,Sun,6,6,,MIA,W 23-20,8,54,7,55,15,109,2021,2021_06_JAX_MIA
BAL,2021-10-11,8,Mon,5,5,,IND,W 31-25 (OT),8,74,5,45,13,119,2021,2021_05_BAL_IND
PIT,2021-10-10,8,Sun,5,5,,DEN,W 27-19,8,59,7,67,15,126,2021,2021_05_PIT_DEN
HOU,2021-10-10,8,Sun,5,5,,NWE,L 22-25,8,70,5,27,13,97,2021,2021_05_HOU_NWE
DAL,2021-10-10,8,Sun,5,5,,NYG,W 44-20,8,58,5,48,13,106,2021,2021_05_DAL_NYG
CHI,2021-10-10,8,Sun,5,5,@,LVR,W 20-9,8,70,10,82,18,152,2021,2021_05_CHI_LVR
SFO,2021-10-03,8,Sun,4,4,,SEA,L 21-28,8,78,5,27,13,105,2021,2021_04_SFO_SEA
NWE,2021-10-03,8,Sun,4,4,,TAM,L 17-19,8,77,7,74,15,151,2021,2021_04_NWE_TAM
IND,2021-10-03,8,Sun,4,4,@,MIA,W 27-17,8,86,5,32,13,118,2021,2021_04_IND_MIA
TEN,2021-10-03,8,Sun,4,4,@,NYJ,L 24-27 (OT),8,98,6,65,14,163,2021,2021_04_TEN_NYJ
NYG,2021-09-26,8,Sun,3,3,,ATL,L 14-17,8,53,4,28,12,81,2021,2021_03_NYG_ATL
LAC,2021-09-26,8,Sun,3,3,@,KAN,W 30-24,8,50,6,56,14,106,2021,2021_03_LAC_KAN
LVR,2021-09-26,8,Sun,3,3,,MIA,W 31-28 (OT),8,104,8,68,16,172,2021,2021_03_LVR_MIA
MIA,2021-09-26,8,Sun,3,3,@,LVR,L 28-31 (OT),8,68,8,104,16,172,2021,2021_03_MIA_LVR
CAR,2021-09-23,8,Thu,3,3,@,HOU,W 24-9,8,64,7,51,15,115,2021,2021_03_CAR_HOU
CHI,2021-09-19,8,Sun,2,2,,CIN,W 20-17,8,70,4,57,12,127,2021,2021_02_CHI_CIN
BAL,2021-09-19,8,Sun,2,2,,KAN,W 36-35,8,55,5,46,13,101,2021,2021_02_BAL_KAN
NYJ,2021-09-19,8,Sun,2,2,,NWE,L 6-25,8,77,6,54,14,131,2021,2021_02_NYJ_NWE
DAL,2021-09-19,8,Sun,2,2,@,LAC,W 20-17,8,76,12,99,20,175,2021,2021_02_DAL_LAC
PHI,2021-09-19,8,Sun,2,2,,SFO,L 11-17,8,57,5,60,13,117,2021,2021_02_PHI_SFO
ARI,2021-09-12,8,Sun,1,1,@,TEN,W 38-13,8,59,7,57,15,116,2021,2021_01_ARI_TEN
BUF,2021-09-12,8,Sun,1,1,,PIT,L 16-23,8,81,5,32,13,113,2021,2021_01_BUF_PIT
WAS,2021-09-12,8,Sun,1,1,,LAC,L 16-20,8,57,6,94,14,151,2021,2021_01_WAS_LAC
NWE,2021-09-12,8,Sun,1,1,,MIA,L 16-17,8,84,5,28,13,112,2021,2021_01_NWE_MIA
DAL,2021-09-09,8,Thu,1,1,@,TAM,L 29-31,8,55,11,106,19,161,2021,2021_01_DAL_TAM
TAM,2020-12-26,8,Sat,15,16,@,DET,W 47-7,8,65,11,117,19,182,2020,2020_16_TAM_DET
BUF,2020-12-19,8,Sat,14,15,@,DEN,W 48-19,8,75,7,33,15,108,2020,2020_15_BUF_DEN
BAL,2020-12-14,8,Mon,13,14,@,CLE,W 47-42,8,69,8,75,16,144,2020,2020_14_BAL_CLE
CLE,2020-12-14,8,Mon,13,14,,BAL,L 42-47,8,75,8,69,16,144,2020,2020_14_CLE_BAL
KAN,2020-12-13,8,Sun,13,14,@,MIA,W 33-27,8,56,3,35,11,91,2020,2020_14_KAN_MIA
NOR,2020-12-13,8,Sun,13,14,@,PHI,L 21-24,8,52,6,27,14,79,2020,2020_14_NOR_PHI
MIA,2020-12-06,8,Sun,12,13,,CIN,W 19-7,8,54,6,62,14,116,2020,2020_13_MIA_CIN
SEA,2020-11-30,8,Mon,11,12,@,PHI,W 23-17,8,83,9,79,17,162,2020,2020_12_SEA_PHI
MIN,2020-11-29,8,Sun,11,12,,CAR,W 28-27,8,52,7,58,15,110,2020,2020_12_MIN_CAR
TAM,2020-11-29,8,Sun,12,12,,KAN,L 24-27,8,57,10,82,18,139,2020,2020_12_TAM_KAN
MIN,2020-11-22,8,Sun,10,11,,DAL,L 28-31,8,80,4,30,12,110,2020,2020_11_MIN_DAL
IND,2020-11-22,8,Sun,10,11,,GNB,W 34-31 (OT),8,116,7,45,15,161,2020,2020_11_IND_GNB
LVR,2020-11-22,8,Sun,10,11,,KAN,L 31-35,8,72,10,89,18,161,2020,2020_11_LVR_KAN
DEN,2020-11-22,8,Sun,10,11,,MIA,W 20-13,8,70,5,50,13,120,2020,2020_11_DEN_MIA
JAX,2020-11-22,8,Sun,10,11,,PIT,L 3-27,8,105,6,42,14,147,2020,2020_11_JAX_PIT
NYJ,2020-11-22,8,Sun,10,11,@,LAC,L 28-34,8,88,9,78,17,166,2020,2020_11_NYJ_LAC
SEA,2020-11-19,8,Thu,10,11,,ARI,W 28-21,8,79,10,115,18,194,2020,2020_11_SEA_ARI
LVR,2020-11-15,8,Sun,9,10,,DEN,W 37-12,8,82,7,37,15,119,2020,2020_10_LVR_DEN
BAL,2020-11-15,8,Sun,9,10,@,NWE,L 17-23,8,64,3,18,11,82,2020,2020_10_BAL_NWE
KAN,2020-11-08,8,Sun,9,9,,CAR,W 33-31,8,75,12,82,20,157,2020,2020_09_KAN_CAR
DEN,2020-11-01,8,Sun,7,8,,LAC,W 31-30,8,70,6,67,14,137,2020,2020_08_DEN_LAC
SEA,2020-10-25,8,Sun,6,7,@,ARI,L 34-37 (OT),8,78,6,40,14,118,2020,2020_07_SEA_ARI
ATL,2020-10-25,8,Sun,7,7,,DET,L 22-23,8,53,5,50,13,103,2020,2020_07_ATL_DET
PIT,2020-10-25,8,Sun,6,7,@,TEN,W 27-24,8,69,7,73,15,142,2020,2020_07_PIT_TEN
KAN,2020-10-19,8,Mon,6,6,@,BUF,W 26-17,8,68,4,39,12,107,2020,2020_06_KAN_BUF
CAR,2020-10-18,8,Sun,6,6,,CHI,L 16-23,8,69,10,92,18,161,2020,2020_06_CAR_CHI
WAS,2020-10-18,8,Sun,6,6,@,NYG,L 19-20,8,50,4,30,12,80,2020,2020_06_WAS_NYG
NYG,2020-10-11,8,Sun,5,5,@,DAL,L 34-37,8,81,3,25,11,106,2020,2020_05_NYG_DAL
LVR,2020-10-11,8,Sun,5,5,@,KAN,W 40-32,8,59,10,94,18,153,2020,2020_05_LVR_KAN
PIT,2020-10-11,8,Sun,4,5,,PHI,W 38-29,8,86,9,84,17,170,2020,2020_05_PIT_PHI
IND,2020-10-04,8,Sun,4,4,@,CHI,W 19-11,8,76,8,103,16,179,2020,2020_04_IND_CHI
CHI,2020-10-04,8,Sun,4,4,,IND,L 11-19,8,103,8,76,16,179,2020,2020_04_CHI_IND
TAM,2020-10-04,8,Sun,4,4,,LAC,W 38-31,8,90,7,60,15,150,2020,2020_04_TAM_LAC
DEN,2020-10-01,8,Thu,4,4,@,NYJ,W 37-28,8,94,11,118,19,212,2020,2020_04_DEN_NYJ
LAC,2020-09-27,8,Sun,3,3,,CAR,L 16-21,8,60,3,30,11,90,2020,2020_03_LAC_CAR
NOR,2020-09-27,8,Sun,3,3,,GNB,L 30-37,8,83,2,10,10,93,2020,2020_03_NOR_GNB
JAX,2020-09-24,8,Thu,3,3,,MIA,L 13-31,8,63,6,51,14,114,2020,2020_03_JAX_MIA
ATL,2020-09-20,8,Sun,2,2,@,DAL,L 39-40,8,51,7,75,15,126,2020,2020_02_ATL_DAL
GNB,2020-09-20,8,Sun,2,2,,DET,W 42-21,8,60,7,70,15,130,2020,2020_02_GNB_DET
JAX,2020-09-20,8,Sun,2,2,@,TEN,L 30-33,8,60,4,30,12,90,2020,2020_02_JAX_TEN
CLE,2020-09-17,8,Thu,2,2,,CIN,W 35-30,8,76,4,45,12,121,2020,2020_02_CLE_CIN
DET,2020-09-13,8,Sun,1,1,,CHI,L 23-27,8,77,6,48,14,125,2020,2020_01_DET_CHI
CLE,2020-09-13,8,Sun,1,1,@,BAL,L 6-38,8,80,7,66,15,146,2020,2020_01_CLE_BAL
LAC,2019-12-29,8,Sun,16,17,@,KAN,L 21-31,8,40,5,39,13,79,2019,2019_17_LAC_KAN
ARI,2019-12-29,8,Sun,16,17,@,LAR,L 24-31,8,63,10,91,18,154,2019,2019_17_ARI_LAR
SFO,2019-12-29,8,Sun,16,17,@,SEA,W 26-21,8,57,5,29,13,86,2019,2019_17_SFO_SEA
BUF,2019-12-15,8,Sun,14,15,@,PIT,W 17-10,8,70,6,30,14,100,2019,2019_15_BUF_PIT
JAX,2019-12-15,8,Sun,14,15,@,OAK,W 20-16,8,87,6,51,14,138,2019,2019_15_JAX_OAK
NYJ,2019-12-12,8,Thu,14,15,@,BAL,L 21-42,8,94,6,35,14,129,2019,2019_15_NYJ_BAL
SEA,2019-12-08,8,Sun,13,14,@,LAR,L 12-28,8,64,3,20,11,84,2019,2019_14_SEA_LAR
CIN,2019-12-08,8,Sun,13,14,@,CLE,L 19-27,8,99,6,30,14,129,2019,2019_14_CIN_CLE
MIN,2019-12-08,8,Sun,13,14,,DET,W 20-7,8,55,4,28,12,83,2019,2019_14_MIN_DET
LAR,2019-12-01,8,Sun,12,13,@,ARI,W 34-7,8,81,2,7,10,88,2019,2019_13_LAR_ARI
NWE,2019-12-01,8,Sun,12,13,@,HOU,L 22-28,8,60,8,79,16,139,2019,2019_13_NWE_HOU
TAM,2019-12-01,8,Sun,12,13,@,JAX,W 28-11,8,44,16,121,24,165,2019,2019_13_TAM_JAX
HOU,2019-12-01,8,Sun,12,13,,NWE,W 28-22,8,79,8,60,16,139,2019,2019_13_HOU_NWE
BAL,2019-11-25,8,Mon,11,12,@,LAR,W 45-6,8,66,8,56,16,122,2019,2019_12_BAL_LAR
LAR,2019-11-25,8,Mon,11,12,,BAL,L 6-45,8,56,8,66,16,122,2019,2019_12_LAR_BAL
TAM,2019-11-24,8,Sun,11,12,@,ATL,W 35-22,8,51,7,60,15,111,2019,2019_12_TAM_ATL
MIA,2019-11-24,8,Sun,11,12,@,CLE,L 24-41,8,94,7,70,15,164,2019,2019_12_MIA_CLE
WAS,2019-11-24,8,Sun,11,12,,DET,W 19-16,8,63,6,65,14,128,2019,2019_12_WAS_DET
KAN,2019-11-18,8,Mon,11,11,@,LAC,W 24-17,8,102,9,60,17,162,2019,2019_11_KAN_LAC
BAL,2019-11-17,8,Sun,10,11,,HOU,W 41-7,8,65,5,60,13,125,2019,2019_11_BAL_HOU
CAR,2019-11-17,8,Sun,10,11,,ATL,L 3-29,8,68,3,20,11,88,2019,2019_11_CAR_ATL
JAX,2019-11-17,8,Sun,10,11,@,IND,L 13-33,8,81,3,20,11,101,2019,2019_11_JAX_IND
CLE,2019-11-14,8,Thu,10,11,,PIT,W 21-7,8,121,6,41,14,162,2019,2019_11_CLE_PIT
TEN,2019-11-10,8,Sun,10,10,,KAN,W 35-32,8,64,9,80,17,144,2019,2019_10_TEN_KAN
DET,2019-11-10,8,Sun,9,10,@,CHI,L 13-20,8,76,7,57,15,133,2019,2019_10_DET_CHI
LAC,2019-11-07,8,Thu,10,10,@,OAK,L 24-26,8,70,12,97,20,167,2019,2019_10_LAC_OAK
NYG,2019-11-04,8,Mon,9,9,,DAL,L 18-37,8,71,10,104,18,175,2019,2019_09_NYG_DAL
PHI,2019-11-03,8,Sun,9,9,,CHI,W 22-14,8,75,9,70,17,145,2019,2019_09_PHI_CHI
GNB,2019-11-03,8,Sun,9,9,@,LAC,L 11-26,8,45,5,45,13,90,2019,2019_09_GNB_LAC
SFO,2019-10-31,8,Thu,8,9,@,ARI,W 28-25,8,75,9,65,17,140,2019,2019_09_SFO_ARI
LAC,2019-10-27,8,Sun,8,8,@,CHI,W 17-16,8,53,5,42,13,95,2019,2019_08_LAC_CHI
BUF,2019-10-27,8,Sun,7,8,,PHI,L 13-31,8,57,4,44,12,101,2019,2019_08_BUF_PHI
NYJ,2019-10-21,8,Mon,6,7,,NWE,L 0-33,8,60,7,92,15,152,2019,2019_07_NYJ_NWE
DET,2019-10-20,8,Sun,6,7,,MIN,L 30-42,8,67,6,60,14,127,2019,2019_07_DET_MIN
BAL,2019-10-20,8,Sun,7,7,@,SEA,W 30-16,8,75,2,18,10,93,2019,2019_07_BAL_SEA
OAK,2019-10-20,8,Sun,6,7,@,GNB,L 24-42,8,97,3,20,11,117,2019,2019_07_OAK_GNB
DET,2019-10-14,8,Mon,5,6,@,GNB,L 22-23,8,50,6,48,14,98,2019,2019_06_DET_GNB
ARI,2019-10-13,8,Sun,6,6,,ATL,W 34-33,8,57,8,72,16,129,2019,2019_06_ARI_ATL
ATL,2019-10-13,8,Sun,6,6,@,ARI,L 33-34,8,72,8,57,16,129,2019,2019_06_ATL_ARI
NYJ,2019-10-13,8,Sun,5,6,,DAL,W 24-22,8,105,9,68,17,173,2019,2019_06_NYJ_DAL
DEN,2019-10-13,8,Sun,6,6,,TEN,W 16-0,8,51,6,40,14,91,2019,2019_06_DEN_TEN
LAC,2019-10-13,8,Sun,6,6,,PIT,L 17-24,8,74,6,45,14,119,2019,2019_06_LAC_PIT
LAR,2019-10-13,8,Sun,6,6,,SFO,L 7-20,8,59,4,30,12,89,2019,2019_06_LAR_SFO
CAR,2019-10-06,8,Sun,5,5,,JAX,W 34-27,8,70,9,84,17,154,2019,2019_05_CAR_JAX
TEN,2019-10-06,8,Sun,5,5,,BUF,L 7-14,8,60,11,78,19,138,2019,2019_05_TEN_BUF
CIN,2019-09-30,8,Mon,4,4,@,PIT,L 3-27,8,60,4,37,12,97,2019,2019_04_CIN_PIT
DET,2019-09-29,8,Sun,4,4,,KAN,L 30-34,8,48,7,51,15,99,2019,2019_04_DET_KAN
BUF,2019-09-29,8,Sun,4,4,,NWE,L 10-16,8,76,8,58,16,134,2019,2019_04_BUF_NWE
NWE,2019-09-29,8,Sun,4,4,@,BUF,W 16-10,8,58,8,76,16,134,2019,2019_04_NWE_BUF
CIN,2019-09-22,8,Sun,3,3,@,BUF,L 17-21,8,54,7,55,15,109,2019,2019_03_CIN_BUF
DAL,2019-09-22,8,Sun,3,3,,MIA,W 31-6,8,100,5,35,13,135,2019,2019_03_DAL_MIA
NWE,2019-09-22,8,Sun,3,3,,NYJ,W 30-14,8,70,5,67,13,137,2019,2019_03_NWE_NYJ
CLE,2019-09-22,8,Sun,3,3,,LAR,L 13-20,8,60,7,49,15,109,2019,2019_03_CLE_LAR
LAR,2019-09-15,8,Sun,2,2,,NOR,W 27-9,8,65,11,87,19,152,2019,2019_02_LAR_NOR
IND,2019-09-15,8,Sun,2,2,@,TEN,W 19-17,8,65,5,75,13,140,2019,2019_02_IND_TEN
ARI,2019-09-15,8,Sun,2,2,@,BAL,L 17-23,8,70,10,62,18,132,2019,2019_02_ARI_BAL
DET,2019-09-15,8,Sun,2,2,,LAC,W 13-10,8,71,9,70,17,141,2019,2019_02_DET_LAC
DAL,2019-09-15,8,Sun,2,2,@,WAS,W 31-21,8,67,6,44,14,111,2019,2019_02_DAL_WAS
MIN,2019-09-15,8,Sun,2,2,@,GNB,L 16-21,8,100,6,35,14,135,2019,2019_02_MIN_GNB
HOU,2019-09-09,8,Mon,1,1,@,NOR,L 28-30,8,69,7,48,15,117,2019,2019_01_HOU_NOR
TAM,2019-09-08,8,Sun,1,1,,SFO,L 17-31,8,87,11,87,19,174,2019,2019_01_TAM_SFO
NYJ,2019-09-08,8,Sun,1,1,,BUF,L 16-17,8,67,7,55,15,122,2019,2019_01_NYJ_BUF
SEA,2019-09-08,8,Sun,1,1,,CIN,W 21-20,8,55,7,57,15,112,2019,2019_01_SEA_CIN
NYG,2019-09-08,8,Sun,1,1,@,DAL,L 17-35,8,70,6,47,14,117,2019,2019_01_NYG_DAL
JAX,2018-12-30,8,Sun,16,17,@,HOU,L 3-20,8,68,2,15,10,83,2018,2018_17_JAX_HOU
KAN,2018-12-23,8,Sun,15,16,@,SEA,L 31-38,8,76,3,20,11,96,2018,2018_16_KAN_SEA
WAS,2018-12-22,8,Sat,15,16,@,TEN,L 16-25,8,49,2,10,10,59,2018,2018_16_WAS_TEN
LAC,2018-12-22,8,Sat,15,16,,BAL,L 10-22,8,69,4,40,12,109,2018,2018_16_LAC_BAL
ARI,2018-12-16,8,Sun,14,15,@,ATL,L 14-40,8,75,6,50,14,125,2018,2018_15_ARI_ATL
OAK,2018-12-16,8,Sun,14,15,@,CIN,L 16-30,8,90,9,85,17,175,2018,2018_15_OAK_CIN
MIA,2018-12-16,8,Sun,14,15,@,MIN,L 17-41,8,49,6,45,14,94,2018,2018_15_MIA_MIN
SFO,2018-12-16,8,Sun,14,15,,SEA,W 26-23 (OT),8,66,14,148,22,214,2018,2018_15_SFO_SEA
BAL,2018-12-16,8,Sun,14,15,,TAM,W 20-12,8,70,6,58,14,128,2018,2018_15_BAL_TAM
JAX,2018-12-16,8,Sun,14,15,,WAS,L 13-16,8,55,6,48,14,103,2018,2018_15_JAX_WAS
DEN,2018-12-15,8,Sat,14,15,,CLE,L 16-17,8,51,6,75,14,126,2018,2018_15_DEN_CLE
ARI,2018-12-09,8,Sun,13,14,,DET,L 3-17,8,83,7,68,15,151,2018,2018_14_ARI_DET
CHI,2018-12-02,8,Sun,12,13,@,NYG,L 27-30 (OT),8,58,12,107,20,165,2018,2018_13_CHI_NYG
ATL,2018-12-02,8,Sun,12,13,,BAL,L 16-26,8,82,9,88,17,170,2018,2018_13_ATL_BAL
JAX,2018-12-02,8,Sun,12,13,,IND,W 6-0,8,74,6,65,14,139,2018,2018_13_JAX_IND
TEN,2018-12-02,8,Sun,12,13,,NYJ,W 26-22,8,75,11,96,19,171,2018,2018_13_TEN_NYJ
MIA,2018-12-02,8,Sun,12,13,,BUF,W 21-17,8,89,13,120,21,209,2018,2018_13_MIA_BUF
DET,2018-12-02,8,Sun,12,13,,LAR,L 16-30,8,54,7,105,15,159,2018,2018_13_DET_LAR
OAK,2018-12-02,8,Sun,12,13,,KAN,L 33-40,8,74,11,94,19,168,2018,2018_13_OAK_KAN
DAL,2018-11-29,8,Thu,12,13,,NOR,W 13-10,8,80,5,48,13,128,2018,2018_13_DAL_NOR
SFO,2018-11-25,8,Sun,11,12,@,TAM,L 9-27,8,68,9,70,17,138,2018,2018_12_SFO_TAM
NYJ,2018-11-25,8,Sun,11,12,,NWE,L 13-27,8,47,11,105,19,152,2018,2018_12_NYJ_NWE
LAR,2018-11-19,8,Mon,11,11,,KAN,W 54-51,8,60,13,135,21,195,2018,2018_11_LAR_KAN
TEN,2018-11-18,8,Sun,10,11,@,IND,L 10-38,8,112,7,60,15,172,2018,2018_11_TEN_IND
NOR,2018-11-18,8,Sun,10,11,,PHI,W 48-7,8,69,6,49,14,118,2018,2018_11_NOR_PHI
NYG,2018-11-18,8,Sun,10,11,,TAM,W 38-35,8,60,4,40,12,100,2018,2018_11_NYG_TAM
NYG,2018-11-12,8,Mon,9,10,@,SFO,W 27-23,8,78,10,97,18,175,2018,2018_10_NYG_SFO
JAX,2018-11-11,8,Sun,9,10,@,IND,L 26-29,8,61,7,45,15,106,2018,2018_10_JAX_IND
WAS,2018-11-11,8,Sun,9,10,@,TAM,W 16-3,8,52,5,50,13,102,2018,2018_10_WAS_TAM
KAN,2018-11-11,8,Sun,10,10,,ARI,W 26-14,8,63,3,30,11,93,2018,2018_10_KAN_ARI
PIT,2018-11-04,8,Sun,8,9,@,BAL,W 23-16,8,103,5,25,13,128,2018,2018_09_PIT_BAL
DET,2018-11-04,8,Sun,8,9,@,MIN,L 9-24,8,66,3,15,11,81,2018,2018_09_DET_MIN
TAM,2018-11-04,8,Sun,8,9,@,CAR,L 28-42,8,49,9,84,17,133,2018,2018_09_TAM_CAR
DEN,2018-11-04,8,Sun,9,9,,HOU,L 17-19,8,50,7,60,15,110,2018,2018_09_DEN_HOU
WAS,2018-10-28,8,Sun,7,8,@,NYG,W 20-13,8,90,11,102,19,192,2018,2018_08_WAS_NYG
NYJ,2018-10-28,8,Sun,8,8,@,CHI,L 10-24,8,45,2,25,10,70,2018,2018_08_NYJ_CHI
PIT,2018-10-28,8,Sun,7,8,,CLE,W 33-18,8,60,7,52,15,112,2018,2018_08_PIT_CLE
HOU,2018-10-25,8,Thu,8,8,,MIA,W 42-23,8,57,5,63,13,120,2018,2018_08_HOU_MIA
DAL,2018-10-21,8,Sun,7,7,@,WAS,L 17-20,8,65,5,35,13,100,2018,2018_07_DAL_WAS
NYJ,2018-10-21,8,Sun,7,7,,MIN,L 17-37,8,71,6,55,14,126,2018,2018_07_NYJ_MIN
KAN,2018-10-21,8,Sun,7,7,,CIN,W 45-10,8,49,8,58,16,107,2018,2018_07_KAN_CIN
TAM,2018-10-21,8,Sun,6,7,,CLE,W 26-23 (OT),8,65,14,114,22,179,2018,2018_07_TAM_CLE
CIN,2018-10-21,8,Sun,7,7,@,KAN,L 10-45,8,58,8,49,16,107,2018,2018_07_CIN_KAN
CAR,2018-10-14,8,Sun,5,6,@,WAS,L 17-23,8,55,5,43,13,98,2018,2018_06_CAR_WAS
SEA,2018-10-14,8,Sun,6,6,@,OAK,W 27-3,8,64,5,38,13,102,2018,2018_06_SEA_OAK
IND,2018-10-14,8,Sun,6,6,@,NYJ,L 34-42,8,66,7,49,15,115,2018,2018_06_IND_NYJ
PHI,2018-10-07,8,Sun,5,5,,MIN,L 21-23,8,52,4,23,12,75,2018,2018_05_PHI_MIN
DET,2018-10-07,8,Sun,5,5,,GNB,W 31-23,8,71,12,112,20,183,2018,2018_05_DET_GNB
NYG,2018-10-07,8,Sun,5,5,@,CAR,L 31-33,8,62,4,22,12,84,2018,2018_05_NYG_CAR
CLE,2018-09-30,8,Sun,4,4,@,OAK,L 42-45 (OT),8,55,6,65,14,120,2018,2018_04_CLE_OAK
SEA,2018-09-30,8,Sun,4,4,@,ARI,W 20-17,8,57,5,38,13,95,2018,2018_04_SEA_ARI
PHI,2018-09-30,8,Sun,4,4,@,TEN,L 23-26 (OT),8,77,4,30,12,107,2018,2018_04_PHI_TEN
DET,2018-09-30,8,Sun,4,4,@,DAL,L 24-26,8,58,2,20,10,78,2018,2018_04_DET_DAL
OAK,2018-09-23,8,Sun,3,3,@,MIA,L 20-28,8,38,9,74,17,112,2018,2018_03_OAK_MIA
JAX,2018-09-23,8,Sun,3,3,,TEN,L 6-9,8,75,4,30,12,105,2018,2018_03_JAX_TEN
MIN,2018-09-16,8,Sun,2,2,@,GNB,T 29-29 (OT),8,70,7,54,15,124,2018,2018_02_MIN_GNB
TEN,2018-09-16,8,Sun,2,2,,HOU,W 20-17,8,70,11,88,19,158,2018,2018_02_TEN_HOU
LAR,2018-09-10,8,Mon,1,1,@,OAK,W 33-13,8,70,11,155,19,225,2018,2018_01_LAR_OAK
CIN,2018-09-09,8,Sun,1,1,@,IND,W 34-23,8,94,7,91,15,185,2018,2018_01_CIN_IND
NOR,2018-09-09,8,Sun,1,1,,TAM,L 40-48,8,77,7,70,15,147,2018,2018_01_NOR_TAM
GNB,2018-09-09,8,Sun,1,1,,CHI,W 24-23,8,72,5,35,13,107,2018,2018_01_GNB_CHI
GNB,2017-12-31,8,Sun,16,17,@,DET,L 11-35,8,68,5,62,13,130,2017,2017_17_GNB_DET
SEA,2017-12-31,8,Sun,16,17,,ARI,L 24-26,8,100,4,25,12,125,2017,2017_17_SEA_ARI
PHI,2017-12-25,8,Mon,15,16,,OAK,W 19-10,8,60,7,50,15,110,2017,2017_16_PHI_OAK
SFO,2017-12-24,8,Sun,15,16,,JAX,W 44-33,8,68,12,99,20,167,2017,2017_16_SFO_JAX
LAC,2017-12-24,8,Sun,15,16,@,NYJ,W 14-7,8,80,5,34,13,114,2017,2017_16_LAC_NYJ
CLE,2017-12-24,8,Sun,15,16,@,CHI,L 3-20,8,60,4,25,12,85,2017,2017_16_CLE_CHI
NYJ,2017-12-17,8,Sun,14,15,@,NOR,L 19-31,8,50,8,92,16,142,2017,2017_15_NYJ_NOR
JAX,2017-12-17,8,Sun,14,15,,HOU,W 45-7,8,54,14,127,22,181,2017,2017_15_JAX_HOU
ARI,2017-12-17,8,Sun,14,15,@,WAS,L 15-20,8,71,7,82,15,153,2017,2017_15_ARI_WAS
NOR,2017-12-17,8,Sun,14,15,,NYJ,W 31-19,8,92,8,50,16,142,2017,2017_15_NOR_NYJ
DET,2017-12-16,8,Sat,14,15,,CHI,W 20-10,8,58,13,97,21,155,2017,2017_15_DET_CHI
MIA,2017-12-11,8,Mon,13,14,,NWE,W 27-20,8,102,9,78,17,180,2017,2017_14_MIA_NWE
DAL,2017-12-10,8,Sun,13,14,@,NYG,W 30-10,8,51,7,69,15,120,2017,2017_14_DAL_NYG
DET,2017-12-10,8,Sun,13,14,@,TAM,W 24-21,8,105,7,65,15,170,2017,2017_14_DET_TAM
HOU,2017-12-10,8,Sun,13,14,,SFO,L 16-26,8,81,11,87,19,168,2017,2017_14_HOU_SFO
KAN,2017-12-03,8,Sun,12,13,@,NYJ,L 31-38,8,30,5,40,13,70,2017,2017_13_KAN_NYJ
TAM,2017-12-03,8,Sun,12,13,@,GNB,L 20-26 (OT),8,74,7,47,15,121,2017,2017_13_TAM_GNB
SFO,2017-12-03,8,Sun,12,13,@,CHI,W 15-14,8,53,4,29,12,82,2017,2017_13_SFO_CHI
WAS,2017-11-23,8,Thu,11,12,,NYG,W 20-10,8,55,6,79,14,134,2017,2017_12_WAS_NYG
DET,2017-11-23,8,Thu,11,12,,MIN,L 23-30,8,54,9,74,17,128,2017,2017_12_DET_MIN
OAK,2017-11-19,8,Sun,10,11,,NWE,L 8-33,8,66,2,10,10,76,2017,2017_11_OAK_NWE
LAR,2017-11-19,8,Sun,10,11,@,MIN,L 7-24,8,60,7,65,15,125,2017,2017_11_LAR_MIN
HOU,2017-11-12,8,Sun,9,10,@,LAR,L 7-33,8,60,10,86,18,146,2017,2017_10_HOU_LAR
BUF,2017-11-12,8,Sun,9,10,,NOR,L 10-47,8,56,4,41,12,97,2017,2017_10_BUF_NOR
NYJ,2017-11-12,8,Sun,10,10,@,TAM,L 10-15,8,77,6,50,14,127,2017,2017_10_NYJ_TAM
CHI,2017-11-12,8,Sun,9,10,,GNB,L 16-23,8,78,5,35,13,113,2017,2017_10_CHI_GNB
ATL,2017-11-05,8,Sun,8,9,@,CAR,L 17-20,8,70,5,29,13,99,2017,2017_09_ATL_CAR
CIN,2017-11-05,8,Sun,8,9,@,JAX,L 7-23,8,77,5,50,13,127,2017,2017_09_CIN_JAX
KAN,2017-11-05,8,Sun,9,9,@,DAL,L 17-28,8,52,5,65,13,117,2017,2017_09_KAN_DAL
SFO,2017-11-05,8,Sun,9,9,,ARI,L 10-20,8,53,2,25,10,78,2017,2017_09_SFO_ARI
HOU,2017-10-29,8,Sun,7,8,@,SEA,L 38-41,8,93,10,120,18,213,2017,2017_08_HOU_SEA
DAL,2017-10-29,8,Sun,7,8,@,WAS,W 33-19,8,89,5,32,13,121,2017,2017_08_DAL_WAS
GNB,2017-10-22,8,Sun,7,7,,NOR,L 17-26,8,54,7,80,15,134,2017,2017_07_GNB_NOR
NWE,2017-10-22,8,Sun,7,7,,ATL,W 23-7,8,65,6,40,14,105,2017,2017_07_NWE_ATL
KAN,2017-10-19,8,Thu,7,7,@,OAK,L 30-31,8,108,10,97,18,205,2017,2017_07_KAN_OAK
GNB,2017-10-15,8,Sun,6,6,@,MIN,L 10-23,8,92,7,65,15,157,2017,2017_06_GNB_MIN
BAL,2017-10-15,8,Sun,6,6,,CHI,L 24-27 (OT),8,69,5,44,13,113,2017,2017_06_BAL_CHI
CHI,2017-10-09,8,Mon,5,5,,MIN,L 17-20,8,55,9,69,17,124,2017,2017_05_CHI_MIN
CIN,2017-10-01,8,Sun,4,4,@,CLE,W 31-7,8,66,4,28,12,94,2017,2017_04_CIN_CLE
PIT,2017-10-01,8,Sun,4,4,@,BAL,W 26-9,8,60,6,55,14,115,2017,2017_04_PIT_BAL
NOR,2017-10-01,8,Sun,4,4,@,MIA,W 20-0,8,71,11,90,19,161,2017,2017_04_NOR_MIA
CHI,2017-09-28,8,Thu,4,4,@,GNB,L 14-35,8,62,7,55,15,117,2017,2017_04_CHI_GNB
LAC,2017-09-24,8,Sun,3,3,,KAN,L 10-24,8,61,13,122,21,183,2017,2017_03_LAC_KAN
ATL,2017-09-24,8,Sun,3,3,@,DET,W 30-26,8,68,9,98,17,166,2017,2017_03_ATL_DET
MIA,2017-09-24,8,Sun,2,3,@,NYJ,L 6-20,8,51,10,94,18,145,2017,2017_03_MIA_NYJ
BUF,2017-09-24,8,Sun,3,3,,DEN,W 26-16,8,69,10,79,18,148,2017,2017_03_BUF_DEN
DEN,2017-09-17,8,Sun,2,2,,DAL,W 42-17,8,61,8,69,16,130,2017,2017_02_DEN_DAL
CHI,2017-09-17,8,Sun,2,2,@,TAM,L 7-29,8,59,4,34,12,93,2017,2017_02_CHI_TAM
DAL,2017-09-17,8,Sun,2,2,@,DEN,L 17-42,8,69,8,61,16,130,2017,2017_02_DAL_DEN
IND,2017-09-17,8,Sun,2,2,,ARI,L 13-16 (OT),8,70,6,41,14,111,2017,2017_02_IND_ARI
GNB,2017-09-10,8,Sun,1,1,,SEA,W 17-9,8,70,8,50,16,120,2017,2017_01_GNB_SEA
PHI,2017-09-10,8,Sun,1,1,@,WAS,W 30-17,8,76,2,15,10,91,2017,2017_01_PHI_WAS
SEA,2017-09-10,8,Sun,1,1,@,GNB,L 9-17,8,50,8,70,16,120,2017,2017_01_SEA_GNB
ATL,2017-09-10,8,Sun,1,1,@,CHI,W 23-17,8,73,4,40,12,113,2017,2017_01_ATL_CHI
ARI,2023-01-08,7,Sun,17,18,@,SFO,L 13-38,7,50,2,10,9,60,2022,2022_18_ARI_SFO
HOU,2023-01-08,7,Sun,17,18,@,IND,W 32-31,7,41,2,10,9,51,2022,2022_18_HOU_IND
HOU,2023-01-01,7,Sun,16,17,,JAX,L 3-31,7,45,2,30,9,75,2022,2022_17_HOU_JAX
IND,2023-01-01,7,Sun,16,17,@,NYG,L 10-38,7,60,3,20,10,80,2022,2022_17_IND_NYG
NYG,2022-12-24,7,Sat,15,16,@,MIN,L 24-27,7,63,2,14,9,77,2022,2022_16_NYG_MIN
ARI,2022-12-18,7,Sun,14,15,@,DEN,L 15-24,7,46,4,31,11,77,2022,2022_15_ARI_DEN
TAM,2022-12-18,7,Sun,14,15,,CIN,L 23-34,7,58,4,27,11,85,2022,2022_15_TAM_CIN
PIT,2022-12-18,7,Sun,14,15,@,CAR,W 24-16,7,81,5,40,12,121,2022,2022_15_PIT_CAR
BUF,2022-12-17,7,Sat,14,15,,MIA,W 32-29,7,51,8,51,15,102,2022,2022_15_BUF_MIA
SFO,2022-12-15,7,Thu,14,15,@,SEA,W 21-13,7,60,8,79,15,139,2022,2022_15_SFO_SEA
NYJ,2022-12-11,7,Sun,13,14,@,BUF,L 12-20,7,61,5,35,12,96,2022,2022_14_NYJ_BUF
DET,2022-12-11,7,Sun,13,14,,MIN,W 34-23,7,51,3,25,10,76,2022,2022_14_DET_MIN
LVR,2022-12-08,7,Thu,13,14,@,LAR,L 16-17,7,94,7,60,14,154,2022,2022_14_LVR_LAR
LAR,2022-12-08,7,Thu,13,14,,LVR,W 17-16,7,60,7,94,14,154,2022,2022_14_LAR_LVR
PIT,2022-12-04,7,Sun,12,13,@,ATL,W 19-16,7,30,6,48,13,78,2022,2022_13_PIT_ATL
WAS,2022-12-04,7,Sun,13,13,@,NYG,T 20-20 (OT),7,55,4,34,11,89,2022,2022_13_WAS_NYG
TEN,2022-12-04,7,Sun,12,13,@,PHI,L 10-35,7,82,12,80,19,162,2022,2022_13_TEN_PHI
SFO,2022-11-27,7,Sun,11,12,,NOR,W 13-0,7,64,6,46,13,110,2022,2022_12_SFO_NOR
LVR,2022-11-27,7,Sun,11,12,@,SEA,W 40-34 (OT),7,50,2,10,9,60,2022,2022_12_LVR_SEA
NYG,2022-11-24,7,Thu,11,12,@,DAL,L 20-28,7,66,13,86,20,152,2022,2022_12_NYG_DAL
CHI,2022-11-20,7,Sun,11,11,@,ATL,L 24-27,7,56,2,13,9,69,2022,2022_11_CHI_ATL
MIN,2022-11-20,7,Sun,10,11,,DAL,L 3-40,7,59,6,39,13,98,2022,2022_11_MIN_DAL
PHI,2022-11-20,7,Sun,10,11,@,IND,W 17-16,7,55,8,90,15,145,2022,2022_11_PHI_IND
PHI,2022-11-14,7,Mon,9,10,,WAS,L 21-32,7,75,5,58,12,133,2022,2022_10_PHI_WAS
MIN,2022-11-13,7,Sun,9,10,@,BUF,W 33-30 (OT),7,64,7,64,14,128,2022,2022_10_MIN_BUF
HOU,2022-11-13,7,Sun,9,10,@,NYG,L 16-24,7,40,5,24,12,64,2022,2022_10_HOU_NYG
BUF,2022-11-13,7,Sun,9,10,,MIN,L 30-33 (OT),7,64,7,64,14,128,2022,2022_10_BUF_MIN
DET,2022-11-06,7,Sun,8,9,,GNB,W 15-9,7,62,8,81,15,143,2022,2022_09_DET_GNB
CAR,2022-11-06,7,Sun,9,9,@,CIN,L 21-42,7,50,5,35,12,85,2022,2022_09_CAR_CIN
TAM,2022-11-06,7,Sun,9,9,,LAR,W 16-13,7,55,4,53,11,108,2022,2022_09_TAM_LAR
ATL,2022-10-30,7,Sun,8,8,,CAR,W 37-34 (OT),7,64,9,74,16,138,2022,2022_08_ATL_CAR
MIA,2022-10-30,7,Sun,8,8,@,DET,W 31-27,7,55,6,30,13,85,2022,2022_08_MIA_DET
BAL,2022-10-27,7,Thu,8,8,@,TAM,W 27-22,7,101,4,35,11,136,2022,2022_08_BAL_TAM
WAS,2022-10-23,7,Sun,7,7,,GNB,W 23-21,7,54,9,69,16,123,2022,2022_07_WAS_GNB
LAC,2022-10-23,7,Sun,7,7,,SEA,L 23-37,7,70,7,68,14,138,2022,2022_07_LAC_SEA
DAL,2022-10-23,7,Sun,7,7,,DET,W 24-6,7,55,8,59,15,114,2022,2022_07_DAL_DET
SEA,2022-10-23,7,Sun,7,7,@,LAC,W 37-23,7,68,7,70,14,138,2022,2022_07_SEA_LAC
PIT,2022-10-16,7,Sun,6,6,,TAM,W 20-18,7,45,6,42,13,87,2022,2022_06_PIT_TAM
NYJ,2022-10-16,7,Sun,6,6,@,GNB,W 27-10,7,79,7,42,14,121,2022,2022_06_NYJ_GNB
CLE,2022-10-16,7,Sun,6,6,,NWE,L 15-38,7,63,12,92,19,155,2022,2022_06_CLE_NWE
LAR,2022-10-16,7,Sun,6,6,,CAR,W 24-10,7,49,3,30,10,79,2022,2022_06_LAR_CAR
IND,2022-10-16,7,Sun,6,6,,JAX,W 34-27,7,52,4,44,11,96,2022,2022_06_IND_JAX
BUF,2022-10-16,7,Sun,6,6,@,KAN,W 24-20,7,35,5,58,12,93,2022,2022_06_BUF_KAN
GNB,2022-10-16,7,Sun,6,6,,NYJ,L 10-27,7,42,7,79,14,121,2022,2022_06_GNB_NYJ
WAS,2022-10-13,7,Thu,6,6,@,CHI,W 12-7,7,36,4,42,11,78,2022,2022_06_WAS_CHI
MIN,2022-10-09,7,Sun,5,5,,CHI,W 29-22,7,70,6,40,13,110,2022,2022_05_MIN_CHI
DET,2022-10-09,7,Sun,5,5,@,NWE,L 0-29,7,82,6,46,13,128,2022,2022_05_DET_NWE
GNB,2022-10-09,7,Sun,5,5,,NYG,L 22-27,7,37,6,63,13,100,2022,2022_05_GNB_NYG
DEN,2022-10-06,7,Thu,5,5,,IND,L 9-12 (OT),7,49,8,64,15,113,2022,2022_05_DEN_IND
NWE,2022-10-02,7,Sun,4,4,@,GNB,L 24-27 (OT),7,75,4,40,11,115,2022,2022_04_NWE_GNB
NYG,2022-10-02,7,Sun,4,4,,CHI,W 20-12,7,55,5,65,12,120,2022,2022_04_NYG_CHI
IND,2022-10-02,7,Sun,4,4,,TEN,L 17-24,7,50,6,40,13,90,2022,2022_04_IND_TEN
NYJ,2022-10-02,7,Sun,4,4,@,PIT,W 24-20,7,64,8,55,15,119,2022,2022_04_NYJ_PIT
ARI,2022-10-02,7,Sun,4,4,@,CAR,W 26-16,7,61,6,76,13,137,2022,2022_04_ARI_CAR
CLE,2022-10-02,7,Sun,4,4,@,ATL,L 20-23,7,51,1,15,8,66,2022,2022_04_CLE_ATL
DEN,2022-10-02,7,Sun,4,4,@,LVR,L 23-32,7,50,4,25,11,75,2022,2022_04_DEN_LVR
SFO,2022-09-25,7,Sun,3,3,@,DEN,L 10-11,7,40,5,30,12,70,2022,2022_03_SFO_DEN
BUF,2022-09-25,7,Sun,3,3,@,MIA,L 19-21,7,52,4,20,11,72,2022,2022_03_BUF_MIA
NOR,2022-09-25,7,Sun,3,3,@,CAR,L 14-22,7,58,4,40,11,98,2022,2022_03_NOR_CAR
LAC,2022-09-25,7,Sun,3,3,,JAX,L 10-38,7,54,2,10,9,64,2022,2022_03_LAC_JAX
DET,2022-09-25,7,Sun,3,3,@,MIN,L 24-28,7,59,3,15,10,74,2022,2022_03_DET_MIN
TEN,2022-09-25,7,Sun,3,3,,LVR,W 24-22,7,85,6,44,13,129,2022,2022_03_TEN_LVR
CHI,2022-09-18,7,Sun,2,2,@,GNB,L 10-27,7,50,3,25,10,75,2022,2022_02_CHI_GNB
NWE,2022-09-18,7,Sun,2,2,@,PIT,W 17-14,7,55,3,20,10,75,2022,2022_02_NWE_PIT
CIN,2022-09-18,7,Sun,2,2,@,DAL,L 17-20,7,35,5,45,12,80,2022,2022_02_CIN_DAL
IND,2022-09-11,7,Sun,1,1,@,HOU,T 20-20 (OT),7,89,6,40,13,129,2022,2022_01_IND_HOU
TEN,2022-09-11,7,Sun,1,1,,NYG,L 20-21,7,50,8,45,15,95,2022,2022_01_TEN_NYG
DET,2022-09-11,7,Sun,1,1,,PHI,L 35-38,7,65,10,61,17,126,2022,2022_01_DET_PHI
BUF,2022-01-02,7,Sun,16,17,,ATL,W 29-15,7,47,4,27,11,74,2021,2021_17_BUF_ATL
SFO,2022-01-02,7,Sun,16,17,,HOU,W 23-7,7,111,5,67,12,178,2021,2021_17_SFO_HOU
ARI,2022-01-02,7,Sun,16,17,@,DAL,W 25-22,7,45,10,88,17,133,2021,2021_17_ARI_DAL
MIA,2021-12-27,7,Mon,15,16,@,NOR,W 20-3,7,65,7,62,14,127,2021,2021_16_MIA_NOR
NOR,2021-12-27,7,Mon,15,16,,MIA,L 3-20,7,62,7,65,14,127,2021,2021_16_NOR_MIA
SEA,2021-12-26,7,Sun,15,16,,CHI,L 24-25,7,88,8,73,15,161,2021,2021_16_SEA_CHI
NYJ,2021-12-26,7,Sun,15,16,,JAX,W 26-21,7,81,2,10,9,91,2021,2021_16_NYJ_JAX
LVR,2021-12-20,7,Mon,14,15,@,CLE,W 16-14,7,64,3,61,10,125,2021,2021_15_LVR_CLE
MIN,2021-12-20,7,Mon,14,15,@,CHI,W 17-9,7,54,9,91,16,145,2021,2021_15_MIN_CHI
ARI,2021-12-19,7,Sun,14,15,@,DET,L 12-30,7,83,6,49,13,132,2021,2021_15_ARI_DET
TEN,2021-12-19,7,Sun,14,15,@,PIT,L 13-19,7,68,5,30,12,98,2021,2021_15_TEN_PIT
ARI,2021-12-13,7,Mon,13,14,,LAR,L 23-30,7,54,5,40,12,94,2021,2021_14_ARI_LAR
DAL,2021-12-12,7,Sun,13,14,@,WAS,W 27-20,7,60,7,65,14,125,2021,2021_14_DAL_WAS
BUF,2021-12-12,7,Sun,13,14,@,TAM,L 27-33 (OT),7,65,4,24,11,89,2021,2021_14_BUF_TAM
CHI,2021-12-12,7,Sun,13,14,@,GNB,L 30-45,7,41,3,30,10,71,2021,2021_14_CHI_GNB
WAS,2021-12-12,7,Sun,13,14,,DAL,L 20-27,7,65,7,60,14,125,2021,2021_14_WAS_DAL
LAR,2021-12-05,7,Sun,12,13,,JAX,W 37-7,7,47,3,39,10,86,2021,2021_13_LAR_JAX
MIN,2021-12-05,7,Sun,12,13,@,DET,L 27-29,7,66,3,11,10,77,2021,2021_13_MIN_DET
CIN,2021-12-05,7,Sun,12,13,,LAC,L 22-41,7,63,7,51,14,114,2021,2021_13_CIN_LAC
KAN,2021-12-05,7,Sun,12,13,,DEN,W 22-9,7,60,5,37,12,97,2021,2021_13_KAN_DEN
LAC,2021-12-05,7,Sun,12,13,@,CIN,W 41-22,7,51,7,63,14,114,2021,2021_13_LAC_CIN
NOR,2021-12-02,7,Thu,12,13,,DAL,L 17-27,7,59,5,35,12,94,2021,2021_13_NOR_DAL
CAR,2021-11-28,7,Sun,12,12,@,MIA,L 10-33,7,61,5,35,12,96,2021,2021_12_CAR_MIA
CAR,2021-11-21,7,Sun,11,11,,WAS,L 21-27,7,65,8,69,15,134,2021,2021_11_CAR_WAS
BUF,2021-11-21,7,Sun,10,11,,IND,L 15-41,7,56,3,30,10,86,2021,2021_11_BUF_IND
NYJ,2021-11-21,7,Sun,10,11,,MIA,L 17-24,7,48,8,62,15,110,2021,2021_11_NYJ_MIA
HOU,2021-11-21,7,Sun,10,11,@,TEN,W 22-13,7,50,5,52,12,102,2021,2021_11_HOU_TEN
LVR,2021-11-21,7,Sun,10,11,,CIN,L 13-32,7,77,1,5,8,82,2021,2021_11_LVR_CIN
DET,2021-11-21,7,Sun,10,11,@,CLE,L 10-13,7,67,10,82,17,149,2021,2021_11_DET_CLE
BUF,2021-11-14,7,Sun,9,10,@,NYJ,W 45-17,7,50,9,69,16,119,2021,2021_10_BUF_NYJ
PHI,2021-11-14,7,Sun,10,10,@,DEN,W 30-13,7,89,4,29,11,118,2021,2021_10_PHI_DEN
PIT,2021-11-14,7,Sun,9,10,,DET,T 16-16 (OT),7,59,8,84,15,143,2021,2021_10_PIT_DET
IND,2021-11-14,7,Sun,10,10,,JAX,W 23-17,7,47,8,79,15,126,2021,2021_10_IND_JAX
LAC,2021-11-14,7,Sun,9,10,,MIN,L 20-27,7,52,10,118,17,170,2021,2021_10_LAC_MIN
NYJ,2021-11-04,7,Thu,8,9,@,IND,L 30-45,7,43,2,22,9,65,2021,2021_09_NYJ_IND
SFO,2021-10-31,7,Sun,7,8,@,CHI,W 33-22,7,55,4,30,11,85,2021,2021_08_SFO_CHI
MIN,2021-10-31,7,Sun,7,8,,DAL,L 16-20,7,57,11,96,18,153,2021,2021_08_MIN_DAL
GNB,2021-10-28,7,Thu,8,8,@,ARI,W 24-21,7,60,7,59,14,119,2021,2021_08_GNB_ARI
ARI,2021-10-28,7,Thu,8,8,,GNB,L 21-24,7,59,7,60,14,119,2021,2021_08_ARI_GNB
NOR,2021-10-25,7,Mon,6,7,@,SEA,W 13-10,7,90,6,53,13,143,2021,2021_07_NOR_SEA
LVR,2021-10-24,7,Sun,7,7,,PHI,W 33-22,7,65,4,37,11,102,2021,2021_07_LVR_PHI
SFO,2021-10-24,7,Sun,6,7,,IND,L 18-30,7,122,6,45,13,167,2021,2021_07_SFO_IND
ARI,2021-10-24,7,Sun,7,7,,HOU,W 31-5,7,54,8,80,15,134,2021,2021_07_ARI_HOU
CAR,2021-10-24,7,Sun,7,7,@,NYG,L 3-25,7,37,8,60,15,97,2021,2021_07_CAR_NYG
TEN,2021-10-18,7,Mon,6,6,,BUF,W 34-31,7,91,8,60,15,151,2021,2021_06_TEN_BUF
CHI,2021-10-17,7,Sun,6,6,,GNB,L 14-24,7,54,3,51,10,105,2021,2021_06_CHI_GNB
MIA,2021-10-17,7,Sun,6,6,@,JAX,L 20-23,7,55,8,54,15,109,2021,2021_06_MIA_JAX
LAR,2021-10-17,7,Sun,6,6,@,NYG,W 38-11,7,50,5,27,12,77,2021,2021_06_LAR_NYG
TAM,2021-10-14,7,Thu,6,6,@,PHI,W 28-22,7,120,4,41,11,161,2021,2021_06_TAM_PHI
DEN,2021-10-10,7,Sun,5,5,@,PIT,L 19-27,7,67,8,59,15,126,2021,2021_05_DEN_PIT
CLE,2021-10-10,7,Sun,5,5,@,LAC,L 42-47,7,77,6,49,13,126,2021,2021_05_CLE_LAC
NYJ,2021-10-10,7,Sun,5,5,@,ATL,L 20-27,7,58,4,66,11,124,2021,2021_05_NYJ_ATL
KAN,2021-10-10,7,Sun,5,5,,BUF,L 20-38,7,55,10,103,17,158,2021,2021_05_KAN_BUF
SFO,2021-10-10,7,Sun,5,5,@,ARI,L 10-17,7,60,6,62,13,122,2021,2021_05_SFO_ARI
MIN,2021-10-10,7,Sun,5,5,,DET,W 19-17,7,74,3,30,10,104,2021,2021_05_MIN_DET
TEN,2021-10-10,7,Sun,5,5,@,JAX,W 37-19,7,44,4,33,11,77,2021,2021_05_TEN_JAX
LAC,2021-10-04,7,Mon,4,4,,LVR,W 28-14,7,105,7,58,14,163,2021,2021_04_LAC_LVR
LVR,2021-10-04,7,Mon,4,4,@,LAC,L 14-28,7,58,7,105,14,163,2021,2021_04_LVR_LAC
KAN,2021-10-03,7,Sun,4,4,@,PHI,W 42-30,7,46,9,49,16,95,2021,2021_04_KAN_PHI
ARI,2021-10-03,7,Sun,4,4,@,LAR,W 37-20,7,63,5,36,12,99,2021,2021_04_ARI_LAR
ATL,2021-10-03,7,Sun,4,4,,WAS,L 30-34,7,36,6,85,13,121,2021,2021_04_ATL_WAS
DAL,2021-10-03,7,Sun,4,4,,CAR,W 36-28,7,50,6,32,13,82,2021,2021_04_DAL_CAR
MIN,2021-10-03,7,Sun,4,4,,CLE,L 7-14,7,42,7,73,14,115,2021,2021_04_MIN_CLE
CHI,2021-10-03,7,Sun,4,4,,DET,W 24-14,7,61,4,26,11,87,2021,2021_04_CHI_DET
CLE,2021-10-03,7,Sun,4,4,@,MIN,W 14-7,7,73,7,42,14,115,2021,2021_04_CLE_MIN
TAM,2021-10-03,7,Sun,4,4,@,NWE,W 19-17,7,74,8,77,15,151,2021,2021_04_TAM_NWE
CLE,2021-09-26,7,Sun,3,3,,CHI,W 26-6,7,98,5,49,12,147,2021,2021_03_CLE_CHI
ARI,2021-09-26,7,Sun,3,3,@,JAX,W 31-19,7,58,4,40,11,98,2021,2021_03_ARI_JAX
TAM,2021-09-26,7,Sun,3,3,@,LAR,L 24-34,7,41,1,4,8,45,2021,2021_03_TAM_LAR
DET,2021-09-26,7,Sun,3,3,,BAL,L 17-19,7,35,6,69,13,104,2021,2021_03_DET_BAL
GNB,2021-09-26,7,Sun,3,3,@,SFO,W 30-28,7,87,4,86,11,173,2021,2021_03_GNB_SFO
HOU,2021-09-23,7,Thu,3,3,,CAR,L 9-24,7,51,8,64,15,115,2021,2021_03_HOU_CAR
JAX,2021-09-19,7,Sun,2,2,,DEN,L 13-23,7,70,10,101,17,171,2021,2021_02_JAX_DEN
SEA,2021-09-12,7,Sun,1,1,@,IND,W 28-16,7,53,2,16,9,69,2021,2021_01_SEA_IND
TEN,2021-09-12,7,Sun,1,1,,ARI,L 13-38,7,57,8,59,15,116,2021,2021_01_TEN_ARI
SFO,2021-09-12,7,Sun,1,1,@,DET,W 41-33,7,79,5,45,12,124,2021,2021_01_SFO_DET
DET,2021-01-03,7,Sun,16,17,,MIN,L 35-37,7,51,4,35,11,86,2020,2020_17_DET_MIN
NYJ,2020-12-27,7,Sun,15,16,,CLE,W 23-16,7,58,6,51,13,109,2020,2020_16_NYJ_CLE
ATL,2020-12-27,7,Sun,15,16,@,KAN,L 14-17,7,45,6,41,13,86,2020,2020_16_ATL_KAN
MIA,2020-12-20,7,Sun,14,15,,NWE,W 22-12,7,40,2,20,9,60,2020,2020_15_MIA_NWE
JAX,2020-12-20,7,Sun,14,15,@,BAL,L 14-40,7,67,4,40,11,107,2020,2020_15_JAX_BAL
DEN,2020-12-19,7,Sat,14,15,,BUF,L 19-48,7,33,8,75,15,108,2020,2020_15_DEN_BUF
CAR,2020-12-19,7,Sat,14,15,@,GNB,L 16-24,7,66,5,50,12,116,2020,2020_15_CAR_GNB
CAR,2020-12-13,7,Sun,13,14,,DEN,L 27-32,7,48,2,18,9,66,2020,2020_14_CAR_DEN
CHI,2020-12-13,7,Sun,13,14,,HOU,W 36-7,7,44,6,50,13,94,2020,2020_14_CHI_HOU
TEN,2020-12-13,7,Sun,13,14,@,JAX,W 31-10,7,78,10,80,17,158,2020,2020_14_TEN_JAX
BUF,2020-12-13,7,Sun,13,14,,PIT,W 26-15,7,48,3,55,10,103,2020,2020_14_BUF_PIT
NYJ,2020-12-13,7,Sun,13,14,@,SEA,L 3-40,7,50,4,35,11,85,2020,2020_14_NYJ_SEA
DAL,2020-12-08,7,Tue,12,13,@,BAL,L 17-34,7,58,4,23,11,81,2020,2020_13_DAL_BAL
SFO,2020-12-07,7,Mon,12,13,,BUF,L 24-34,7,43,4,50,11,93,2020,2020_13_SFO_BUF
DET,2020-12-06,7,Sun,12,13,@,CHI,W 34-30,7,45,3,20,10,65,2020,2020_13_DET_CHI
IND,2020-12-06,7,Sun,12,13,@,HOU,W 26-20,7,50,3,30,10,80,2020,2020_13_IND_HOU
BAL,2020-12-02,7,Wed,11,12,@,PIT,L 14-19,7,86,5,40,12,126,2020,2020_12_BAL_PIT
CAR,2020-11-29,7,Sun,12,12,@,MIN,L 27-28,7,58,8,52,15,110,2020,2020_12_CAR_MIN
GNB,2020-11-22,7,Sun,10,11,@,IND,L 31-34 (OT),7,45,8,116,15,161,2020,2020_11_GNB_IND
CAR,2020-11-22,7,Sun,11,11,,DET,W 20-0,7,45,4,20,11,65,2020,2020_11_CAR_DET
NWE,2020-11-22,7,Sun,10,11,@,HOU,L 20-27,7,55,5,35,12,90,2020,2020_11_NWE_HOU
ATL,2020-11-22,7,Sun,10,11,@,NOR,L 9-24,7,53,5,35,12,88,2020,2020_11_ATL_NOR
ARI,2020-11-15,7,Sun,9,10,,BUF,W 32-30,7,40,9,69,16,109,2020,2020_10_ARI_BUF
JAX,2020-11-15,7,Sun,9,10,@,GNB,L 20-24,7,86,4,35,11,121,2020,2020_10_JAX_GNB
NYG,2020-11-15,7,Sun,10,10,,PHI,W 27-17,7,64,11,74,18,138,2020,2020_10_NYG_PHI
DEN,2020-11-15,7,Sun,9,10,@,LVR,L 12-37,7,37,8,82,15,119,2020,2020_10_DEN_LVR
MIA,2020-11-08,7,Sun,8,9,@,ARI,W 34-31,7,75,7,71,14,146,2020,2020_09_MIA_ARI
ARI,2020-11-08,7,Sun,8,9,,MIA,L 31-34,7,71,7,75,14,146,2020,2020_09_ARI_MIA
DAL,2020-11-08,7,Sun,9,9,,PIT,L 19-24,7,70,3,16,10,86,2020,2020_09_DAL_PIT
NYG,2020-11-02,7,Mon,8,8,,TAM,L 23-25,7,73,3,20,10,93,2020,2020_08_NYG_TAM
TEN,2020-11-01,7,Sun,7,8,@,CIN,L 20-31,7,68,7,45,14,113,2020,2020_08_TEN_CIN
MIN,2020-11-01,7,Sun,7,8,@,GNB,W 28-22,7,36,9,85,16,121,2020,2020_08_MIN_GNB
CHI,2020-11-01,7,Sun,8,8,,NOR,L 23-26 (OT),7,53,5,45,12,98,2020,2020_08_CHI_NOR
KAN,2020-11-01,7,Sun,8,8,,NYJ,W 35-9,7,61,3,25,10,86,2020,2020_08_KAN_NYJ
CIN,2020-11-01,7,Sun,8,8,,TEN,W 31-20,7,45,7,68,14,113,2020,2020_08_CIN_TEN
DAL,2020-11-01,7,Sun,8,8,@,PHI,L 9-23,7,68,4,28,11,96,2020,2020_08_DAL_PHI
CLE,2020-11-01,7,Sun,8,8,,LVR,L 6-16,7,59,5,25,12,84,2020,2020_08_CLE_LVR
CIN,2020-10-25,7,Sun,7,7,,CLE,L 34-37,7,45,5,40,12,85,2020,2020_07_CIN_CLE
TEN,2020-10-25,7,Sun,6,7,,PIT,L 24-27,7,73,8,69,15,142,2020,2020_07_TEN_PIT
PHI,2020-10-22,7,Thu,7,7,,NYG,W 22-21,7,75,9,62,16,137,2020,2020_07_PHI_NYG
ARI,2020-10-19,7,Mon,6,6,@,DAL,W 38-10,7,43,6,36,13,79,2020,2020_06_ARI_DAL
TEN,2020-10-18,7,Sun,5,6,,HOU,W 42-36 (OT),7,73,4,46,11,119,2020,2020_06_TEN_HOU
DET,2020-10-18,7,Sun,5,6,@,JAX,W 34-16,7,60,5,56,12,116,2020,2020_06_DET_JAX
NYJ,2020-10-18,7,Sun,6,6,@,MIA,L 0-24,7,80,5,25,12,105,2020,2020_06_NYJ_MIA
CLE,2020-10-18,7,Sun,6,6,@,PIT,L 7-38,7,55,6,45,13,100,2020,2020_06_CLE_PIT
SFO,2020-10-18,7,Sun,6,6,,LAR,W 24-16,7,63,6,34,13,97,2020,2020_06_SFO_LAR
SFO,2020-10-11,7,Sun,5,5,,MIA,L 17-43,7,75,7,69,14,144,2020,2020_05_SFO_MIA
MIA,2020-10-11,7,Sun,5,5,@,SFO,W 43-17,7,69,7,75,14,144,2020,2020_05_MIA_SFO
LVR,2020-10-04,7,Sun,4,4,,BUF,L 23-30,7,65,5,81,12,146,2020,2020_04_LVR_BUF
CIN,2020-10-04,7,Sun,4,4,,JAX,W 33-25,7,73,6,49,13,122,2020,2020_04_CIN_JAX
LAC,2020-10-04,7,Sun,4,4,@,TAM,L 31-38,7,60,8,90,15,150,2020,2020_04_LAC_TAM
ATL,2020-09-27,7,Sun,3,3,,CHI,L 26-30,7,75,10,80,17,155,2020,2020_03_ATL_CHI
NYJ,2020-09-27,7,Sun,3,3,@,IND,L 7-36,7,57,4,40,11,97,2020,2020_03_NYJ_IND
DET,2020-09-27,7,Sun,3,3,@,ARI,W 26-23,7,46,7,38,14,84,2020,2020_03_DET_ARI
ARI,2020-09-27,7,Sun,3,3,,DET,L 23-26,7,38,7,46,14,84,2020,2020_03_ARI_DET
DAL,2020-09-20,7,Sun,2,2,,ATL,W 40-39,7,75,8,51,15,126,2020,2020_02_DAL_ATL
DET,2020-09-20,7,Sun,2,2,@,GNB,L 21-42,7,70,8,60,15,130,2020,2020_02_DET_GNB
BAL,2020-09-13,7,Sun,1,1,,CLE,W 38-6,7,66,8,80,15,146,2020,2020_01_BAL_CLE
BUF,2020-09-13,7,Sun,1,1,,NYJ,W 27-17,7,79,9,95,16,174,2020,2020_01_BUF_NYJ
WAS,2020-09-13,7,Sun,1,1,,PHI,W 27-17,7,55,3,20,10,75,2020,2020_01_WAS_PHI
DAL,2020-09-13,7,Sun,1,1,@,LAR,L 17-20,7,50,5,34,12,84,2020,2020_01_DAL_LAR
CIN,2020-09-13,7,Sun,1,1,,LAC,L 13-16,7,44,6,35,13,79,2020,2020_01_CIN_LAC
PHI,2019-12-29,7,Sun,16,17,@,NYG,W 34-17,7,55,4,48,11,103,2019,2019_17_PHI_NYG
CHI,2019-12-22,7,Sun,15,16,,KAN,L 3-26,7,50,9,71,16,121,2019,2019_16_CHI_KAN
CLE,2019-12-22,7,Sun,15,16,,BAL,L 15-31,7,62,7,50,14,112,2019,2019_16_CLE_BAL
BAL,2019-12-22,7,Sun,15,16,@,CLE,W 31-15,7,50,7,62,14,112,2019,2019_16_BAL_CLE
SEA,2019-12-22,7,Sun,15,16,,ARI,L 13-27,7,55,5,47,12,102,2019,2019_16_SEA_ARI
DET,2019-12-22,7,Sun,15,16,@,DEN,L 17-27,7,68,6,50,13,118,2019,2019_16_DET_DEN
BUF,2019-12-21,7,Sat,15,16,@,NWE,L 17-24,7,46,3,30,10,76,2019,2019_16_BUF_NWE
LAR,2019-12-21,7,Sat,15,16,@,SFO,L 31-34,7,43,3,26,10,69,2019,2019_16_LAR_SFO
IND,2019-12-16,7,Mon,14,15,@,NOR,L 7-34,7,49,6,52,13,101,2019,2019_15_IND_NOR
DEN,2019-12-15,7,Sun,14,15,@,KAN,L 3-23,7,72,5,45,12,117,2019,2019_15_DEN_KAN
MIA,2019-12-15,7,Sun,14,15,@,NYG,L 20-36,7,42,4,32,11,74,2019,2019_15_MIA_NYG
PHI,2019-12-15,7,Sun,14,15,@,WAS,W 37-27,7,54,5,60,12,114,2019,2019_15_PHI_WAS
SFO,2019-12-15,7,Sun,14,15,,ATL,L 22-29,7,67,11,98,18,165,2019,2019_15_SFO_ATL
NYG,2019-12-09,7,Mon,13,14,@,PHI,L 17-23 (OT),7,54,4,30,11,84,2019,2019_14_NYG_PHI
DEN,2019-12-08,7,Sun,13,14,@,HOU,W 38-24,7,50,9,44,16,94,2019,2019_14_DEN_HOU
ARI,2019-12-08,7,Sun,13,14,,PIT,L 17-23,7,75,4,20,11,95,2019,2019_14_ARI_PIT
CAR,2019-12-08,7,Sun,13,14,@,ATL,L 20-40,7,44,6,58,13,102,2019,2019_14_CAR_ATL
LAC,2019-12-01,7,Sun,12,13,@,DEN,L 20-23,7,82,3,25,10,107,2019,2019_13_LAC_DEN
GNB,2019-12-01,7,Sun,12,13,@,NYG,W 31-13,7,54,4,31,11,85,2019,2019_13_GNB_NYG
MIA,2019-12-01,7,Sun,12,13,,PHI,W 37-31,7,59,10,91,17,150,2019,2019_13_MIA_PHI
BUF,2019-11-28,7,Thu,12,13,@,DAL,W 26-15,7,53,5,66,12,119,2019,2019_13_BUF_DAL
DEN,2019-11-24,7,Sun,11,12,@,BUF,L 3-20,7,70,12,90,19,160,2019,2019_12_DEN_BUF
CLE,2019-11-24,7,Sun,11,12,,MIA,W 41-24,7,70,8,94,15,164,2019,2019_12_CLE_MIA
DAL,2019-11-24,7,Sun,11,12,@,NWE,L 9-13,7,50,6,56,13,106,2019,2019_12_DAL_NWE
CIN,2019-11-24,7,Sun,11,12,,PIT,L 10-16,7,79,10,77,17,156,2019,2019_12_CIN_PIT
ATL,2019-11-24,7,Sun,11,12,,TAM,L 22-35,7,60,8,51,15,111,2019,2019_12_ATL_TAM
TAM,2019-11-17,7,Sun,10,11,,NOR,L 17-34,7,55,9,76,16,131,2019,2019_11_TAM_NOR
PHI,2019-11-17,7,Sun,10,11,,NWE,L 10-17,7,39,6,89,13,128,2019,2019_11_PHI_NWE
OAK,2019-11-17,7,Sun,10,11,,CIN,W 17-10,7,42,4,40,11,82,2019,2019_11_OAK_CIN
BUF,2019-11-10,7,Sun,9,10,@,CLE,L 16-19,7,40,4,70,11,110,2019,2019_10_BUF_CLE
CHI,2019-11-10,7,Sun,9,10,,DET,W 20-13,7,57,8,76,15,133,2019,2019_10_CHI_DET
ATL,2019-11-10,7,Sun,9,10,@,NOR,W 26-9,7,48,12,90,19,138,2019,2019_10_ATL_NOR
NYJ,2019-11-10,7,Sun,9,10,,NYG,W 34-27,7,54,6,62,13,116,2019,2019_10_NYJ_NYG
HOU,2019-11-03,7,Sun,9,9,@,JAX,W 26-3,7,60,4,34,11,94,2019,2019_09_HOU_JAX
IND,2019-11-03,7,Sun,8,9,@,PIT,L 24-26,7,89,5,70,12,159,2019,2019_09_IND_PIT
NWE,2019-11-03,7,Sun,9,9,@,BAL,L 20-37,7,48,4,34,11,82,2019,2019_09_NWE_BAL
DEN,2019-11-03,7,Sun,9,9,,CLE,W 24-19,7,55,5,40,12,95,2019,2019_09_DEN_CLE
DET,2019-10-27,7,Sun,7,8,,NYG,W 31-26,7,75,5,44,12,119,2019,2019_08_DET_NYG
HOU,2019-10-27,7,Sun,8,8,,OAK,W 27-24,7,50,11,100,18,150,2019,2019_08_HOU_OAK
MIN,2019-10-24,7,Thu,8,8,,WAS,W 19-9,7,74,4,46,11,120,2019,2019_08_MIN_WAS
NWE,2019-10-21,7,Mon,7,7,@,NYJ,W 33-0,7,92,8,60,15,152,2019,2019_07_NWE_NYJ
TEN,2019-10-20,7,Sun,7,7,,LAC,W 23-20,7,54,4,29,11,83,2019,2019_07_TEN_LAC
WAS,2019-10-20,7,Sun,7,7,,SFO,L 0-9,7,47,2,20,9,67,2019,2019_07_WAS_SFO
PHI,2019-10-13,7,Sun,6,6,@,MIN,L 20-38,7,49,4,30,11,79,2019,2019_06_PHI_MIN
CLE,2019-10-07,7,Mon,5,5,@,SFO,L 3-31,7,55,4,34,11,89,2019,2019_05_CLE_SFO
ATL,2019-10-06,7,Sun,5,5,@,HOU,L 32-53,7,63,9,89,16,152,2019,2019_05_ATL_HOU
IND,2019-10-06,7,Sun,5,5,@,KAN,W 19-13,7,50,11,125,18,175,2019,2019_05_IND_KAN
NWE,2019-10-06,7,Sun,5,5,@,WAS,W 33-7,7,55,6,72,13,127,2019,2019_05_NWE_WAS
CIN,2019-10-06,7,Sun,5,5,,ARI,L 23-26,7,60,12,96,19,156,2019,2019_05_CIN_ARI
HOU,2019-09-29,7,Sun,4,4,,CAR,L 10-16,7,81,6,35,13,116,2019,2019_04_HOU_CAR
MIN,2019-09-29,7,Sun,4,4,@,CHI,L 6-16,7,55,7,50,14,105,2019,2019_04_MIN_CHI
SEA,2019-09-29,7,Sun,4,4,@,ARI,W 27-10,7,65,7,44,14,109,2019,2019_04_SEA_ARI
KAN,2019-09-29,7,Sun,4,4,@,DET,W 34-30,7,51,8,48,15,99,2019,2019_04_KAN_DET
CHI,2019-09-29,7,Sun,4,4,,MIN,W 16-6,7,50,7,55,14,105,2019,2019_04_CHI_MIN
ATL,2019-09-29,7,Sun,4,4,,TEN,L 10-24,7,50,5,77,12,127,2019,2019_04_ATL_TEN
ARI,2019-09-29,7,Sun,4,4,,SEA,L 10-27,7,44,7,65,14,109,2019,2019_04_ARI_SEA
LAC,2019-09-22,7,Sun,3,3,,HOU,L 20-27,7,69,6,65,13,134,2019,2019_03_LAC_HOU
BAL,2019-09-22,7,Sun,3,3,@,KAN,L 28-33,7,60,4,31,11,91,2019,2019_03_BAL_KAN
OAK,2019-09-22,7,Sun,3,3,@,MIN,L 14-34,7,84,6,59,13,143,2019,2019_03_OAK_MIN
SEA,2019-09-22,7,Sun,3,3,,NOR,L 27-33,7,53,11,70,18,123,2019,2019_03_SEA_NOR
ARI,2019-09-22,7,Sun,3,3,,CAR,L 20-38,7,52,3,35,10,87,2019,2019_03_ARI_CAR
BUF,2019-09-22,7,Sun,3,3,,CIN,W 21-17,7,55,8,54,15,109,2019,2019_03_BUF_CIN
LAR,2019-09-22,7,Sun,3,3,@,CLE,W 20-13,7,49,8,60,15,109,2019,2019_03_LAR_CLE
GNB,2019-09-22,7,Sun,3,3,,DEN,W 27-16,7,53,3,27,10,80,2019,2019_03_GNB_DEN
PHI,2019-09-15,7,Sun,2,2,@,ATL,L 20-24,7,60,10,58,17,118,2019,2019_02_PHI_ATL
NYG,2019-09-15,7,Sun,2,2,,BUF,L 14-28,7,40,9,65,16,105,2019,2019_02_NYG_BUF
CHI,2019-09-15,7,Sun,2,2,@,DEN,W 16-14,7,65,10,81,17,146,2019,2019_02_CHI_DEN
HOU,2019-09-15,7,Sun,2,2,,JAX,W 13-12,7,47,9,70,16,117,2019,2019_02_HOU_JAX
OAK,2019-09-15,7,Sun,2,2,,KAN,L 10-28,7,52,10,114,17,166,2019,2019_02_OAK_KAN
CIN,2019-09-15,7,Sun,2,2,,SFO,L 17-41,7,60,9,75,16,135,2019,2019_02_CIN_SFO
NOR,2019-09-09,7,Mon,1,1,,HOU,W 30-28,7,48,8,69,15,117,2019,2019_01_NOR_HOU
BUF,2019-09-08,7,Sun,1,1,@,NYJ,W 17-16,7,55,8,67,15,122,2019,2019_01_BUF_NYJ
NWE,2019-09-08,7,Sun,1,1,,PIT,W 33-3,7,55,6,54,13,109,2019,2019_01_NWE_PIT
CIN,2019-09-08,7,Sun,1,1,@,SEA,L 20-21,7,57,8,55,15,112,2019,2019_01_CIN_SEA
ARI,2019-09-08,7,Sun,1,1,,DET,T 27-27 (OT),7,35,9,59,16,94,2019,2019_01_ARI_DET
DET,2018-12-23,7,Sun,15,16,,MIN,L 9-27,7,55,11,78,18,133,2018,2018_16_DET_MIN
ARI,2018-12-23,7,Sun,15,16,,LAR,L 9-31,7,54,6,66,13,120,2018,2018_16_ARI_LAR
GNB,2018-12-16,7,Sun,14,15,@,CHI,L 17-24,7,48,4,24,11,72,2018,2018_15_GNB_CHI
LAC,2018-12-13,7,Thu,14,15,@,KAN,W 29-28,7,50,10,66,17,116,2018,2018_15_LAC_KAN
NYJ,2018-12-09,7,Sun,13,14,@,BUF,W 27-23,7,93,7,47,14,140,2018,2018_14_NYJ_BUF
CLE,2018-12-09,7,Sun,13,14,,CAR,W 26-20,7,52,10,68,17,120,2018,2018_14_CLE_CAR
HOU,2018-12-09,7,Sun,13,14,,IND,L 21-24,7,35,9,59,16,94,2018,2018_14_HOU_IND
DET,2018-12-09,7,Sun,13,14,@,ARI,W 17-3,7,68,8,83,15,151,2018,2018_14_DET_ARI
MIA,2018-12-09,7,Sun,13,14,,NWE,W 34-33,7,81,5,30,12,111,2018,2018_14_MIA_NWE
BUF,2018-12-09,7,Sun,13,14,,NYJ,L 23-27,7,47,7,93,14,140,2018,2018_14_BUF_NYJ
KAN,2018-12-09,7,Sun,13,14,,BAL,W 27-24 (OT),7,53,11,112,18,165,2018,2018_14_KAN_BAL
JAX,2018-12-06,7,Thu,13,14,@,TEN,L 9-30,7,67,3,30,10,97,2018,2018_14_JAX_TEN
DEN,2018-12-02,7,Sun,12,13,@,CIN,W 24-10,7,60,12,100,19,160,2018,2018_13_DEN_CIN
GNB,2018-12-02,7,Sun,12,13,,ARI,L 17-20,7,43,7,49,14,92,2018,2018_13_GNB_ARI
LAR,2018-12-02,7,Sun,12,13,@,DET,W 30-16,7,105,8,54,15,159,2018,2018_13_LAR_DET
ARI,2018-12-02,7,Sun,12,13,@,GNB,W 20-17,7,49,7,43,14,92,2018,2018_13_ARI_GNB
NWE,2018-12-02,7,Sun,12,13,,MIN,W 24-10,7,60,5,55,12,115,2018,2018_13_NWE_MIN
PIT,2018-12-02,7,Sun,12,13,,LAC,L 30-33,7,59,5,80,12,139,2018,2018_13_PIT_LAC
CAR,2018-12-02,7,Sun,12,13,@,TAM,L 17-24,7,104,9,69,16,173,2018,2018_13_CAR_TAM
TEN,2018-11-26,7,Mon,11,12,@,HOU,L 17-34,7,50,3,53,10,103,2018,2018_12_TEN_HOU
CLE,2018-11-25,7,Sun,11,12,@,CIN,W 35-20,7,61,13,96,20,157,2018,2018_12_CLE_CIN
IND,2018-11-25,7,Sun,11,12,,MIA,W 27-24,7,52,10,75,17,127,2018,2018_12_IND_MIA
PHI,2018-11-25,7,Sun,11,12,,NYG,W 25-22,7,46,11,91,18,137,2018,2018_12_PHI_NYG
IND,2018-11-18,7,Sun,10,11,,TEN,W 38-10,7,60,8,112,15,172,2018,2018_11_IND_TEN
ARI,2018-11-18,7,Sun,10,11,,OAK,L 21-23,7,62,4,20,11,82,2018,2018_11_ARI_OAK
CIN,2018-11-18,7,Sun,10,11,@,BAL,L 21-24,7,58,5,31,12,89,2018,2018_11_CIN_BAL
DEN,2018-11-18,7,Sun,10,11,@,LAC,W 23-22,7,43,14,120,21,163,2018,2018_11_DEN_LAC
HOU,2018-11-18,7,Sun,10,11,@,WAS,W 23-21,7,40,6,43,13,83,2018,2018_11_HOU_WAS
CLE,2018-11-11,7,Sun,10,10,,ATL,W 28-16,7,38,1,5,8,43,2018,2018_10_CLE_ATL
IND,2018-11-11,7,Sun,9,10,,JAX,W 29-26,7,45,8,61,15,106,2018,2018_10_IND_JAX
SEA,2018-11-11,7,Sun,9,10,@,LAR,L 31-36,7,56,10,102,17,158,2018,2018_10_SEA_LAR
HOU,2018-11-04,7,Sun,9,9,@,DEN,W 19-17,7,60,8,50,15,110,2018,2018_09_HOU_DEN
GNB,2018-11-04,7,Sun,8,9,@,NWE,L 17-31,7,63,5,30,12,93,2018,2018_09_GNB_NWE
ATL,2018-11-04,7,Sun,8,9,@,WAS,W 38-14,7,50,10,147,17,197,2018,2018_09_ATL_WAS
KAN,2018-10-28,7,Sun,8,8,,DEN,W 30-23,7,50,10,83,17,133,2018,2018_08_KAN_DEN
SEA,2018-10-28,7,Sun,7,8,@,DET,W 28-14,7,111,4,32,11,143,2018,2018_08_SEA_DET
NOR,2018-10-28,7,Sun,7,8,@,MIN,W 30-20,7,64,6,54,13,118,2018,2018_08_NOR_MIN
CLE,2018-10-28,7,Sun,8,8,@,PIT,L 18-33,7,52,8,60,15,112,2018,2018_08_CLE_PIT
NWE,2018-10-21,7,Sun,7,7,@,CHI,W 38-31,7,64,5,40,12,104,2018,2018_07_NWE_CHI
BUF,2018-10-21,7,Sun,7,7,@,IND,L 5-37,7,59,4,35,11,94,2018,2018_07_BUF_IND
ARI,2018-10-18,7,Thu,7,7,,DEN,L 10-45,7,45,5,50,12,95,2018,2018_07_ARI_DEN
MIA,2018-10-14,7,Sun,6,6,,CHI,W 31-28 (OT),7,67,6,58,13,125,2018,2018_06_MIA_CHI
NYJ,2018-10-14,7,Sun,6,6,,IND,W 42-34,7,49,8,66,15,115,2018,2018_06_NYJ_IND
PIT,2018-10-07,7,Sun,5,5,,ATL,W 41-17,7,58,7,75,14,133,2018,2018_05_PIT_ATL
DAL,2018-10-07,7,Sun,5,5,@,HOU,L 16-19 (OT),7,72,5,25,12,97,2018,2018_05_DAL_HOU
ATL,2018-10-07,7,Sun,5,5,@,PIT,L 17-41,7,75,7,58,14,133,2018,2018_05_ATL_PIT
SEA,2018-10-07,7,Sun,5,5,,LAR,L 31-33,7,50,7,45,14,95,2018,2018_05_SEA_LAR
OAK,2018-10-07,7,Sun,5,5,@,LAC,L 10-26,7,55,9,82,16,137,2018,2018_05_OAK_LAC
LAR,2018-10-07,7,Sun,5,5,@,SEA,W 33-31,7,45,7,50,14,95,2018,2018_05_LAR_SEA
NWE,2018-10-04,7,Thu,5,5,,IND,W 38-24,7,50,4,35,11,85,2018,2018_05_NWE_IND
BAL,2018-09-30,7,Sun,4,4,@,PIT,W 26-14,7,50,5,40,12,90,2018,2018_04_BAL_PIT
CHI,2018-09-23,7,Sun,3,3,@,ARI,W 16-14,7,45,6,43,13,88,2018,2018_03_CHI_ARI
BAL,2018-09-23,7,Sun,3,3,,DEN,W 27-14,7,52,13,120,20,172,2018,2018_03_BAL_DEN
HOU,2018-09-23,7,Sun,3,3,,NYG,L 22-27,7,50,3,20,10,70,2018,2018_03_HOU_NYG
DAL,2018-09-23,7,Sun,3,3,@,SEA,L 13-24,7,55,10,67,17,122,2018,2018_03_DAL_SEA
CHI,2018-09-17,7,Mon,2,2,,SEA,W 24-17,7,55,5,37,12,92,2018,2018_02_CHI_SEA
CAR,2018-09-16,7,Sun,2,2,@,ATL,L 24-31,7,49,2,26,9,75,2018,2018_02_CAR_ATL
WAS,2018-09-16,7,Sun,2,2,,IND,L 9-21,7,90,6,26,13,116,2018,2018_02_WAS_IND
NYJ,2018-09-16,7,Sun,2,2,,MIA,L 12-20,7,50,2,10,9,60,2018,2018_02_NYJ_MIA
GNB,2018-09-16,7,Sun,2,2,,MIN,T 29-29 (OT),7,54,8,70,15,124,2018,2018_02_GNB_MIN
JAX,2018-09-16,7,Sun,2,2,,NWE,W 31-20,7,71,2,25,9,96,2018,2018_02_JAX_NWE
BAL,2018-09-13,7,Thu,2,2,@,CIN,L 23-34,7,51,9,92,16,143,2018,2018_02_BAL_CIN
NYJ,2018-09-10,7,Mon,1,1,@,DET,W 48-17,7,49,3,15,10,64,2018,2018_01_NYJ_DET
IND,2018-09-09,7,Sun,1,1,,CIN,L 23-34,7,91,8,94,15,185,2018,2018_01_IND_CIN
SEA,2018-09-09,7,Sun,1,1,@,DEN,L 24-27,7,45,7,60,14,105,2018,2018_01_SEA_DEN
LAC,2018-09-09,7,Sun,1,1,,KAN,L 28-38,7,45,6,50,13,95,2018,2018_01_LAC_KAN
TAM,2018-09-09,7,Sun,1,1,@,NOR,W 48-40,7,70,8,77,15,147,2018,2018_01_TAM_NOR
MIA,2018-09-09,7,Sun,1,1,,TEN,W 27-20,7,51,5,48,12,99,2018,2018_01_MIA_TEN
DEN,2018-09-09,7,Sun,1,1,,SEA,W 27-24,7,60,7,45,14,105,2018,2018_01_DEN_SEA
MIN,2018-09-09,7,Sun,1,1,,SFO,W 24-16,7,52,3,21,10,73,2018,2018_01_MIN_SFO
ATL,2017-12-31,7,Sun,16,17,,CAR,W 22-10,7,60,5,35,12,95,2017,2017_17_ATL_CAR
HOU,2017-12-31,7,Sun,16,17,@,IND,L 13-22,7,34,4,20,11,54,2017,2017_17_HOU_IND
PHI,2017-12-31,7,Sun,16,17,,DAL,L 0-6,7,49,7,64,14,113,2017,2017_17_PHI_DAL
DAL,2017-12-31,7,Sun,16,17,@,PHI,W 6-0,7,64,7,49,14,113,2017,2017_17_DAL_PHI
LAC,2017-12-31,7,Sun,16,17,,OAK,W 30-10,7,65,6,85,13,150,2017,2017_17_LAC_OAK
NOR,2017-12-31,7,Sun,16,17,@,TAM,L 24-31,7,38,2,15,9,53,2017,2017_17_NOR_TAM
OAK,2017-12-25,7,Mon,15,16,@,PHI,L 10-19,7,50,8,60,15,110,2017,2017_16_OAK_PHI
HOU,2017-12-25,7,Mon,15,16,,PIT,L 6-34,7,80,4,24,11,104,2017,2017_16_HOU_PIT
DAL,2017-12-24,7,Sun,15,16,,SEA,L 12-21,7,75,11,142,18,217,2017,2017_16_DAL_SEA
TAM,2017-12-18,7,Mon,14,15,,ATL,L 21-24,7,53,6,60,13,113,2017,2017_15_TAM_ATL
MIA,2017-12-17,7,Sun,14,15,@,BUF,L 16-24,7,60,3,28,10,88,2017,2017_15_MIA_BUF
BAL,2017-12-17,7,Sun,14,15,@,CLE,W 27-10,7,57,6,35,13,92,2017,2017_15_BAL_CLE
WAS,2017-12-17,7,Sun,14,15,,ARI,W 20-15,7,82,8,71,15,153,2017,2017_15_WAS_ARI
PHI,2017-12-17,7,Sun,14,15,@,NYG,W 34-29,7,44,5,67,12,111,2017,2017_15_PHI_NYG
SFO,2017-12-17,7,Sun,14,15,,TEN,W 25-23,7,70,3,22,10,92,2017,2017_15_SFO_TEN
DAL,2017-12-17,7,Sun,14,15,@,OAK,W 20-17,7,100,14,105,21,205,2017,2017_15_DAL_OAK
KAN,2017-12-16,7,Sat,14,15,,LAC,W 30-13,7,71,9,61,16,132,2017,2017_15_KAN_LAC
CIN,2017-12-10,7,Sun,13,14,,CHI,L 7-33,7,56,10,74,17,130,2017,2017_14_CIN_CHI
NYG,2017-12-10,7,Sun,13,14,,DAL,L 10-30,7,69,8,51,15,120,2017,2017_14_NYG_DAL
TAM,2017-12-10,7,Sun,13,14,,DET,L 21-24,7,65,8,105,15,170,2017,2017_14_TAM_DET
OAK,2017-12-10,7,Sun,13,14,@,KAN,L 15-26,7,39,7,69,14,108,2017,2017_14_OAK_KAN
LAR,2017-12-10,7,Sun,13,14,,PHI,L 35-43,7,102,10,67,17,169,2017,2017_14_LAR_PHI
KAN,2017-12-10,7,Sun,13,14,,OAK,W 26-15,7,69,7,39,14,108,2017,2017_14_KAN_OAK
JAX,2017-12-10,7,Sun,13,14,,SEA,W 30-24,7,48,6,73,13,121,2017,2017_14_JAX_SEA
PIT,2017-12-04,7,Mon,12,13,@,CIN,W 23-20,7,66,13,173,20,239,2017,2017_13_PIT_CIN
NOR,2017-12-03,7,Sun,12,13,,CAR,W 31-21,7,68,6,54,13,122,2017,2017_13_NOR_CAR
LAR,2017-12-03,7,Sun,12,13,@,ARI,W 32-16,7,36,4,25,11,61,2017,2017_13_LAR_ARI
MIA,2017-12-03,7,Sun,12,13,,DEN,W 35-9,7,85,9,57,16,142,2017,2017_13_MIA_DEN
TEN,2017-12-03,7,Sun,12,13,,HOU,W 24-13,7,63,11,85,18,148,2017,2017_13_TEN_HOU
ATL,2017-12-03,7,Sun,12,13,,MIN,L 9-14,7,55,6,51,13,106,2017,2017_13_ATL_MIN
PHI,2017-12-03,7,Sun,12,13,@,SEA,L 10-24,7,64,5,46,12,110,2017,2017_13_PHI_SEA
GNB,2017-12-03,7,Sun,12,13,,TAM,W 26-20 (OT),7,47,8,74,15,121,2017,2017_13_GNB_TAM
WAS,2017-11-30,7,Thu,12,13,@,DAL,L 14-38,7,43,3,25,10,68,2017,2017_13_WAS_DAL
BAL,2017-11-27,7,Mon,11,12,,HOU,W 23-16,7,89,6,36,13,125,2017,2017_12_BAL_HOU
NYJ,2017-11-26,7,Sun,11,12,,CAR,L 27-35,7,68,10,84,17,152,2017,2017_12_NYJ_CAR
CLE,2017-11-26,7,Sun,11,12,@,CIN,L 16-30,7,69,4,35,11,104,2017,2017_12_CLE_CIN
OAK,2017-11-26,7,Sun,11,12,,DEN,W 21-14,7,68,9,75,16,143,2017,2017_12_OAK_DEN
NWE,2017-11-26,7,Sun,11,12,,MIA,W 35-17,7,70,6,52,13,122,2017,2017_12_NWE_MIA
NOR,2017-11-26,7,Sun,11,12,@,LAR,L 20-26,7,112,9,90,16,202,2017,2017_12_NOR_LAR
SFO,2017-11-26,7,Sun,11,12,,SEA,L 13-24,7,74,6,35,13,109,2017,2017_12_SFO_SEA
DAL,2017-11-23,7,Thu,11,12,,LAC,L 6-28,7,60,5,56,12,116,2017,2017_12_DAL_LAC
ATL,2017-11-20,7,Mon,10,11,@,SEA,W 34-31,7,69,9,106,16,175,2017,2017_11_ATL_SEA
MIN,2017-11-19,7,Sun,10,11,,LAR,W 24-7,7,65,8,60,15,125,2017,2017_11_MIN_LAR
NOR,2017-11-19,7,Sun,10,11,,WAS,W 34-31 (OT),7,54,9,67,16,121,2017,2017_11_NOR_WAS
PIT,2017-11-16,7,Thu,10,11,,TEN,W 40-17,7,61,9,65,16,126,2017,2017_11_PIT_TEN
MIA,2017-11-13,7,Mon,9,10,@,CAR,L 21-45,7,57,6,37,13,94,2017,2017_10_MIA_CAR
DET,2017-11-12,7,Sun,9,10,,CLE,W 38-24,7,81,7,60,14,141,2017,2017_10_DET_CLE
CLE,2017-11-12,7,Sun,9,10,@,DET,L 24-38,7,60,7,81,14,141,2017,2017_10_CLE_DET
LAC,2017-11-12,7,Sun,9,10,@,JAX,L 17-20 (OT),7,77,9,106,16,183,2017,2017_10_LAC_JAX
HOU,2017-11-05,7,Sun,8,9,,IND,L 14-20,7,74,6,68,13,142,2017,2017_09_HOU_IND
TAM,2017-11-05,7,Sun,8,9,@,NOR,L 10-30,7,50,4,28,11,78,2017,2017_09_TAM_NOR
WAS,2017-11-05,7,Sun,8,9,@,SEA,W 17-14,7,62,16,138,23,200,2017,2017_09_WAS_SEA
KAN,2017-10-30,7,Mon,8,8,,DEN,W 29-19,7,69,7,53,14,122,2017,2017_08_KAN_DEN
DEN,2017-10-30,7,Mon,7,8,@,KAN,L 19-29,7,53,7,69,14,122,2017,2017_08_DEN_KAN
NOR,2017-10-29,7,Sun,7,8,,CHI,W 20-12,7,51,4,31,11,82,2017,2017_08_NOR_CHI
IND,2017-10-29,7,Sun,8,8,@,CIN,L 23-24,7,45,5,54,12,99,2017,2017_08_IND_CIN
MIA,2017-10-26,7,Thu,7,8,@,BAL,L 0-40,7,43,5,40,12,83,2017,2017_08_MIA_BAL
NOR,2017-10-22,7,Sun,6,7,@,GNB,W 26-17,7,80,8,54,15,134,2017,2017_07_NOR_GNB
NYG,2017-10-22,7,Sun,7,7,,SEA,L 7-24,7,28,15,110,22,138,2017,2017_07_NYG_SEA
MIN,2017-10-15,7,Sun,6,6,,GNB,W 23-10,7,65,8,92,15,157,2017,2017_06_MIN_GNB
LAR,2017-10-15,7,Sun,6,6,@,JAX,W 27-17,7,70,5,40,12,110,2017,2017_06_LAR_JAX
DET,2017-10-15,7,Sun,6,6,@,NOR,L 38-52,7,46,13,118,20,164,2017,2017_06_DET_NOR
KAN,2017-10-15,7,Sun,6,6,,PIT,L 13-19,7,48,6,57,13,105,2017,2017_06_KAN_PIT
ARI,2017-10-15,7,Sun,6,6,,TAM,W 38-33,7,61,9,49,16,110,2017,2017_06_ARI_TAM
SFO,2017-10-15,7,Sun,6,6,@,WAS,L 24-26,7,40,5,43,12,83,2017,2017_06_SFO_WAS
DAL,2017-10-08,7,Sun,5,5,,GNB,L 31-35,7,70,6,38,13,108,2017,2017_05_DAL_GNB
HOU,2017-10-08,7,Sun,5,5,,KAN,L 34-42,7,59,6,64,13,123,2017,2017_05_HOU_KAN
ARI,2017-10-08,7,Sun,5,5,@,PHI,L 7-34,7,61,5,60,12,121,2017,2017_05_ARI_PHI
SEA,2017-10-08,7,Sun,5,5,@,LAR,W 16-10,7,40,5,45,12,85,2017,2017_05_SEA_LAR
IND,2017-10-08,7,Sun,5,5,,SFO,W 26-23 (OT),7,62,10,77,17,139,2017,2017_05_IND_SFO
WAS,2017-10-02,7,Mon,4,4,@,KAN,L 20-29,7,44,3,15,10,59,2017,2017_04_WAS_KAN
NWE,2017-10-01,7,Sun,4,4,,CAR,L 30-33,7,55,1,33,8,88,2017,2017_04_NWE_CAR
LAR,2017-10-01,7,Sun,4,4,@,DAL,W 35-30,7,41,4,45,11,86,2017,2017_04_LAR_DAL
OAK,2017-10-01,7,Sun,4,4,@,DEN,L 10-16,7,75,6,40,13,115,2017,2017_04_OAK_DEN
GNB,2017-09-28,7,Thu,4,4,,CHI,W 35-14,7,55,8,62,15,117,2017,2017_04_GNB_CHI
CIN,2017-09-24,7,Sun,3,3,@,GNB,L 24-27 (OT),7,68,4,33,11,101,2017,2017_03_CIN_GNB
TAM,2017-09-24,7,Sun,2,3,@,MIN,L 17-34,7,37,5,53,12,90,2017,2017_03_TAM_MIN
LAR,2017-09-21,7,Thu,3,3,@,SFO,W 41-39,7,52,10,55,17,107,2017,2017_03_LAR_SFO
NYG,2017-09-18,7,Mon,2,2,,DET,L 10-24,7,50,6,50,13,100,2017,2017_02_NYG_DET
BAL,2017-09-17,7,Sun,2,2,,CLE,W 24-10,7,45,11,65,18,110,2017,2017_02_BAL_CLE
TEN,2017-09-17,7,Sun,2,2,@,JAX,W 37-16,7,70,10,99,17,169,2017,2017_02_TEN_JAX
LAR,2017-09-17,7,Sun,2,2,,WAS,L 20-27,7,75,4,25,11,100,2017,2017_02_LAR_WAS
CIN,2017-09-14,7,Thu,2,2,,HOU,L 9-13,7,45,9,61,16,106,2017,2017_02_CIN_HOU
LAR,2017-09-10,7,Sun,1,1,,IND,W 46-9,7,50,4,20,11,70,2017,2017_01_LAR_IND
NYJ,2023-01-08,6,Sun,17,18,@,MIA,L 6-11,6,54,5,47,11,101,2022,2022_18_NYJ_MIA
DAL,2023-01-08,6,Sun,17,18,@,WAS,L 6-26,6,74,2,10,8,84,2022,2022_18_DAL_WAS
TEN,2023-01-07,6,Sat,17,18,@,JAX,L 16-20,6,40,4,25,10,65,2022,2022_18_TEN_JAX
LVR,2023-01-07,6,Sat,17,18,,KAN,L 13-31,6,47,5,43,11,90,2022,2022_18_LVR_KAN
DET,2023-01-01,6,Sun,16,17,,CHI,W 41-10,6,42,3,49,9,91,2022,2022_17_DET_CHI
MIN,2023-01-01,6,Sun,16,17,@,GNB,L 17-41,6,35,3,30,9,65,2022,2022_17_MIN_GNB
NWE,2023-01-01,6,Sun,16,17,,MIA,W 23-21,6,39,9,71,15,110,2022,2022_17_NWE_MIA
PIT,2023-01-01,6,Sun,16,17,@,BAL,W 16-13,6,43,4,30,10,73,2022,2022_17_PIT_BAL
LVR,2023-01-01,6,Sun,16,17,,SFO,L 34-37 (OT),6,49,9,71,15,120,2022,2022_17_LVR_SFO
LAC,2022-12-26,6,Mon,15,16,@,IND,W 20-3,6,60,2,11,8,71,2022,2022_16_LAC_IND
DEN,2022-12-25,6,Sun,15,16,@,LAR,L 14-51,6,55,3,6,9,61,2022,2022_16_DEN_LAR
ARI,2022-12-25,6,Sun,15,16,,TAM,L 16-19 (OT),6,74,5,30,11,104,2022,2022_16_ARI_TAM
SEA,2022-12-24,6,Sat,15,16,@,KAN,L 10-24,6,35,5,39,11,74,2022,2022_16_SEA_KAN
WAS,2022-12-24,6,Sat,15,16,@,SFO,L 20-37,6,51,4,25,10,76,2022,2022_16_WAS_SFO
NOR,2022-12-18,6,Sun,14,15,,ATL,W 21-18,6,46,3,30,9,76,2022,2022_15_NOR_ATL
WAS,2022-12-18,6,Sun,14,15,,NYG,L 12-20,6,40,5,30,11,70,2022,2022_15_WAS_NYG
DET,2022-12-18,6,Sun,14,15,@,NYJ,W 20-17,6,52,2,20,8,72,2022,2022_15_DET_NYJ
CHI,2022-12-18,6,Sun,14,15,,PHI,L 20-25,6,30,2,25,8,55,2022,2022_15_CHI_PHI
NWE,2022-12-18,6,Sun,14,15,@,LVR,L 24-30,6,30,13,90,19,120,2022,2022_15_NWE_LVR
TEN,2022-12-18,6,Sun,14,15,@,LAC,L 14-17,6,62,3,20,9,82,2022,2022_15_TEN_LAC
DEN,2022-12-11,6,Sun,13,14,,KAN,L 28-34,6,38,4,70,10,108,2022,2022_14_DEN_KAN
LAC,2022-12-11,6,Sun,13,14,,MIA,W 23-17,6,40,6,50,12,90,2022,2022_14_LAC_MIA
MIA,2022-12-11,6,Sun,13,14,@,LAC,L 17-23,6,50,6,40,12,90,2022,2022_14_MIA_LAC
CAR,2022-12-11,6,Sun,13,14,@,SEA,W 30-24,6,29,3,35,9,64,2022,2022_14_CAR_SEA
NOR,2022-12-05,6,Mon,13,13,@,TAM,L 16-17,6,84,4,39,10,123,2022,2022_13_NOR_TAM
IND,2022-12-04,6,Sun,13,13,@,DAL,L 19-54,6,88,3,43,9,131,2022,2022_13_IND_DAL
CLE,2022-12-04,6,Sun,12,13,@,HOU,W 27-14,6,56,5,31,11,87,2022,2022_13_CLE_HOU
CIN,2022-12-04,6,Sun,12,13,,KAN,W 27-24,6,65,4,35,10,100,2022,2022_13_CIN_KAN
NYJ,2022-12-04,6,Sun,12,13,@,MIN,L 22-27,6,40,3,44,9,84,2022,2022_13_NYJ_MIN
ATL,2022-12-04,6,Sun,13,13,,PIT,L 16-19,6,48,7,30,13,78,2022,2022_13_ATL_PIT
SEA,2022-12-04,6,Sun,12,13,@,LAR,W 27-23,6,42,4,39,10,81,2022,2022_13_SEA_LAR
NWE,2022-12-01,6,Thu,12,13,,BUF,L 10-24,6,62,6,47,12,109,2022,2022_13_NWE_BUF
BUF,2022-12-01,6,Thu,12,13,@,NWE,W 24-10,6,47,6,62,12,109,2022,2022_13_BUF_NWE
NOR,2022-11-27,6,Sun,12,12,@,SFO,L 0-13,6,46,7,64,13,110,2022,2022_12_NOR_SFO
NWE,2022-11-24,6,Thu,11,12,@,MIN,L 26-33,6,55,3,20,9,75,2022,2022_12_NWE_MIN
CLE,2022-11-20,6,Sun,10,11,@,BUF,L 23-31,6,42,8,89,14,131,2022,2022_11_CLE_BUF
DAL,2022-11-20,6,Sun,10,11,@,MIN,W 40-3,6,39,7,59,13,98,2022,2022_11_DAL_MIN
LAR,2022-11-20,6,Sun,10,11,@,NOR,L 20-27,6,55,2,15,8,70,2022,2022_11_LAR_NOR
CIN,2022-11-20,6,Sun,10,11,@,PIT,W 37-30,6,44,8,70,14,114,2022,2022_11_CIN_PIT
GNB,2022-11-13,6,Sun,10,10,,DAL,W 31-28 (OT),6,40,9,83,15,123,2022,2022_10_GNB_DAL
CLE,2022-11-13,6,Sun,9,10,@,MIA,L 17-39,6,52,5,43,11,95,2022,2022_10_CLE_MIA
SEA,2022-11-13,6,Sun,10,10,@,TAM,L 16-21,6,46,4,40,10,86,2022,2022_10_SEA_TAM
SEA,2022-11-06,6,Sun,9,9,@,ARI,W 31-21,6,34,12,77,18,111,2022,2022_09_SEA_ARI
CLE,2022-10-31,6,Mon,8,8,,CIN,W 32-13,6,56,2,6,8,62,2022,2022_08_CLE_CIN
DAL,2022-10-30,6,Sun,8,8,,CHI,W 49-29,6,41,6,45,12,86,2022,2022_08_DAL_CHI
CHI,2022-10-30,6,Sun,8,8,@,DAL,L 29-49,6,45,6,41,12,86,2022,2022_08_CHI_DAL
TEN,2022-10-30,6,Sun,7,8,@,HOU,W 17-10,6,35,6,45,12,80,2022,2022_08_TEN_HOU
DET,2022-10-30,6,Sun,7,8,,MIA,L 27-31,6,30,7,55,13,85,2022,2022_08_DET_MIA
LVR,2022-10-30,6,Sun,7,8,@,NOR,L 0-24,6,59,5,27,11,86,2022,2022_08_LVR_NOR
NWE,2022-10-30,6,Sun,8,8,@,NYJ,W 22-17,6,54,4,41,10,95,2022,2022_08_NWE_NYJ
HOU,2022-10-30,6,Sun,7,8,,TEN,L 10-17,6,45,6,35,12,80,2022,2022_08_HOU_TEN
NYG,2022-10-30,6,Sun,8,8,@,SEA,L 13-27,6,53,3,25,9,78,2022,2022_08_NYG_SEA
CLE,2022-10-23,6,Sun,7,7,@,BAL,L 20-23,6,45,3,53,9,98,2022,2022_07_CLE_BAL
SEA,2022-10-16,6,Sun,6,6,,ARI,W 19-9,6,44,6,53,12,97,2022,2022_06_SEA_ARI
TAM,2022-10-16,6,Sun,6,6,@,PIT,L 18-20,6,42,7,45,13,87,2022,2022_06_TAM_PIT
ARI,2022-10-16,6,Sun,6,6,@,SEA,L 9-19,6,53,6,44,12,97,2022,2022_06_ARI_SEA
TAM,2022-10-09,6,Sun,5,5,,ATL,W 21-15,6,45,6,55,12,100,2022,2022_05_TAM_ATL
PIT,2022-10-09,6,Sun,5,5,@,BUF,L 3-38,6,54,5,28,11,82,2022,2022_05_PIT_BUF
BAL,2022-10-09,6,Sun,5,5,,CIN,W 19-17,6,48,4,20,10,68,2022,2022_05_BAL_CIN
NWE,2022-10-09,6,Sun,5,5,,DET,W 29-0,6,46,7,82,13,128,2022,2022_05_NWE_DET
NYG,2022-10-09,6,Sun,5,5,@,GNB,W 27-22,6,63,7,37,13,100,2022,2022_05_NYG_GNB
JAX,2022-10-09,6,Sun,5,5,,HOU,L 6-13,6,48,4,25,10,73,2022,2022_05_JAX_HOU
CHI,2022-10-09,6,Sun,5,5,@,MIN,L 22-29,6,40,7,70,13,110,2022,2022_05_CHI_MIN
CLE,2022-10-09,6,Sun,5,5,,LAC,L 28-30,6,65,4,17,10,82,2022,2022_05_CLE_LAC
NOR,2022-10-09,6,Sun,5,5,,SEA,W 39-32,6,57,12,85,18,142,2022,2022_05_NOR_SEA
ATL,2022-10-09,6,Sun,5,5,@,TAM,L 15-21,6,55,6,45,12,100,2022,2022_05_ATL_TAM
TEN,2022-10-02,6,Sun,4,4,@,IND,W 24-17,6,40,7,50,13,90,2022,2022_04_TEN_IND
CAR,2022-10-02,6,Sun,4,4,,ARI,L 16-26,6,76,7,61,13,137,2022,2022_04_CAR_ARI
LAC,2022-10-02,6,Sun,4,4,@,HOU,W 34-24,6,61,9,67,15,128,2022,2022_04_LAC_HOU
MIA,2022-09-29,6,Thu,4,4,@,CIN,L 15-27,6,41,6,74,12,115,2022,2022_04_MIA_CIN
CIN,2022-09-29,6,Thu,4,4,,MIA,W 27-15,6,74,6,41,12,115,2022,2022_04_CIN_MIA
SEA,2022-09-25,6,Sun,3,3,,ATL,L 23-27,6,47,2,15,8,62,2022,2022_03_SEA_ATL
KAN,2022-09-25,6,Sun,3,3,@,IND,L 17-20,6,45,4,34,10,79,2022,2022_03_KAN_IND
LAR,2022-09-25,6,Sun,3,3,@,ARI,W 20-12,6,35,6,50,12,85,2022,2022_03_LAR_ARI
TAM,2022-09-25,6,Sun,3,3,,GNB,L 12-14,6,40,8,65,14,105,2022,2022_03_TAM_GNB
CHI,2022-09-25,6,Sun,3,3,,HOU,W 23-20,6,32,3,25,9,57,2022,2022_03_CHI_HOU
LVR,2022-09-25,6,Sun,3,3,@,TEN,L 22-24,6,44,7,85,13,129,2022,2022_03_LVR_TEN
ARI,2022-09-25,6,Sun,3,3,,LAR,L 12-20,6,50,6,35,12,85,2022,2022_03_ARI_LAR
KAN,2022-09-15,6,Thu,2,2,,LAC,W 27-24,6,54,3,25,9,79,2022,2022_02_KAN_LAC
HOU,2022-09-11,6,Sun,1,1,,IND,T 20-20 (OT),6,40,7,89,13,129,2022,2022_01_HOU_IND
WAS,2022-09-11,6,Sun,1,1,,JAX,W 28-22,6,63,13,90,19,153,2022,2022_01_WAS_JAX
NYJ,2022-09-11,6,Sun,1,1,,BAL,L 9-24,6,81,5,29,11,110,2022,2022_01_NYJ_BAL
SFO,2022-01-09,6,Sun,17,18,@,LAR,W 27-24 (OT),6,56,3,15,9,71,2021,2021_18_SFO_LAR
PIT,2022-01-09,6,Sun,17,18,@,BAL,W 16-13 (OT),6,43,1,5,7,48,2021,2021_18_PIT_BAL
ARI,2022-01-09,6,Sun,17,18,,SEA,L 30-38,6,46,4,30,10,76,2021,2021_18_ARI_SEA
JAX,2022-01-09,6,Sun,17,18,,IND,W 26-11,6,49,4,52,10,101,2021,2021_18_JAX_IND
DEN,2022-01-08,6,Sat,17,18,,KAN,L 24-28,6,45,5,45,11,90,2021,2021_18_DEN_KAN
LVR,2022-01-02,6,Sun,16,17,@,IND,W 23-20,6,41,3,25,9,66,2021,2021_17_LVR_IND
TEN,2022-01-02,6,Sun,16,17,,MIA,W 34-3,6,70,5,55,11,125,2021,2021_17_TEN_MIA
PHI,2022-01-02,6,Sun,16,17,@,WAS,W 20-16,6,42,1,4,7,46,2021,2021_17_PHI_WAS
NYG,2021-12-26,6,Sun,15,16,@,PHI,L 10-34,6,40,11,79,17,119,2021,2021_16_NYG_PHI
CAR,2021-12-26,6,Sun,15,16,,TAM,L 6-32,6,32,6,50,12,82,2021,2021_16_CAR_TAM
DET,2021-12-26,6,Sun,15,16,@,ATL,L 16-20,6,30,2,15,8,45,2021,2021_16_DET_ATL
TAM,2021-12-26,6,Sun,15,16,@,CAR,W 32-6,6,50,6,32,12,82,2021,2021_16_TAM_CAR
BAL,2021-12-26,6,Sun,15,16,@,CIN,L 21-41,6,27,5,45,11,72,2021,2021_16_BAL_CIN
CLE,2021-12-25,6,Sat,15,16,@,GNB,L 22-24,6,38,3,29,9,67,2021,2021_16_CLE_GNB
TEN,2021-12-23,6,Thu,15,16,,SFO,W 20-17,6,57,5,41,11,98,2021,2021_16_TEN_SFO
NOR,2021-12-19,6,Sun,14,15,@,TAM,W 9-0,6,41,3,30,9,71,2021,2021_15_NOR_TAM
DEN,2021-12-19,6,Sun,14,15,,CIN,L 10-15,6,60,6,38,12,98,2021,2021_15_DEN_CIN
DET,2021-12-19,6,Sun,14,15,,ARI,W 30-12,6,49,7,83,13,132,2021,2021_15_DET_ARI
NYG,2021-12-19,6,Sun,14,15,,DAL,L 6-21,6,34,6,45,12,79,2021,2021_15_NYG_DAL
CIN,2021-12-19,6,Sun,14,15,@,DEN,W 15-10,6,38,6,60,12,98,2021,2021_15_CIN_DEN
DAL,2021-12-19,6,Sun,14,15,@,NYG,W 21-6,6,45,6,34,12,79,2021,2021_15_DAL_NYG
CAR,2021-12-12,6,Sun,13,14,,ATL,L 21-29,6,45,6,60,12,105,2021,2021_14_CAR_ATL
ATL,2021-12-12,6,Sun,13,14,@,CAR,W 29-21,6,60,6,45,12,105,2021,2021_14_ATL_CAR
SFO,2021-12-12,6,Sun,13,14,@,CIN,W 26-23 (OT),6,40,2,19,8,59,2021,2021_14_SFO_CIN
DET,2021-12-12,6,Sun,13,14,@,DEN,L 10-38,6,53,2,18,8,71,2021,2021_14_DET_DEN
LAC,2021-12-12,6,Sun,13,14,,NYG,W 37-21,6,39,3,20,9,59,2021,2021_14_LAC_NYG
HOU,2021-12-12,6,Sun,13,14,,SEA,L 13-33,6,52,8,69,14,121,2021,2021_14_HOU_SEA
NWE,2021-12-06,6,Mon,13,13,@,BUF,W 14-10,6,47,3,20,9,67,2021,2021_13_NWE_BUF
CHI,2021-12-05,6,Sun,12,13,,ARI,L 22-33,6,45,8,63,14,108,2021,2021_13_CHI_ARI
NYJ,2021-12-05,6,Sun,12,13,,PHI,L 18-33,6,66,3,20,9,86,2021,2021_13_NYJ_PHI
WAS,2021-12-05,6,Sun,12,13,@,LVR,W 17-15,6,47,6,54,12,101,2021,2021_13_WAS_LVR
SEA,2021-12-05,6,Sun,12,13,,SFO,W 30-23,6,40,10,86,16,126,2021,2021_13_SEA_SFO
ATL,2021-12-05,6,Sun,12,13,,TAM,L 17-30,6,39,3,15,9,54,2021,2021_13_ATL_TAM
LVR,2021-12-05,6,Sun,12,13,,WAS,L 15-17,6,54,6,47,12,101,2021,2021_13_LVR_WAS
SEA,2021-11-29,6,Mon,11,12,@,WAS,L 15-17,6,51,4,38,10,89,2021,2021_12_SEA_WAS
IND,2021-11-28,6,Sun,12,12,,TAM,L 31-38,6,66,4,44,10,110,2021,2021_12_IND_TAM
JAX,2021-11-28,6,Sun,11,12,,ATL,L 14-21,6,43,5,26,11,69,2021,2021_12_JAX_ATL
TAM,2021-11-22,6,Mon,10,11,,NYG,W 30-10,6,39,4,30,10,69,2021,2021_11_TAM_NYG
BAL,2021-11-21,6,Sun,10,11,@,CHI,W 16-13,6,36,6,58,12,94,2021,2021_11_BAL_CHI
KAN,2021-11-21,6,Sun,11,11,,DAL,W 19-9,6,64,6,45,12,109,2021,2021_11_KAN_DAL
DAL,2021-11-21,6,Sun,10,11,@,KAN,L 9-19,6,45,6,64,12,109,2021,2021_11_DAL_KAN
PHI,2021-11-21,6,Sun,11,11,,NOR,W 40-29,6,49,3,25,9,74,2021,2021_11_PHI_NOR
CHI,2021-11-21,6,Sun,10,11,,BAL,L 13-16,6,58,6,36,12,94,2021,2021_11_CHI_BAL
TAM,2021-11-14,6,Sun,9,10,@,WAS,L 19-29,6,43,3,33,9,76,2021,2021_10_TAM_WAS
NWE,2021-11-14,6,Sun,10,10,,CLE,W 45-7,6,46,6,42,12,88,2021,2021_10_NWE_CLE
ATL,2021-11-14,6,Sun,9,10,@,DAL,L 3-43,6,41,8,80,14,121,2021,2021_10_ATL_DAL
CLE,2021-11-14,6,Sun,10,10,@,NWE,L 7-45,6,42,6,46,12,88,2021,2021_10_CLE_NWE
NWE,2021-11-07,6,Sun,9,9,@,CAR,W 24-6,6,35,10,83,16,118,2021,2021_09_NWE_CAR
KAN,2021-11-07,6,Sun,9,9,,GNB,W 13-7,6,33,4,19,10,52,2021,2021_09_KAN_GNB
ATL,2021-11-07,6,Sun,8,9,@,NOR,W 27-25,6,76,10,74,16,150,2021,2021_09_ATL_NOR
LVR,2021-11-07,6,Sun,8,9,@,NYG,L 16-23,6,65,4,35,10,100,2021,2021_09_LVR_NYG
HOU,2021-10-31,6,Sun,8,8,,LAR,L 22-38,6,38,3,20,9,58,2021,2021_08_HOU_LAR
SEA,2021-10-25,6,Mon,7,7,,NOR,L 10-13,6,53,7,90,13,143,2021,2021_07_SEA_NOR
MIA,2021-10-24,6,Sun,7,7,,ATL,L 28-30,6,44,3,29,9,73,2021,2021_07_MIA_ATL
TEN,2021-10-24,6,Sun,7,7,,KAN,W 27-3,6,31,9,77,15,108,2021,2021_07_TEN_KAN
NWE,2021-10-24,6,Sun,7,7,,NYJ,W 54-13,6,95,5,29,11,124,2021,2021_07_NWE_NYJ
IND,2021-10-24,6,Sun,7,7,@,SFO,W 30-18,6,45,7,122,13,167,2021,2021_07_IND_SFO
SEA,2021-10-17,6,Sun,6,6,@,PIT,L 20-23 (OT),6,45,5,38,11,83,2021,2021_06_SEA_PIT
DEN,2021-10-17,6,Sun,6,6,,LVR,L 24-34,6,53,6,54,12,107,2021,2021_06_DEN_LVR
LVR,2021-10-17,6,Sun,6,6,@,DEN,W 34-24,6,54,6,53,12,107,2021,2021_06_LVR_DEN
WAS,2021-10-17,6,Sun,6,6,,KAN,L 13-31,6,44,5,47,11,91,2021,2021_06_WAS_KAN
CAR,2021-10-17,6,Sun,6,6,,MIN,L 28-34 (OT),6,28,11,98,17,126,2021,2021_06_CAR_MIN
PHI,2021-10-10,6,Sun,5,5,@,CAR,W 21-18,6,60,9,69,15,129,2021,2021_05_PHI_CAR
LAC,2021-10-10,6,Sun,5,5,,CLE,W 47-42,6,49,7,77,13,126,2021,2021_05_LAC_CLE
TAM,2021-10-10,6,Sun,5,5,,MIA,W 45-17,6,47,5,37,11,84,2021,2021_05_TAM_MIA
ARI,2021-10-10,6,Sun,5,5,,SFO,W 17-10,6,62,7,60,13,122,2021,2021_05_ARI_SFO
NOR,2021-10-10,6,Sun,5,5,@,WAS,W 33-22,6,45,5,37,11,82,2021,2021_05_NOR_WAS
NYJ,2021-10-03,6,Sun,4,4,,TEN,W 27-24 (OT),6,65,8,98,14,163,2021,2021_04_NYJ_TEN
WAS,2021-10-03,6,Sun,4,4,@,ATL,W 34-30,6,85,7,36,13,121,2021,2021_04_WAS_ATL
CAR,2021-10-03,6,Sun,4,4,@,DAL,L 28-36,6,32,7,50,13,82,2021,2021_04_CAR_DAL
BAL,2021-10-03,6,Sun,4,4,@,DEN,W 23-7,6,55,4,25,10,80,2021,2021_04_BAL_DEN
CIN,2021-09-30,6,Thu,4,4,,JAX,W 24-21,6,38,2,10,8,48,2021,2021_04_CIN_JAX
BAL,2021-09-26,6,Sun,3,3,@,DET,W 19-17,6,69,7,35,13,104,2021,2021_03_BAL_DET
DEN,2021-09-26,6,Sun,3,3,,NYJ,W 26-0,6,50,9,90,15,140,2021,2021_03_DEN_NYJ
KAN,2021-09-26,6,Sun,3,3,,LAC,L 24-30,6,56,8,50,14,106,2021,2021_03_KAN_LAC
ATL,2021-09-19,6,Sun,2,2,@,TAM,L 25-48,6,49,9,83,15,132,2021,2021_02_ATL_TAM
BUF,2021-09-19,6,Sun,2,2,@,MIA,W 35-0,6,53,9,83,15,136,2021,2021_02_BUF_MIA
NWE,2021-09-19,6,Sun,2,2,@,NYJ,W 25-6,6,54,8,77,14,131,2021,2021_02_NWE_NYJ
NOR,2021-09-12,6,Sun,1,1,,GNB,W 38-3,6,36,5,33,11,69,2021,2021_01_NOR_GNB
CAR,2021-09-12,6,Sun,1,1,,NYJ,W 19-14,6,38,5,30,11,68,2021,2021_01_CAR_NYJ
LAC,2021-09-12,6,Sun,1,1,@,WAS,W 20-16,6,94,8,57,14,151,2021,2021_01_LAC_WAS
BAL,2021-01-03,6,Sun,16,17,@,CIN,W 38-3,6,49,3,29,9,78,2020,2020_17_BAL_CIN
NYG,2021-01-03,6,Sun,16,17,,DAL,W 23-19,6,45,6,58,12,103,2020,2020_17_NYG_DAL
TEN,2021-01-03,6,Sun,16,17,@,HOU,W 41-38,6,50,6,44,12,94,2020,2020_17_TEN_HOU
DAL,2021-01-03,6,Sun,16,17,@,NYG,L 19-23,6,58,6,45,12,103,2020,2020_17_DAL_NYG
NWE,2021-01-03,6,Sun,16,17,,NYJ,W 28-14,6,47,3,30,9,77,2020,2020_17_NWE_NYJ
HOU,2021-01-03,6,Sun,16,17,,TEN,L 38-41,6,44,6,50,12,94,2020,2020_17_HOU_TEN
ARI,2021-01-03,6,Sun,16,17,@,LAR,L 7-18,6,38,5,38,11,76,2020,2020_17_ARI_LAR
PHI,2021-01-03,6,Sun,16,17,,WAS,L 14-20,6,41,5,56,11,97,2020,2020_17_PHI_WAS
KAN,2020-12-27,6,Sun,15,16,,ATL,W 17-14,6,41,7,45,13,86,2020,2020_16_KAN_ATL
HOU,2020-12-27,6,Sun,15,16,,CIN,L 31-37,6,46,5,35,11,81,2020,2020_16_HOU_CIN
PIT,2020-12-27,6,Sun,15,16,,IND,W 28-24,6,49,9,83,15,132,2020,2020_16_PIT_IND
LAC,2020-12-27,6,Sun,15,16,,DEN,W 19-16,6,45,6,44,12,89,2020,2020_16_LAC_DEN
CLE,2020-12-27,6,Sun,15,16,@,NYJ,L 16-23,6,51,7,58,13,109,2020,2020_16_CLE_NYJ
DEN,2020-12-27,6,Sun,15,16,@,LAC,L 16-19,6,44,6,45,12,89,2020,2020_16_DEN_LAC
CLE,2020-12-20,6,Sun,14,15,@,NYG,W 20-6,6,60,2,25,8,85,2020,2020_15_CLE_NYG
NYJ,2020-12-20,6,Sun,14,15,@,LAR,W 23-20,6,61,5,43,11,104,2020,2020_15_NYJ_LAR
WAS,2020-12-20,6,Sun,14,15,,SEA,L 15-20,6,41,4,45,10,86,2020,2020_15_WAS_SEA
LVR,2020-12-17,6,Thu,14,15,,LAC,L 27-30 (OT),6,69,3,20,9,89,2020,2020_15_LVR_LAC
LAC,2020-12-13,6,Sun,13,14,,ATL,W 20-17,6,40,4,35,10,75,2020,2020_14_LAC_ATL
HOU,2020-12-13,6,Sun,13,14,@,CHI,L 7-36,6,50,7,44,13,94,2020,2020_14_HOU_CHI
LVR,2020-12-13,6,Sun,13,14,,IND,L 27-44,6,33,6,50,12,83,2020,2020_14_LVR_IND
PHI,2020-12-13,6,Sun,13,14,,NOR,W 24-21,6,27,8,52,14,79,2020,2020_14_PHI_NOR
IND,2020-12-13,6,Sun,13,14,@,LVR,W 44-27,6,50,6,33,12,83,2020,2020_14_IND_LVR
PIT,2020-12-07,6,Mon,12,13,,WAS,L 17-23,6,45,9,62,15,107,2020,2020_13_PIT_WAS
LAR,2020-12-06,6,Sun,12,13,@,ARI,W 38-28,6,75,5,21,11,96,2020,2020_13_LAR_ARI
MIN,2020-12-06,6,Sun,12,13,,JAX,W 27-24 (OT),6,41,10,83,16,124,2020,2020_13_MIN_JAX
CIN,2020-12-06,6,Sun,12,13,@,MIA,L 7-19,6,62,8,54,14,116,2020,2020_13_CIN_MIA
SEA,2020-12-06,6,Sun,12,13,,NYG,L 12-17,6,41,6,35,12,76,2020,2020_13_SEA_NYG
NYJ,2020-12-06,6,Sun,12,13,,LVR,L 28-31,6,40,3,21,9,61,2020,2020_13_NYJ_LVR
NYG,2020-12-06,6,Sun,12,13,@,SEA,W 17-12,6,35,6,41,12,76,2020,2020_13_NYG_SEA
NWE,2020-11-29,6,Sun,11,12,,ARI,W 20-17,6,42,6,50,12,92,2020,2020_12_NWE_ARI
CLE,2020-11-29,6,Sun,11,12,@,JAX,W 27-25,6,47,5,24,11,71,2020,2020_12_CLE_JAX
NYJ,2020-11-29,6,Sun,11,12,,MIA,L 3-20,6,74,3,20,9,94,2020,2020_12_NYJ_MIA
ARI,2020-11-29,6,Sun,11,12,@,NWE,L 17-20,6,50,6,42,12,92,2020,2020_12_ARI_NWE
IND,2020-11-29,6,Sun,11,12,,TEN,L 26-45,6,50,9,63,15,113,2020,2020_12_IND_TEN
ATL,2020-11-29,6,Sun,11,12,,LVR,W 43-6,6,49,11,141,17,190,2020,2020_12_ATL_LVR
WAS,2020-11-22,6,Sun,10,11,,CIN,W 20-9,6,49,3,31,9,80,2020,2020_11_WAS_CIN
PIT,2020-11-22,6,Sun,10,11,@,JAX,W 27-3,6,42,8,105,14,147,2020,2020_11_PIT_JAX
BAL,2020-11-22,6,Sun,10,11,,TEN,L 24-30 (OT),6,81,4,44,10,125,2020,2020_11_BAL_TEN
PIT,2020-11-15,6,Sun,9,10,,CIN,W 36-10,6,45,6,65,12,110,2020,2020_10_PIT_CIN
HOU,2020-11-15,6,Sun,9,10,@,CLE,L 7-10,6,49,6,63,12,112,2020,2020_10_HOU_CLE
WAS,2020-11-15,6,Sun,9,10,@,DET,L 27-30,6,58,9,55,15,113,2020,2020_10_WAS_DET
CLE,2020-11-15,6,Sun,9,10,,HOU,W 10-7,6,63,6,49,12,112,2020,2020_10_CLE_HOU
SFO,2020-11-15,6,Sun,10,10,@,NOR,L 13-27,6,51,5,61,11,112,2020,2020_10_SFO_NOR
CIN,2020-11-15,6,Sun,9,10,@,PIT,L 10-36,6,65,6,45,12,110,2020,2020_10_CIN_PIT
NWE,2020-11-09,6,Mon,8,9,@,NYJ,W 30-27,6,81,4,32,10,113,2020,2020_09_NWE_NYJ
TEN,2020-11-08,6,Sun,8,9,,CHI,W 24-17,6,57,5,35,11,92,2020,2020_09_TEN_CHI
WAS,2020-11-08,6,Sun,8,9,,NYG,L 20-23,6,45,4,40,10,85,2020,2020_09_WAS_NYG
BUF,2020-11-08,6,Sun,9,9,,SEA,W 44-34,6,70,4,13,10,83,2020,2020_09_BUF_SEA
LAC,2020-11-01,6,Sun,7,8,@,DEN,L 30-31,6,67,8,70,14,137,2020,2020_08_LAC_DEN
SFO,2020-11-01,6,Sun,8,8,@,SEA,L 27-37,6,36,6,30,12,66,2020,2020_08_SFO_SEA
SEA,2020-11-01,6,Sun,7,8,,SFO,W 37-27,6,30,6,36,12,66,2020,2020_08_SEA_SFO
CAR,2020-10-29,6,Thu,8,8,,ATL,L 17-25,6,30,6,63,12,93,2020,2020_08_CAR_ATL
ATL,2020-10-29,6,Thu,8,8,@,CAR,W 25-17,6,63,6,30,12,93,2020,2020_08_ATL_CAR
CHI,2020-10-26,6,Mon,7,7,@,LAR,L 10-24,6,46,4,46,10,92,2020,2020_07_CHI_LAR
NYJ,2020-10-25,6,Sun,7,7,,BUF,L 10-18,6,49,11,106,17,155,2020,2020_07_NYJ_BUF
NOR,2020-10-25,6,Sun,6,7,,CAR,W 27-24,6,50,1,5,7,55,2020,2020_07_NOR_CAR
HOU,2020-10-25,6,Sun,7,7,,GNB,L 20-35,6,55,5,40,11,95,2020,2020_07_HOU_GNB
SFO,2020-10-25,6,Sun,7,7,@,NWE,W 33-6,6,65,3,30,9,95,2020,2020_07_SFO_NWE
JAX,2020-10-25,6,Sun,7,7,@,LAC,L 29-39,6,55,3,35,9,90,2020,2020_07_JAX_LAC
ARI,2020-10-25,6,Sun,7,7,,SEA,W 37-34 (OT),6,40,8,78,14,118,2020,2020_07_ARI_SEA
DAL,2020-10-25,6,Sun,7,7,@,WAS,L 3-25,6,49,4,30,10,79,2020,2020_07_DAL_WAS
DAL,2020-10-19,6,Mon,6,6,,ARI,L 10-38,6,36,7,43,13,79,2020,2020_06_DAL_ARI
IND,2020-10-18,6,Sun,6,6,,CIN,W 31-27,6,55,6,20,12,75,2020,2020_06_IND_CIN
PIT,2020-10-18,6,Sun,5,6,,CLE,W 38-7,6,45,7,55,13,100,2020,2020_06_PIT_CLE
CIN,2020-10-18,6,Sun,6,6,@,IND,L 27-31,6,20,6,55,12,75,2020,2020_06_CIN_IND
LAR,2020-10-18,6,Sun,6,6,@,SFO,L 16-24,6,34,7,63,13,97,2020,2020_06_LAR_SFO
GNB,2020-10-18,6,Sun,5,6,@,TAM,L 10-38,6,76,0,0,6,76,2020,2020_06_GNB_TAM
TEN,2020-10-13,6,Tue,4,5,,BUF,W 42-16,6,46,10,56,16,102,2020,2020_05_TEN_BUF
NYJ,2020-10-11,6,Sun,5,5,,ARI,L 10-30,6,30,10,59,16,89,2020,2020_05_NYJ_ARI
MIN,2020-10-11,6,Sun,5,5,@,SEA,L 26-27,6,55,3,25,9,80,2020,2020_05_MIN_SEA
CHI,2020-10-08,6,Thu,5,5,,TAM,W 20-19,6,66,11,109,17,175,2020,2020_05_CHI_TAM
JAX,2020-10-04,6,Sun,4,4,@,CIN,L 25-33,6,49,7,73,13,122,2020,2020_04_JAX_CIN
DAL,2020-10-04,6,Sun,4,4,,CLE,L 38-49,6,65,5,40,11,105,2020,2020_04_DAL_CLE
SFO,2020-10-04,6,Sun,4,4,,PHI,L 20-25,6,42,3,25,9,67,2020,2020_04_SFO_PHI
BAL,2020-09-28,6,Mon,3,3,,KAN,L 20-34,6,45,6,38,12,83,2020,2020_03_BAL_KAN
KAN,2020-09-28,6,Mon,3,3,@,BAL,W 34-20,6,38,6,45,12,83,2020,2020_03_KAN_BAL
LVR,2020-09-27,6,Sun,3,3,@,NWE,L 20-36,6,40,2,33,8,73,2020,2020_03_LVR_NWE
SFO,2020-09-27,6,Sun,3,3,@,NYG,W 36-9,6,45,5,28,11,73,2020,2020_03_SFO_NYG
CLE,2020-09-27,6,Sun,3,3,,WAS,W 34-20,6,50,4,40,10,90,2020,2020_03_CLE_WAS
MIA,2020-09-24,6,Thu,3,3,@,JAX,W 31-13,6,51,8,63,14,114,2020,2020_03_MIA_JAX
MIN,2020-09-20,6,Sun,2,2,@,IND,L 11-28,6,45,9,93,15,138,2020,2020_02_MIN_IND
WAS,2020-09-20,6,Sun,2,2,@,ARI,L 15-30,6,42,11,97,17,139,2020,2020_02_WAS_ARI
LAC,2020-09-20,6,Sun,2,2,,KAN,L 20-23 (OT),6,40,11,90,17,130,2020,2020_02_LAC_KAN
BUF,2020-09-20,6,Sun,2,2,@,MIA,W 31-28,6,55,3,20,9,75,2020,2020_02_BUF_MIA
SEA,2020-09-13,6,Sun,1,1,@,ATL,W 38-25,6,46,6,72,12,118,2020,2020_01_SEA_ATL
LAC,2020-09-13,6,Sun,1,1,@,CIN,W 16-13,6,35,7,44,13,79,2020,2020_01_LAC_CIN
JAX,2020-09-13,6,Sun,1,1,,IND,W 27-20,6,61,5,80,11,141,2020,2020_01_JAX_IND
CHI,2020-09-13,6,Sun,1,1,@,DET,W 27-23,6,48,8,77,14,125,2020,2020_01_CHI_DET
GNB,2020-09-13,6,Sun,1,1,@,MIN,W 43-34,6,63,5,20,11,83,2020,2020_01_GNB_MIN
ATL,2020-09-13,6,Sun,1,1,,SEA,L 25-38,6,72,6,46,12,118,2020,2020_01_ATL_SEA
NOR,2020-09-13,6,Sun,1,1,,TAM,W 34-23,6,119,9,103,15,222,2020,2020_01_NOR_TAM
NWE,2019-12-29,6,Sun,16,17,,MIA,L 24-27,6,54,4,35,10,89,2019,2019_17_NWE_MIA
BAL,2019-12-29,6,Sun,16,17,,PIT,W 28-10,6,35,6,47,12,82,2019,2019_17_BAL_PIT
PIT,2019-12-29,6,Sun,16,17,@,BAL,L 10-28,6,47,6,35,12,82,2019,2019_17_PIT_BAL
TEN,2019-12-22,6,Sun,15,16,,NOR,L 28-38,6,56,11,70,17,126,2019,2019_16_TEN_NOR
WAS,2019-12-22,6,Sun,15,16,,NYG,L 35-41 (OT),6,51,4,33,10,84,2019,2019_16_WAS_NYG
JAX,2019-12-22,6,Sun,15,16,@,ATL,L 12-24,6,36,9,64,15,100,2019,2019_16_JAX_ATL
MIA,2019-12-22,6,Sun,15,16,,CIN,W 38-35 (OT),6,47,10,77,16,124,2019,2019_16_MIA_CIN
CAR,2019-12-22,6,Sun,15,16,@,IND,L 6-38,6,46,0,0,6,46,2019,2019_16_CAR_IND
DEN,2019-12-22,6,Sun,15,16,,DET,W 27-17,6,50,7,68,13,118,2019,2019_16_DEN_DET
TAM,2019-12-21,6,Sat,15,16,,HOU,L 20-23,6,45,4,35,10,80,2019,2019_16_TAM_HOU
NOR,2019-12-16,6,Mon,14,15,,IND,W 34-7,6,52,7,49,13,101,2019,2019_15_NOR_IND
OAK,2019-12-15,6,Sun,14,15,,JAX,L 16-20,6,51,8,87,14,138,2019,2019_15_OAK_JAX
PIT,2019-12-15,6,Sun,14,15,,BUF,L 10-17,6,30,8,70,14,100,2019,2019_15_PIT_BUF
CLE,2019-12-15,6,Sun,14,15,@,ARI,L 24-38,6,55,5,34,11,89,2019,2019_15_CLE_ARI
BAL,2019-12-12,6,Thu,14,15,,NYJ,W 42-21,6,35,8,94,14,129,2019,2019_15_BAL_NYJ
CLE,2019-12-08,6,Sun,13,14,,CIN,W 27-19,6,30,8,99,14,129,2019,2019_14_CLE_CIN
ATL,2019-12-08,6,Sun,13,14,,CAR,W 40-20,6,58,7,44,13,102,2019,2019_14_ATL_CAR
LAC,2019-12-08,6,Sun,13,14,@,JAX,W 45-10,6,65,10,101,16,166,2019,2019_14_LAC_JAX
TAM,2019-12-08,6,Sun,13,14,,IND,W 38-35,6,104,3,35,9,139,2019,2019_14_TAM_IND
DAL,2019-12-05,6,Thu,13,14,@,CHI,L 24-31,6,52,4,30,10,82,2019,2019_14_DAL_CHI
IND,2019-12-01,6,Sun,12,13,,TEN,L 17-31,6,40,3,33,9,73,2019,2019_13_IND_TEN
WAS,2019-12-01,6,Sun,12,13,@,CAR,W 29-21,6,65,5,43,11,108,2019,2019_13_WAS_CAR
SFO,2019-12-01,6,Sun,12,13,@,BAL,L 17-20,6,54,3,23,9,77,2019,2019_13_SFO_BAL
TEN,2019-11-24,6,Sun,11,12,,JAX,W 42-20,6,54,11,104,17,158,2019,2019_12_TEN_JAX
NWE,2019-11-24,6,Sun,11,12,,DAL,W 13-9,6,56,7,50,13,106,2019,2019_12_NWE_DAL
CHI,2019-11-24,6,Sun,11,12,,NYG,W 19-14,6,40,6,35,12,75,2019,2019_12_CHI_NYG
DET,2019-11-24,6,Sun,11,12,@,WAS,L 16-19,6,65,8,63,14,128,2019,2019_12_DET_WAS
NYG,2019-11-24,6,Sun,11,12,@,CHI,L 14-19,6,35,6,40,12,75,2019,2019_12_NYG_CHI
NWE,2019-11-17,6,Sun,10,11,@,PHI,W 17-10,6,89,7,39,13,128,2019,2019_11_NWE_PHI
MIA,2019-11-17,6,Sun,10,11,,BUF,L 20-37,6,44,5,50,11,94,2019,2019_11_MIA_BUF
LAR,2019-11-17,6,Sun,10,11,,CHI,W 17-7,6,34,2,25,8,59,2019,2019_11_LAR_CHI
NYJ,2019-11-17,6,Sun,10,11,@,WAS,W 34-17,6,55,11,66,17,121,2019,2019_11_NYJ_WAS
DEN,2019-11-17,6,Sun,10,11,@,MIN,L 23-27,6,35,5,49,11,84,2019,2019_11_DEN_MIN
DAL,2019-11-17,6,Sun,10,11,@,DET,W 35-27,6,45,11,89,17,134,2019,2019_11_DAL_DET
PIT,2019-11-14,6,Thu,10,11,@,CLE,L 7-21,6,41,8,121,14,162,2019,2019_11_PIT_CLE
NYG,2019-11-10,6,Sun,10,10,@,NYJ,L 27-34,6,62,7,54,13,116,2019,2019_10_NYG_NYJ
MIA,2019-11-03,6,Sun,8,9,,NYJ,W 26-18,6,51,10,105,16,156,2019,2019_09_MIA_NYJ
CAR,2019-11-03,6,Sun,8,9,,TEN,W 30-20,6,77,11,99,17,176,2019,2019_09_CAR_TEN
TEN,2019-10-27,6,Sun,8,8,,TAM,W 27-23,6,77,9,87,15,164,2019,2019_08_TEN_TAM
CIN,2019-10-27,6,Sun,8,8,@,LAR,L 10-24,6,40,9,59,15,99,2019,2019_08_CIN_LAR
IND,2019-10-20,6,Sun,6,7,,HOU,W 30-23,6,45,10,54,16,99,2019,2019_07_IND_HOU
CIN,2019-10-20,6,Sun,7,7,,JAX,L 17-27,6,50,11,130,17,180,2019,2019_07_CIN_JAX
MIN,2019-10-20,6,Sun,7,7,@,DET,W 42-30,6,60,8,67,14,127,2019,2019_07_MIN_DET
DAL,2019-10-20,6,Sun,7,7,,PHI,W 37-10,6,65,5,40,11,105,2019,2019_07_DAL_PHI
MIA,2019-10-20,6,Sun,6,7,@,BUF,L 21-31,6,55,9,83,15,138,2019,2019_07_MIA_BUF
NYG,2019-10-20,6,Sun,7,7,,ARI,L 21-27,6,75,10,85,16,160,2019,2019_07_NYG_ARI
KAN,2019-10-17,6,Thu,7,7,@,DEN,W 30-6,6,46,4,33,10,79,2019,2019_07_KAN_DEN
GNB,2019-10-14,6,Mon,6,6,,DET,W 23-22,6,48,8,50,14,98,2019,2019_06_GNB_DET
PIT,2019-10-13,6,Sun,6,6,@,LAC,W 24-17,6,45,8,74,14,119,2019,2019_06_PIT_LAC
TEN,2019-10-13,6,Sun,6,6,@,DEN,L 0-16,6,40,8,51,14,91,2019,2019_06_TEN_DEN
WAS,2019-10-13,6,Sun,6,6,@,MIA,W 17-16,6,56,5,45,11,101,2019,2019_06_WAS_MIA
NOR,2019-10-06,6,Sun,5,5,,TAM,W 31-24,6,40,4,30,10,70,2019,2019_05_NOR_TAM
OAK,2019-10-06,6,Sun,5,5,,CHI,W 24-21,6,69,10,75,16,144,2019,2019_05_OAK_CHI
WAS,2019-10-06,6,Sun,5,5,,NWE,L 7-33,6,72,7,55,13,127,2019,2019_05_WAS_NWE
LAR,2019-10-03,6,Thu,5,5,@,SEA,L 29-30,6,45,5,45,11,90,2019,2019_05_LAR_SEA
DAL,2019-09-29,6,Sun,4,4,@,NOR,L 10-12,6,64,9,80,15,144,2019,2019_04_DAL_NOR
CAR,2019-09-29,6,Sun,4,4,@,HOU,W 16-10,6,35,7,81,13,116,2019,2019_04_CAR_HOU
CLE,2019-09-29,6,Sun,4,4,@,BAL,W 40-25,6,41,3,15,9,56,2019,2019_04_CLE_BAL
HOU,2019-09-22,6,Sun,3,3,@,LAC,W 27-20,6,65,7,69,13,134,2019,2019_03_HOU_LAC
MIN,2019-09-22,6,Sun,3,3,,OAK,W 34-14,6,59,7,84,13,143,2019,2019_03_MIN_OAK
NYG,2019-09-22,6,Sun,3,3,@,TAM,W 32-31,6,59,4,30,10,89,2019,2019_03_NYG_TAM
PIT,2019-09-22,6,Sun,3,3,@,SFO,L 20-24,6,42,5,71,11,113,2019,2019_03_PIT_SFO
WAS,2019-09-15,6,Sun,2,2,,DAL,L 21-31,6,44,8,67,14,111,2019,2019_02_WAS_DAL
GNB,2019-09-15,6,Sun,2,2,,MIN,W 21-16,6,35,8,100,14,135,2019,2019_02_GNB_MIN
DEN,2019-09-09,6,Mon,1,1,@,OAK,L 16-24,6,44,9,62,15,106,2019,2019_01_DEN_OAK
CAR,2019-09-08,6,Sun,1,1,,LAR,L 27-30,6,46,5,43,11,89,2019,2019_01_CAR_LAR
PIT,2019-09-08,6,Sun,1,1,@,NWE,L 3-33,6,54,7,55,13,109,2019,2019_01_PIT_NWE
TEN,2019-09-08,6,Sun,1,1,@,CLE,W 43-13,6,54,18,182,24,236,2019,2019_01_TEN_CLE
DAL,2019-09-08,6,Sun,1,1,,NYG,W 35-17,6,47,8,70,14,117,2019,2019_01_DAL_NYG
PHI,2019-09-08,6,Sun,1,1,,WAS,W 32-27,6,55,12,96,18,151,2019,2019_01_PHI_WAS
DAL,2018-12-30,6,Sun,16,17,@,NYG,W 36-35,6,46,11,78,17,124,2018,2018_17_DAL_NYG
LAC,2018-12-30,6,Sun,16,17,@,DEN,W 23-9,6,51,11,99,17,150,2018,2018_17_LAC_DEN
LAR,2018-12-30,6,Sun,16,17,,SFO,W 48-32,6,57,5,41,11,98,2018,2018_17_LAR_SFO
NOR,2018-12-30,6,Sun,16,17,,CAR,L 14-33,6,94,2,10,8,104,2018,2018_17_NOR_CAR
OAK,2018-12-24,6,Mon,15,16,,DEN,W 27-14,6,50,11,91,17,141,2018,2018_16_OAK_DEN
IND,2018-12-23,6,Sun,15,16,,NYG,W 28-27,6,29,6,24,12,53,2018,2018_16_IND_NYG
NYG,2018-12-23,6,Sun,15,16,@,IND,L 27-28,6,24,6,29,12,53,2018,2018_16_NYG_IND
LAR,2018-12-23,6,Sun,15,16,@,ARI,W 31-9,6,66,7,54,13,120,2018,2018_16_LAR_ARI
SFO,2018-12-23,6,Sun,15,16,,CHI,L 9-14,6,45,4,30,10,75,2018,2018_16_SFO_CHI
CLE,2018-12-23,6,Sun,15,16,,CIN,W 26-18,6,57,3,15,9,72,2018,2018_16_CLE_CIN
PIT,2018-12-23,6,Sun,15,16,@,NOR,L 28-31,6,79,9,91,15,170,2018,2018_16_PIT_NOR
TAM,2018-12-16,6,Sun,14,15,@,BAL,L 12-20,6,58,8,70,14,128,2018,2018_15_TAM_BAL
MIN,2018-12-16,6,Sun,14,15,,MIA,W 41-17,6,45,8,49,14,94,2018,2018_15_MIN_MIA
ATL,2018-12-16,6,Sun,14,15,,ARI,W 40-14,6,50,8,75,14,125,2018,2018_15_ATL_ARI
PHI,2018-12-16,6,Sun,14,15,@,LAR,W 30-23,6,49,5,50,11,99,2018,2018_15_PHI_LAR
WAS,2018-12-16,6,Sun,14,15,@,JAX,W 16-13,6,48,8,55,14,103,2018,2018_15_WAS_JAX
IND,2018-12-16,6,Sun,14,15,,DAL,W 23-0,6,55,9,74,15,129,2018,2018_15_IND_DAL
CLE,2018-12-15,6,Sat,14,15,@,DEN,W 17-16,6,75,8,51,14,126,2018,2018_15_CLE_DEN
CIN,2018-12-09,6,Sun,13,14,@,LAC,L 21-26,6,34,6,38,12,72,2018,2018_14_CIN_LAC
NOR,2018-12-09,6,Sun,13,14,@,TAM,W 28-14,6,51,10,84,16,135,2018,2018_14_NOR_TAM
LAC,2018-12-09,6,Sun,13,14,,CIN,W 26-21,6,38,6,34,12,72,2018,2018_14_LAC_CIN
CHI,2018-12-09,6,Sun,13,14,,LAR,W 15-6,6,45,9,57,15,102,2018,2018_14_CHI_LAR
GNB,2018-12-09,6,Sun,13,14,,ATL,W 34-20,6,37,13,101,19,138,2018,2018_14_GNB_ATL
CLE,2018-12-02,6,Sun,12,13,@,HOU,L 13-29,6,45,5,77,11,122,2018,2018_13_CLE_HOU
IND,2018-12-02,6,Sun,12,13,@,JAX,L 0-6,6,65,8,74,14,139,2018,2018_13_IND_JAX
BAL,2018-11-25,6,Sun,11,12,,OAK,W 34-17,6,45,4,24,10,69,2018,2018_12_BAL_OAK
MIN,2018-11-25,6,Sun,11,12,,GNB,W 24-17,6,55,4,20,10,75,2018,2018_12_MIN_GNB
DEN,2018-11-25,6,Sun,11,12,,PIT,W 24-17,6,50,5,34,11,84,2018,2018_12_DEN_PIT
PHI,2018-11-18,6,Sun,10,11,@,NOR,L 7-48,6,49,8,69,14,118,2018,2018_11_PHI_NOR
WAS,2018-11-18,6,Sun,10,11,,HOU,L 21-23,6,43,7,40,13,83,2018,2018_11_WAS_HOU
SEA,2018-11-15,6,Thu,10,11,,GNB,W 27-24,6,30,5,80,11,110,2018,2018_11_SEA_GNB
CHI,2018-11-11,6,Sun,9,10,,DET,W 34-22,6,46,6,41,12,87,2018,2018_10_CHI_DET
OAK,2018-11-11,6,Sun,9,10,,LAC,L 6-20,6,55,6,70,12,125,2018,2018_10_OAK_LAC
LAC,2018-11-11,6,Sun,9,10,@,OAK,W 20-6,6,70,6,55,12,125,2018,2018_10_LAC_OAK
GNB,2018-11-11,6,Sun,9,10,,MIA,W 31-12,6,45,3,10,9,55,2018,2018_10_GNB_MIA
DET,2018-11-11,6,Sun,9,10,@,CHI,L 22-34,6,41,6,46,12,87,2018,2018_10_DET_CHI
DAL,2018-11-05,6,Mon,8,9,,TEN,L 14-28,6,52,3,20,9,72,2018,2018_09_DAL_TEN
OAK,2018-11-01,6,Thu,8,9,@,SFO,L 3-34,6,40,3,23,9,63,2018,2018_09_OAK_SFO
BUF,2018-10-29,6,Mon,8,8,,NWE,L 6-25,6,51,5,33,11,84,2018,2018_08_BUF_NWE
MIN,2018-10-28,6,Sun,8,8,,NOR,L 20-30,6,54,7,64,13,118,2018,2018_08_MIN_NOR
NOR,2018-10-21,6,Sun,6,7,@,BAL,W 24-23,6,52,5,54,11,106,2018,2018_07_NOR_BAL
MIN,2018-10-21,6,Sun,7,7,@,NYJ,W 37-17,6,55,8,71,14,126,2018,2018_07_MIN_NYJ
DET,2018-10-21,6,Sun,6,7,@,MIA,W 32-21,6,43,4,50,10,93,2018,2018_07_DET_MIA
HOU,2018-10-21,6,Sun,7,7,@,JAX,W 20-7,6,35,2,15,8,50,2018,2018_07_HOU_JAX
GNB,2018-10-15,6,Mon,6,6,,SFO,W 33-30,6,54,2,10,8,64,2018,2018_06_GNB_SFO
CLE,2018-10-14,6,Sun,6,6,,LAC,L 14-38,6,53,10,72,16,125,2018,2018_06_CLE_LAC
HOU,2018-10-14,6,Sun,6,6,,BUF,W 20-13,6,50,12,104,18,154,2018,2018_06_HOU_BUF
CHI,2018-10-14,6,Sun,5,6,@,MIA,L 28-31 (OT),6,58,7,67,13,125,2018,2018_06_CHI_MIA
DEN,2018-10-14,6,Sun,6,6,,LAR,L 20-23,6,61,10,81,16,142,2018,2018_06_DEN_LAR
CIN,2018-10-14,6,Sun,6,6,,PIT,L 21-28,6,30,9,69,15,99,2018,2018_06_CIN_PIT
WAS,2018-10-08,6,Mon,4,5,@,NOR,L 19-43,6,38,4,45,10,83,2018,2018_05_WAS_NOR
DEN,2018-10-07,6,Sun,5,5,@,NYJ,L 16-34,6,45,4,33,10,78,2018,2018_05_DEN_NYJ
CIN,2018-10-07,6,Sun,5,5,,MIA,W 27-17,6,47,9,85,15,132,2018,2018_05_CIN_MIA
NWE,2018-09-30,6,Sun,4,4,,MIA,W 38-7,6,57,10,89,16,146,2018,2018_04_NWE_MIA
NYG,2018-09-30,6,Sun,4,4,,NOR,L 18-33,6,67,5,51,11,118,2018,2018_04_NYG_NOR
CIN,2018-09-30,6,Sun,4,4,@,ATL,W 37-36,6,55,10,95,16,150,2018,2018_04_CIN_ATL
OAK,2018-09-30,6,Sun,4,4,,CLE,W 45-42 (OT),6,65,8,55,14,120,2018,2018_04_OAK_CLE
NYJ,2018-09-30,6,Sun,4,4,@,JAX,L 12-31,6,43,9,89,15,132,2018,2018_04_NYJ_JAX
LAR,2018-09-23,6,Sun,3,3,,LAC,W 35-23,6,64,4,30,10,94,2018,2018_03_LAR_LAC
MIN,2018-09-23,6,Sun,3,3,,BUF,L 6-27,6,59,12,84,18,143,2018,2018_03_MIN_BUF
WAS,2018-09-23,6,Sun,3,3,,GNB,W 31-17,6,66,11,115,17,181,2018,2018_03_WAS_GNB
KAN,2018-09-23,6,Sun,3,3,,SFO,W 38-27,6,48,14,147,20,195,2018,2018_03_KAN_SFO
ARI,2018-09-23,6,Sun,3,3,,CHI,L 14-16,6,43,7,45,13,88,2018,2018_03_ARI_CHI
DET,2018-09-23,6,Sun,3,3,,NWE,W 26-10,6,70,5,38,11,108,2018,2018_03_DET_NWE
NYJ,2018-09-20,6,Thu,3,3,@,CLE,L 17-21,6,55,5,41,11,96,2018,2018_03_NYJ_CLE
DAL,2018-09-16,6,Sun,2,2,,NYG,W 20-13,6,47,3,24,9,71,2018,2018_02_DAL_NYG
IND,2018-09-16,6,Sun,2,2,@,WAS,W 21-9,6,26,7,90,13,116,2018,2018_02_IND_WAS
BUF,2018-09-16,6,Sun,2,2,,LAC,L 20-31,6,31,6,45,12,76,2018,2018_02_BUF_LAC
DEN,2018-09-16,6,Sun,2,2,,OAK,W 20-19,6,35,4,30,10,65,2018,2018_02_DEN_OAK
PHI,2018-09-16,6,Sun,2,2,@,TAM,L 21-27,6,55,4,44,10,99,2018,2018_02_PHI_TAM
LAC,2018-09-16,6,Sun,2,2,@,BUF,W 31-20,6,45,6,31,12,76,2018,2018_02_LAC_BUF
KAN,2018-09-09,6,Sun,1,1,@,LAC,W 38-28,6,50,7,45,13,95,2018,2018_01_KAN_LAC
HOU,2018-09-09,6,Sun,1,1,@,NWE,L 20-27,6,44,6,36,12,80,2018,2018_01_HOU_NWE
NWE,2018-09-09,6,Sun,1,1,,HOU,W 27-20,6,36,6,44,12,80,2018,2018_01_NWE_HOU
NYG,2018-09-09,6,Sun,1,1,,JAX,L 15-20,6,43,11,119,17,162,2018,2018_01_NYG_JAX
CIN,2017-12-31,6,Sun,16,17,@,BAL,W 31-27,6,60,5,47,11,107,2017,2017_17_CIN_BAL
OAK,2017-12-31,6,Sun,16,17,@,LAC,L 10-30,6,85,7,65,13,150,2017,2017_17_OAK_LAC
BUF,2017-12-31,6,Sun,16,17,@,MIA,W 22-16,6,45,14,145,20,190,2017,2017_17_BUF_MIA
LAR,2017-12-31,6,Sun,16,17,,SFO,L 13-34,6,46,4,23,10,69,2017,2017_17_LAR_SFO
JAX,2017-12-31,6,Sun,16,17,@,TEN,L 10-15,6,41,2,15,8,56,2017,2017_17_JAX_TEN
ARI,2017-12-24,6,Sun,15,16,,NYG,W 23-0,6,45,10,101,16,146,2017,2017_16_ARI_NYG
CAR,2017-12-24,6,Sun,15,16,,TAM,W 22-19,6,50,12,72,18,122,2017,2017_16_CAR_TAM
WAS,2017-12-24,6,Sun,15,16,,DEN,W 27-11,6,35,3,30,9,65,2017,2017_16_WAS_DEN
GNB,2017-12-23,6,Sat,15,16,,MIN,L 0-16,6,79,2,10,8,89,2017,2017_16_GNB_MIN
ATL,2017-12-18,6,Mon,14,15,@,TAM,W 24-21,6,60,7,53,13,113,2017,2017_15_ATL_TAM
PIT,2017-12-17,6,Sun,14,15,,NWE,L 24-27,6,63,2,4,8,67,2017,2017_15_PIT_NWE
GNB,2017-12-17,6,Sun,14,15,@,CAR,L 24-31,6,28,5,40,11,68,2017,2017_15_GNB_CAR
CLE,2017-12-17,6,Sun,14,15,,BAL,L 10-27,6,35,7,57,13,92,2017,2017_15_CLE_BAL
SEA,2017-12-10,6,Sun,13,14,@,JAX,L 24-30,6,73,7,48,13,121,2017,2017_14_SEA_JAX
PIT,2017-12-10,6,Sun,13,14,,BAL,W 39-38,6,101,5,35,11,136,2017,2017_14_PIT_BAL
CAR,2017-12-10,6,Sun,13,14,,MIN,W 31-24,6,48,2,30,8,78,2017,2017_14_CAR_MIN
CLE,2017-12-10,6,Sun,13,14,,GNB,L 21-27 (OT),6,45,3,20,9,65,2017,2017_14_CLE_GNB
TEN,2017-12-10,6,Sun,13,14,@,ARI,L 7-12,6,48,5,30,11,78,2017,2017_14_TEN_ARI
CAR,2017-12-03,6,Sun,12,13,@,NOR,L 21-31,6,54,7,68,13,122,2017,2017_13_CAR_NOR
MIN,2017-12-03,6,Sun,12,13,@,ATL,W 14-9,6,51,7,55,13,106,2017,2017_13_MIN_ATL
OAK,2017-12-03,6,Sun,12,13,,NYG,W 24-17,6,42,1,5,7,47,2017,2017_13_OAK_NYG
DET,2017-12-03,6,Sun,12,13,@,BAL,L 20-44,6,45,2,25,8,70,2017,2017_13_DET_BAL
JAX,2017-12-03,6,Sun,12,13,,IND,W 30-10,6,55,4,31,10,86,2017,2017_13_JAX_IND
HOU,2017-11-27,6,Mon,11,12,@,BAL,L 16-23,6,36,7,89,13,125,2017,2017_12_HOU_BAL
MIA,2017-11-26,6,Sun,11,12,@,NWE,L 17-35,6,52,7,70,13,122,2017,2017_12_MIA_NWE
BUF,2017-11-26,6,Sun,11,12,@,KAN,W 16-10,6,50,6,50,12,100,2017,2017_12_BUF_KAN
KAN,2017-11-26,6,Sun,11,12,,BUF,L 10-16,6,50,6,50,12,100,2017,2017_12_KAN_BUF
SEA,2017-11-26,6,Sun,11,12,@,SFO,W 24-13,6,35,7,74,13,109,2017,2017_12_SEA_SFO
NYG,2017-11-23,6,Thu,11,12,@,WAS,L 10-20,6,79,8,55,14,134,2017,2017_12_NYG_WAS
JAX,2017-11-19,6,Sun,10,11,@,CLE,W 19-7,6,40,0,0,6,40,2017,2017_11_JAX_CLE
BUF,2017-11-19,6,Sun,10,11,@,LAC,L 24-54,6,48,1,13,7,61,2017,2017_11_BUF_LAC
HOU,2017-11-19,6,Sun,10,11,,ARI,W 31-21,6,42,10,90,16,132,2017,2017_11_HOU_ARI
DET,2017-11-19,6,Sun,10,11,@,CHI,W 27-24,6,49,5,64,11,113,2017,2017_11_DET_CHI
CAR,2017-11-13,6,Mon,10,10,,MIA,W 45-21,6,37,7,57,13,94,2017,2017_10_CAR_MIA
SFO,2017-11-12,6,Sun,10,10,,NYG,W 31-21,6,44,4,35,10,79,2017,2017_10_SFO_NYG
TAM,2017-11-12,6,Sun,9,10,,NYJ,W 15-10,6,50,8,77,14,127,2017,2017_10_TAM_NYJ
IND,2017-11-05,6,Sun,9,9,@,HOU,W 20-14,6,68,7,74,13,142,2017,2017_09_IND_HOU
LAR,2017-11-05,6,Sun,8,9,@,NYG,W 51-17,6,55,4,52,10,107,2017,2017_09_LAR_NYG
BAL,2017-11-05,6,Sun,9,9,@,TEN,L 20-23,6,39,3,39,9,78,2017,2017_09_BAL_TEN
DET,2017-10-29,6,Sun,7,8,,PIT,L 15-20,6,57,5,37,11,94,2017,2017_08_DET_PIT
TAM,2017-10-29,6,Sun,7,8,,CAR,L 3-17,6,55,5,51,11,106,2017,2017_08_TAM_CAR
NYJ,2017-10-29,6,Sun,8,8,,ATL,L 20-25,6,50,6,68,12,118,2017,2017_08_NYJ_ATL
NWE,2017-10-29,6,Sun,8,8,,LAC,W 21-13,6,80,10,77,16,157,2017,2017_08_NWE_LAC
SFO,2017-10-29,6,Sun,8,8,@,PHI,L 10-33,6,69,4,35,10,104,2017,2017_08_SFO_PHI
ATL,2017-10-29,6,Sun,7,8,@,NYJ,W 25-20,6,68,6,50,12,118,2017,2017_08_ATL_NYJ
OAK,2017-10-29,6,Sun,8,8,@,BUF,L 14-34,6,50,11,95,17,145,2017,2017_08_OAK_BUF
ATL,2017-10-22,6,Sun,6,7,@,NWE,L 7-23,6,40,8,65,14,105,2017,2017_07_ATL_NWE
LAR,2017-10-22,6,Sun,7,7,,ARI,W 33-0,6,45,10,65,16,110,2017,2017_07_LAR_ARI
NYJ,2017-10-15,6,Sun,6,6,,NWE,L 17-24,6,69,6,45,12,114,2017,2017_06_NYJ_NWE
PIT,2017-10-15,6,Sun,6,6,@,KAN,W 19-13,6,57,7,48,13,105,2017,2017_06_PIT_KAN
NWE,2017-10-15,6,Sun,6,6,@,NYJ,W 24-17,6,45,6,69,12,114,2017,2017_06_NWE_NYJ
ATL,2017-10-15,6,Sun,5,6,,MIA,L 17-20,6,73,4,42,10,115,2017,2017_06_ATL_MIA
BUF,2017-10-08,6,Sun,5,5,@,CIN,L 16-20,6,71,6,71,12,142,2017,2017_05_BUF_CIN
KAN,2017-10-08,6,Sun,5,5,@,HOU,W 42-34,6,64,7,59,13,123,2017,2017_05_KAN_HOU
GNB,2017-10-08,6,Sun,5,5,@,DAL,W 35-31,6,38,7,70,13,108,2017,2017_05_GNB_DAL
CLE,2017-10-08,6,Sun,5,5,,NYJ,L 14-17,6,60,9,80,15,140,2017,2017_05_CLE_NYJ
CIN,2017-10-08,6,Sun,5,5,,BUF,W 20-16,6,71,6,71,12,142,2017,2017_05_CIN_BUF
BAL,2017-10-01,6,Sun,4,4,,PIT,L 9-26,6,55,8,60,14,115,2017,2017_04_BAL_PIT
TEN,2017-10-01,6,Sun,4,4,@,HOU,L 14-57,6,88,3,20,9,108,2017,2017_04_TEN_HOU
DET,2017-10-01,6,Sun,4,4,@,MIN,W 14-7,6,60,2,10,8,70,2017,2017_04_DET_MIN
SEA,2017-10-01,6,Sun,4,4,,IND,W 46-18,6,45,5,31,11,76,2017,2017_04_SEA_IND
DEN,2017-10-01,6,Sun,4,4,,OAK,W 16-10,6,40,7,75,13,115,2017,2017_04_DEN_OAK
JAX,2017-10-01,6,Sun,4,4,@,NYJ,L 20-23 (OT),6,47,10,70,16,117,2017,2017_04_JAX_NYJ
ARI,2017-09-25,6,Mon,3,3,,DAL,L 17-28,6,50,9,76,15,126,2017,2017_03_ARI_DAL
PIT,2017-09-24,6,Sun,3,3,@,CHI,L 17-23 (OT),6,40,10,73,16,113,2017,2017_03_PIT_CHI
DET,2017-09-18,6,Mon,2,2,@,NYG,W 24-10,6,50,7,50,13,100,2017,2017_02_DET_NYG
SFO,2017-09-17,6,Sun,2,2,@,SEA,L 9-12,6,66,9,71,15,137,2017,2017_02_SFO_SEA
ARI,2017-09-17,6,Sun,2,2,@,IND,W 16-13 (OT),6,41,8,70,14,111,2017,2017_02_ARI_IND
CAR,2017-09-17,6,Sun,2,2,,BUF,W 9-3,6,40,5,44,11,84,2017,2017_02_CAR_BUF
LAC,2017-09-17,6,Sun,2,2,,MIA,L 17-19,6,56,5,23,11,79,2017,2017_02_LAC_MIA
ATL,2017-09-17,6,Sun,2,2,,GNB,W 34-23,6,34,10,70,16,104,2017,2017_02_ATL_GNB
NOR,2017-09-11,6,Mon,1,1,@,MIN,L 19-29,6,52,5,50,11,102,2017,2017_01_NOR_MIN
NYG,2017-09-10,6,Sun,1,1,@,DAL,L 3-19,6,55,5,50,11,105,2017,2017_01_NYG_DAL
ARI,2017-09-10,6,Sun,1,1,@,DET,L 23-35,6,55,10,100,16,155,2017,2017_01_ARI_DET
BUF,2017-09-10,6,Sun,1,1,,NYJ,W 21-12,6,50,5,62,11,112,2017,2017_01_BUF_NYJ
NWE,2017-09-07,6,Thu,1,1,,KAN,L 27-42,6,55,15,139,21,194,2017,2017_01_NWE_KAN
LAC,2023-01-08,5,Sun,17,18,@,DEN,L 28-31,5,34,3,36,8,70,2022,2022_18_LAC_DEN
DET,2023-01-08,5,Sun,17,18,@,GNB,W 20-16,5,75,4,35,9,110,2022,2022_18_DET_GNB
BAL,2023-01-08,5,Sun,17,18,@,CIN,L 16-27,5,22,3,35,8,57,2022,2022_18_BAL_CIN
MIA,2023-01-08,5,Sun,17,18,,NYJ,W 11-6,5,47,6,54,11,101,2022,2022_18_MIA_NYJ
KAN,2023-01-07,5,Sat,17,18,@,LVR,W 31-13,5,43,6,47,11,90,2022,2022_18_KAN_LVR
KAN,2023-01-01,5,Sun,16,17,,DEN,W 27-24,5,31,3,23,8,54,2022,2022_17_KAN_DEN
ATL,2023-01-01,5,Sun,16,17,,ARI,W 20-19,5,70,8,50,13,120,2022,2022_17_ATL_ARI
WAS,2023-01-01,5,Sun,16,17,,CLE,L 10-24,5,24,3,20,8,44,2022,2022_17_WAS_CLE
SEA,2023-01-01,5,Sun,16,17,,NYJ,W 23-6,5,25,2,10,7,35,2022,2022_17_SEA_NYJ
GNB,2022-12-25,5,Sun,15,16,@,MIA,W 26-20,5,40,8,62,13,102,2022,2022_16_GNB_MIA
TAM,2022-12-25,5,Sun,15,16,@,ARI,W 19-16 (OT),5,30,6,74,11,104,2022,2022_16_TAM_ARI
KAN,2022-12-24,5,Sat,15,16,,SEA,W 24-10,5,39,6,35,11,74,2022,2022_16_KAN_SEA
TEN,2022-12-24,5,Sat,15,16,,HOU,L 14-19,5,30,4,35,9,65,2022,2022_16_TEN_HOU
ATL,2022-12-24,5,Sat,15,16,@,BAL,L 9-17,5,48,1,6,6,54,2022,2022_16_ATL_BAL
CAR,2022-12-18,5,Sun,14,15,,PIT,L 16-24,5,40,7,81,12,121,2022,2022_15_CAR_PIT
NYG,2022-12-18,5,Sun,14,15,@,WAS,W 20-12,5,30,6,40,11,70,2022,2022_15_NYG_WAS
BAL,2022-12-11,5,Sun,13,14,@,PIT,W 16-14,5,46,2,15,7,61,2022,2022_14_BAL_PIT
TEN,2022-12-11,5,Sun,13,14,,JAX,L 22-36,5,50,9,70,14,120,2022,2022_14_TEN_JAX
BUF,2022-12-11,5,Sun,13,14,,NYJ,W 20-12,5,35,7,61,12,96,2022,2022_14_BUF_NYJ
NYG,2022-12-11,5,Sun,13,14,,PHI,L 22-48,5,34,2,9,7,43,2022,2022_14_NYG_PHI
CHI,2022-12-04,5,Sun,13,13,,GNB,L 19-28,5,63,2,20,7,83,2022,2022_13_CHI_GNB
HOU,2022-12-04,5,Sun,12,13,,CLE,L 14-27,5,31,6,56,11,87,2022,2022_13_HOU_CLE
JAX,2022-12-04,5,Sun,12,13,@,DET,L 14-40,5,24,1,10,6,34,2022,2022_13_JAX_DET
CLE,2022-11-27,5,Sun,11,12,,TAM,W 23-17 (OT),5,42,9,70,14,112,2022,2022_12_CLE_TAM
HOU,2022-11-27,5,Sun,11,12,@,MIA,L 15-30,5,45,4,35,9,80,2022,2022_12_HOU_MIA
LAR,2022-11-27,5,Sun,11,12,@,KAN,L 10-26,5,25,3,25,8,50,2022,2022_12_LAR_KAN
BUF,2022-11-24,5,Thu,11,12,@,DET,W 28-25,5,36,3,32,8,68,2022,2022_12_BUF_DET
ARI,2022-11-21,5,Mon,11,11,,SFO,L 10-38,5,50,3,30,8,80,2022,2022_11_ARI_SFO
WAS,2022-11-20,5,Sun,11,11,@,HOU,W 23-10,5,36,2,15,7,51,2022,2022_11_WAS_HOU
DET,2022-11-20,5,Sun,10,11,@,NYG,W 31-18,5,45,8,63,13,108,2022,2022_11_DET_NYG
DEN,2022-11-20,5,Sun,10,11,,LVR,L 16-22 (OT),5,45,9,98,14,143,2022,2022_11_DEN_LVR
GNB,2022-11-17,5,Thu,11,11,,TEN,L 17-27,5,40,2,19,7,59,2022,2022_11_GNB_TEN
WAS,2022-11-14,5,Mon,10,10,@,PHI,W 32-21,5,58,7,75,12,133,2022,2022_10_WAS_PHI
LAR,2022-11-13,5,Sun,9,10,,ARI,L 17-27,5,29,10,67,15,96,2022,2022_10_LAR_ARI
MIA,2022-11-13,5,Sun,10,10,,CLE,W 39-17,5,43,6,52,11,95,2022,2022_10_MIA_CLE
NYG,2022-11-13,5,Sun,9,10,,HOU,W 24-16,5,24,7,40,12,64,2022,2022_10_NYG_HOU
JAX,2022-11-13,5,Sun,10,10,@,KAN,L 17-27,5,30,0,0,5,30,2022,2022_10_JAX_KAN
SFO,2022-11-13,5,Sun,9,10,,LAC,W 22-16,5,52,1,5,6,57,2022,2022_10_SFO_LAC
BAL,2022-11-07,5,Mon,9,9,@,NOR,W 27-13,5,31,5,40,10,71,2022,2022_09_BAL_NOR
NOR,2022-11-07,5,Mon,9,9,,BAL,L 13-27,5,40,5,31,10,71,2022,2022_09_NOR_BAL
CIN,2022-11-06,5,Sun,9,9,,CAR,W 42-21,5,35,7,50,12,85,2022,2022_09_CIN_CAR
LAC,2022-11-06,5,Sun,8,9,@,ATL,W 20-17,5,45,2,15,7,60,2022,2022_09_LAC_ATL
LVR,2022-11-06,5,Sun,8,9,@,JAX,L 20-27,5,45,4,30,9,75,2022,2022_09_LVR_JAX
MIN,2022-11-06,5,Sun,8,9,@,WAS,W 20-17,5,42,3,26,8,68,2022,2022_09_MIN_WAS
JAX,2022-10-30,5,Sun,8,8,,DEN,L 17-21,5,54,12,80,17,134,2022,2022_08_JAX_DEN
NOR,2022-10-30,5,Sun,8,8,,LVR,W 24-0,5,27,6,59,11,86,2022,2022_08_NOR_LVR
PIT,2022-10-23,5,Sun,7,7,@,MIA,L 10-16,5,40,5,30,10,70,2022,2022_07_PIT_MIA
MIA,2022-10-23,5,Sun,7,7,,PIT,W 16-10,5,30,5,40,10,70,2022,2022_07_MIA_PIT
CIN,2022-10-23,5,Sun,7,7,,ATL,W 35-17,5,17,3,22,8,39,2022,2022_07_CIN_ATL
LVR,2022-10-23,5,Sun,6,7,,HOU,W 38-20,5,44,3,14,8,58,2022,2022_07_LVR_HOU
KAN,2022-10-16,5,Sun,6,6,,BUF,L 20-24,5,58,7,35,12,93,2022,2022_06_KAN_BUF
ATL,2022-10-16,5,Sun,6,6,,SFO,W 28-14,5,40,5,30,10,70,2022,2022_06_ATL_SFO
SFO,2022-10-16,5,Sun,6,6,@,ATL,L 14-28,5,30,5,40,10,70,2022,2022_06_SFO_ATL
KAN,2022-10-10,5,Mon,5,5,,LVR,W 30-29,5,72,11,99,16,171,2022,2022_05_KAN_LVR
NYJ,2022-10-09,5,Sun,5,5,,MIA,W 40-17,5,105,11,102,16,207,2022,2022_05_NYJ_MIA
CAR,2022-10-09,5,Sun,5,5,,SFO,L 15-37,5,33,9,50,14,83,2022,2022_05_CAR_SFO
DAL,2022-10-09,5,Sun,5,5,@,LAR,W 22-10,5,42,3,25,8,67,2022,2022_05_DAL_LAR
BUF,2022-10-09,5,Sun,5,5,,PIT,W 38-3,5,28,6,54,11,82,2022,2022_05_BUF_PIT
MIN,2022-10-02,5,Sun,4,4,@,NOR,W 28-25,5,35,10,102,15,137,2022,2022_04_MIN_NOR
TAM,2022-10-02,5,Sun,4,4,,KAN,L 31-41,5,40,4,32,9,72,2022,2022_04_TAM_KAN
CHI,2022-10-02,5,Sun,4,4,@,NYG,L 12-20,5,65,7,55,12,120,2022,2022_04_CHI_NYG
DEN,2022-09-25,5,Sun,3,3,,SFO,W 11-10,5,30,7,40,12,70,2022,2022_03_DEN_SFO
PHI,2022-09-25,5,Sun,3,3,@,WAS,W 24-8,5,52,4,48,9,100,2022,2022_03_PHI_WAS
CIN,2022-09-25,5,Sun,3,3,@,NYJ,W 27-12,5,30,4,55,9,85,2022,2022_03_CIN_NYJ
CLE,2022-09-22,5,Thu,3,3,,PIT,W 29-17,5,24,5,25,10,49,2022,2022_03_CLE_PIT
PIT,2022-09-22,5,Thu,3,3,@,CLE,L 17-29,5,25,5,24,10,49,2022,2022_03_PIT_CLE
MIN,2022-09-19,5,Mon,2,2,@,PHI,L 7-24,5,25,8,60,13,85,2022,2022_02_MIN_PHI
DAL,2022-09-18,5,Sun,2,2,,CIN,W 20-17,5,45,7,35,12,80,2022,2022_02_DAL_CIN
ATL,2022-09-18,5,Sun,2,2,@,LAR,L 27-31,5,29,3,61,8,90,2022,2022_02_ATL_LAR
IND,2022-09-18,5,Sun,2,2,@,JAX,L 0-24,5,30,3,19,8,49,2022,2022_02_IND_JAX
CAR,2022-09-18,5,Sun,2,2,@,NYG,L 16-19,5,38,8,62,13,100,2022,2022_02_CAR_NYG
CLE,2022-09-18,5,Sun,2,2,,NYJ,L 30-31,5,38,8,57,13,95,2022,2022_02_CLE_NYJ
SEA,2022-09-12,5,Mon,1,1,,DEN,W 17-16,5,77,12,106,17,183,2022,2022_01_SEA_DEN
TAM,2022-09-11,5,Sun,1,1,@,DAL,W 19-3,5,25,10,73,15,98,2022,2022_01_TAM_DAL
ARI,2022-09-11,5,Sun,1,1,,KAN,L 21-44,5,49,3,25,8,74,2022,2022_01_ARI_KAN
LAC,2022-09-11,5,Sun,1,1,,LVR,W 24-19,5,21,3,11,8,32,2022,2022_01_LAC_LVR
BAL,2022-09-11,5,Sun,1,1,@,NYJ,W 24-9,5,29,6,81,11,110,2022,2022_01_BAL_NYJ
BUF,2022-09-08,5,Thu,1,1,@,LAR,W 31-10,5,35,4,30,9,65,2022,2022_01_BUF_LAR
ATL,2022-01-09,5,Sun,17,18,,NOR,L 20-30,5,46,4,40,9,86,2021,2021_18_ATL_NOR
MIA,2022-01-09,5,Sun,17,18,,NWE,W 33-24,5,33,8,78,13,111,2021,2021_18_MIA_NWE
TEN,2022-01-09,5,Sun,17,18,@,HOU,W 28-25,5,42,4,65,9,107,2021,2021_18_TEN_HOU
DAL,2022-01-08,5,Sat,17,18,@,PHI,W 51-26,5,44,3,30,8,74,2021,2021_18_DAL_PHI
KAN,2022-01-08,5,Sat,17,18,@,DEN,W 28-24,5,45,6,45,11,90,2021,2021_18_KAN_DEN
PIT,2022-01-03,5,Mon,16,17,,CLE,W 26-14,5,51,10,77,15,128,2021,2021_17_PIT_CLE
NOR,2022-01-02,5,Sun,16,17,,CAR,W 18-10,5,33,1,5,6,38,2021,2021_17_NOR_CAR
CIN,2022-01-02,5,Sun,16,17,,KAN,W 34-31,5,62,10,83,15,145,2021,2021_17_CIN_KAN
CHI,2022-01-02,5,Sun,16,17,,NYG,W 29-3,5,35,3,26,8,61,2021,2021_17_CHI_NYG
SEA,2022-01-02,5,Sun,16,17,,DET,W 51-29,5,31,4,30,9,61,2021,2021_17_SEA_DET
HOU,2022-01-02,5,Sun,16,17,@,SFO,L 7-23,5,67,7,111,12,178,2021,2021_17_HOU_SFO
MIA,2022-01-02,5,Sun,16,17,@,TEN,L 3-34,5,55,6,70,11,125,2021,2021_17_MIA_TEN
CIN,2021-12-26,5,Sun,15,16,,BAL,W 41-21,5,45,6,27,11,72,2021,2021_16_CIN_BAL
BUF,2021-12-26,5,Sun,15,16,@,NWE,W 33-21,5,45,3,30,8,75,2021,2021_16_BUF_NWE
KAN,2021-12-26,5,Sun,15,16,,PIT,W 36-10,5,41,5,40,10,81,2021,2021_16_KAN_PIT
LAC,2021-12-26,5,Sun,15,16,@,HOU,L 29-41,5,49,10,70,15,119,2021,2021_16_LAC_HOU
PIT,2021-12-26,5,Sun,15,16,@,KAN,L 10-36,5,40,5,41,10,81,2021,2021_16_PIT_KAN
IND,2021-12-25,5,Sat,15,16,@,ARI,W 22-16,5,40,11,85,16,125,2021,2021_16_IND_ARI
SFO,2021-12-23,5,Thu,15,16,@,TEN,L 17-20,5,41,6,57,11,98,2021,2021_16_SFO_TEN
MIA,2021-12-19,5,Sun,14,15,,NYJ,W 31-24,5,45,3,32,8,77,2021,2021_15_MIA_NYJ
CAR,2021-12-19,5,Sun,14,15,@,BUF,L 14-31,5,55,8,67,13,122,2021,2021_15_CAR_BUF
PIT,2021-12-19,5,Sun,14,15,,TEN,W 19-13,5,30,7,68,12,98,2021,2021_15_PIT_TEN
SFO,2021-12-19,5,Sun,14,15,,ATL,W 31-13,5,35,4,29,9,64,2021,2021_15_SFO_ATL
LAC,2021-12-16,5,Thu,14,15,,KAN,L 28-34 (OT),5,60,4,36,9,96,2021,2021_15_LAC_KAN
LAR,2021-12-13,5,Mon,13,14,@,ARI,W 30-23,5,40,7,54,12,94,2021,2021_14_LAR_ARI
NYJ,2021-12-12,5,Sun,13,14,,NOR,L 9-30,5,45,4,42,9,87,2021,2021_14_NYJ_NOR
IND,2021-12-05,5,Sun,13,13,@,HOU,W 31-0,5,25,4,25,9,50,2021,2021_13_IND_HOU
DEN,2021-12-05,5,Sun,12,13,@,KAN,L 9-22,5,37,7,60,12,97,2021,2021_13_DEN_KAN
PIT,2021-12-05,5,Sun,12,13,,BAL,W 20-19,5,81,10,55,15,136,2021,2021_13_PIT_BAL
DAL,2021-12-02,5,Thu,12,13,@,NOR,W 27-17,5,35,7,59,12,94,2021,2021_13_DAL_NOR
TEN,2021-11-28,5,Sun,12,12,@,NWE,L 13-36,5,50,4,35,9,85,2021,2021_12_TEN_NWE
MIA,2021-11-28,5,Sun,12,12,,CAR,W 33-10,5,35,7,61,12,96,2021,2021_12_MIA_CAR
BAL,2021-11-28,5,Sun,11,12,,CLE,W 16-10,5,54,5,45,10,99,2021,2021_12_BAL_CLE
NYJ,2021-11-28,5,Sun,11,12,@,HOU,W 21-14,5,40,4,32,9,72,2021,2021_12_NYJ_HOU
ATL,2021-11-28,5,Sun,11,12,@,JAX,W 21-14,5,26,6,43,11,69,2021,2021_12_ATL_JAX
CLE,2021-11-28,5,Sun,12,12,@,BAL,L 10-16,5,45,5,54,10,99,2021,2021_12_CLE_BAL
SFO,2021-11-28,5,Sun,11,12,,MIN,W 34-26,5,57,5,38,10,95,2021,2021_12_SFO_MIN
DEN,2021-11-28,5,Sun,11,12,,LAC,W 28-13,5,35,9,75,14,110,2021,2021_12_DEN_LAC
MIN,2021-11-28,5,Sun,11,12,@,SFO,L 26-34,5,38,5,57,10,95,2021,2021_12_MIN_SFO
CHI,2021-11-25,5,Thu,11,12,@,DET,W 16-14,5,50,10,67,15,117,2021,2021_12_CHI_DET
TEN,2021-11-21,5,Sun,11,11,,HOU,L 13-22,5,52,7,50,12,102,2021,2021_11_TEN_HOU
NWE,2021-11-18,5,Thu,11,11,@,ATL,W 25-0,5,59,9,72,14,131,2021,2021_11_NWE_ATL
LAR,2021-11-15,5,Mon,10,10,@,SFO,L 10-31,5,35,9,53,14,88,2021,2021_10_LAR_SFO
SEA,2021-11-14,5,Sun,9,10,@,GNB,L 0-17,5,39,3,43,8,82,2021,2021_10_SEA_GNB
PIT,2021-11-08,5,Mon,8,9,,CHI,W 29-27,5,30,12,115,17,145,2021,2021_09_PIT_CHI
DAL,2021-11-07,5,Sun,8,9,,DEN,L 16-30,5,38,5,37,10,75,2021,2021_09_DAL_DEN
DEN,2021-11-07,5,Sun,9,9,@,DAL,W 30-16,5,37,5,38,10,75,2021,2021_09_DEN_DAL
LAC,2021-10-31,5,Sun,7,8,,NWE,L 24-27,5,40,4,30,9,70,2021,2021_08_LAC_NWE
CLE,2021-10-31,5,Sun,8,8,,PIT,L 10-15,5,30,8,65,13,95,2021,2021_08_CLE_PIT
SEA,2021-10-31,5,Sun,8,8,,JAX,W 31-7,5,40,12,93,17,133,2021,2021_08_SEA_JAX
CIN,2021-10-31,5,Sun,8,8,@,NYJ,L 31-34,5,51,8,46,13,97,2021,2021_08_CIN_NYJ
BAL,2021-10-24,5,Sun,7,7,,CIN,L 17-41,5,46,1,5,6,51,2021,2021_07_BAL_CIN
NYJ,2021-10-24,5,Sun,6,7,@,NWE,L 13-54,5,29,6,95,11,124,2021,2021_07_NYJ_NWE
PIT,2021-10-17,5,Sun,6,6,,SEA,W 23-20 (OT),5,38,6,45,11,83,2021,2021_06_PIT_SEA
ARI,2021-10-17,5,Sun,6,6,@,CLE,W 37-14,5,45,9,88,14,133,2021,2021_06_ARI_CLE
NWE,2021-10-17,5,Sun,6,6,,DAL,L 29-35 (OT),5,47,12,115,17,162,2021,2021_06_NWE_DAL
KAN,2021-10-17,5,Sun,6,6,@,WAS,W 31-13,5,47,6,44,11,91,2021,2021_06_KAN_WAS
NYG,2021-10-17,5,Sun,6,6,,LAR,L 11-38,5,27,7,50,12,77,2021,2021_06_NYG_LAR
IND,2021-10-11,5,Mon,5,5,@,BAL,L 25-31 (OT),5,45,8,74,13,119,2021,2021_05_IND_BAL
MIA,2021-10-10,5,Sun,5,5,@,TAM,L 17-45,5,37,6,47,11,84,2021,2021_05_MIA_TAM
WAS,2021-10-10,5,Sun,5,5,,NOR,L 22-33,5,37,6,45,11,82,2021,2021_05_WAS_NOR
NWE,2021-10-10,5,Sun,5,5,@,HOU,W 25-22,5,27,8,70,13,97,2021,2021_05_NWE_HOU
NYG,2021-10-10,5,Sun,5,5,@,DAL,L 20-44,5,48,8,58,13,106,2021,2021_05_NYG_DAL
LAR,2021-10-07,5,Thu,5,5,@,SEA,W 26-17,5,85,3,20,8,105,2021,2021_05_LAR_SEA
NOR,2021-10-03,5,Sun,4,4,,NYG,L 21-27 (OT),5,35,3,25,8,60,2021,2021_04_NOR_NYG
MIA,2021-10-03,5,Sun,4,4,,IND,L 17-27,5,32,8,86,13,118,2021,2021_04_MIA_IND
PIT,2021-10-03,5,Sun,4,4,@,GNB,L 17-27,5,34,3,25,8,59,2021,2021_04_PIT_GNB
SEA,2021-10-03,5,Sun,4,4,@,SFO,W 28-21,5,27,8,78,13,105,2021,2021_04_SEA_SFO
LAR,2021-10-03,5,Sun,4,4,,ARI,L 20-37,5,36,7,63,12,99,2021,2021_04_LAR_ARI
BUF,2021-09-26,5,Sun,3,3,,WAS,W 43-21,5,30,5,38,10,68,2021,2021_03_BUF_WAS
WAS,2021-09-26,5,Sun,3,3,@,BUF,L 21-43,5,38,5,30,10,68,2021,2021_03_WAS_BUF
CHI,2021-09-26,5,Sun,3,3,@,CLE,L 6-26,5,49,7,98,12,147,2021,2021_03_CHI_CLE
GNB,2021-09-20,5,Mon,2,2,,DET,W 35-17,5,50,9,78,14,128,2021,2021_02_GNB_DET
KAN,2021-09-19,5,Sun,2,2,@,BAL,L 35-36,5,46,8,55,13,101,2021,2021_02_KAN_BAL
ARI,2021-09-19,5,Sun,2,2,,MIN,W 34-33,5,40,3,16,8,56,2021,2021_02_ARI_MIN
PIT,2021-09-19,5,Sun,2,2,,LVR,L 17-26,5,43,5,40,10,83,2021,2021_02_PIT_LVR
SFO,2021-09-19,5,Sun,2,2,@,PHI,W 17-11,5,60,8,57,13,117,2021,2021_02_SFO_PHI
CAR,2021-09-19,5,Sun,2,2,,NOR,W 26-7,5,49,11,115,16,164,2021,2021_02_CAR_NOR
LVR,2021-09-19,5,Sun,2,2,@,PIT,W 26-17,5,40,5,43,10,83,2021,2021_02_LVR_PIT
TEN,2021-09-19,5,Sun,2,2,@,SEA,W 33-30 (OT),5,45,10,100,15,145,2021,2021_02_TEN_SEA
CLE,2021-09-19,5,Sun,2,2,,HOU,W 31-21,5,62,9,78,14,140,2021,2021_02_CLE_HOU
BAL,2021-09-13,5,Mon,1,1,@,LVR,L 27-33 (OT),5,71,10,62,15,133,2021,2021_01_BAL_LVR
PIT,2021-09-12,5,Sun,1,1,@,BUF,W 23-16,5,32,8,81,13,113,2021,2021_01_PIT_BUF
DET,2021-09-12,5,Sun,1,1,,SFO,L 33-41,5,45,7,79,12,124,2021,2021_01_DET_SFO
GNB,2021-09-12,5,Sun,1,1,@,NOR,L 3-38,5,33,6,36,11,69,2021,2021_01_GNB_NOR
MIA,2021-09-12,5,Sun,1,1,@,NWE,W 17-16,5,28,8,84,13,112,2021,2021_01_MIA_NWE
NYJ,2021-09-12,5,Sun,1,1,@,CAR,L 14-19,5,30,6,38,11,68,2021,2021_01_NYJ_CAR
KAN,2021-09-12,5,Sun,1,1,,CLE,W 33-29,5,36,5,30,10,66,2021,2021_01_KAN_CLE
HOU,2021-09-12,5,Sun,1,1,,JAX,W 37-21,5,50,10,82,15,132,2021,2021_01_HOU_JAX
CLE,2021-09-12,5,Sun,1,1,@,KAN,L 29-33,5,30,5,36,10,66,2021,2021_01_CLE_KAN
DEN,2021-09-12,5,Sun,1,1,@,NYG,W 27-13,5,51,4,48,9,99,2021,2021_01_DEN_NYG
KAN,2021-01-03,5,Sun,16,17,,LAC,L 21-38,5,69,4,23,9,92,2020,2020_17_KAN_LAC
WAS,2021-01-03,5,Sun,16,17,@,PHI,W 20-14,5,56,6,41,11,97,2020,2020_17_WAS_PHI
LAR,2021-01-03,5,Sun,16,17,,ARI,W 18-7,5,38,6,38,11,76,2020,2020_17_LAR_ARI
SEA,2020-12-27,5,Sun,15,16,,LAR,W 20-9,5,31,5,45,10,76,2020,2020_16_SEA_LAR
LAR,2020-12-27,5,Sun,15,16,@,SEA,L 9-20,5,45,5,31,10,76,2020,2020_16_LAR_SEA
WAS,2020-12-27,5,Sun,15,16,,CAR,L 13-20,5,26,3,35,8,61,2020,2020_16_WAS_CAR
CIN,2020-12-27,5,Sun,15,16,@,HOU,W 37-31,5,35,6,46,11,81,2020,2020_16_CIN_HOU
NYG,2020-12-27,5,Sun,15,16,@,BAL,L 13-27,5,35,10,65,15,100,2020,2020_16_NYG_BAL
DAL,2020-12-27,5,Sun,15,16,,PHI,W 37-17,5,73,12,115,17,188,2020,2020_16_DAL_PHI
MIA,2020-12-26,5,Sat,15,16,@,LVR,W 26-25,5,76,4,40,9,116,2020,2020_16_MIA_LVR
KAN,2020-12-20,5,Sun,14,15,@,NOR,W 32-29,5,54,10,93,15,147,2020,2020_15_KAN_NOR
HOU,2020-12-20,5,Sun,14,15,@,IND,L 20-27,5,24,4,35,9,59,2020,2020_15_HOU_IND
LAR,2020-12-20,5,Sun,14,15,,NYJ,L 20-23,5,43,6,61,11,104,2020,2020_15_LAR_NYJ
DAL,2020-12-20,5,Sun,14,15,,SFO,W 41-33,5,58,4,39,9,97,2020,2020_15_DAL_SFO
GNB,2020-12-19,5,Sat,14,15,,CAR,W 24-16,5,50,7,66,12,116,2020,2020_15_GNB_CAR
SFO,2020-12-13,5,Sun,13,14,,WAS,L 15-23,5,35,5,30,10,65,2020,2020_14_SFO_WAS
TAM,2020-12-13,5,Sun,13,14,,MIN,W 26-14,5,34,5,71,10,105,2020,2020_14_TAM_MIN
WAS,2020-12-13,5,Sun,13,14,@,SFO,W 23-15,5,30,5,35,10,65,2020,2020_14_WAS_SFO
MIN,2020-12-13,5,Sun,13,14,@,TAM,L 14-26,5,71,5,34,10,105,2020,2020_14_MIN_TAM
SFO,2020-12-13,5,Sun,13,14,,WAS,L 15-23,5,35,5,30,10,65,2020,2020_14_SFO_WAS
LAR,2020-12-10,5,Thu,13,14,,NWE,W 24-3,5,35,5,27,10,62,2020,2020_14_LAR_NWE
NWE,2020-12-10,5,Thu,13,14,@,LAR,L 3-24,5,27,5,35,10,62,2020,2020_14_NWE_LAR
TEN,2020-12-06,5,Sun,12,13,,CLE,L 35-41,5,52,13,92,18,144,2020,2020_13_TEN_CLE
KAN,2020-12-06,5,Sun,12,13,,DEN,W 22-16,5,44,4,31,9,75,2020,2020_13_KAN_DEN
LAC,2020-12-06,5,Sun,12,13,,NWE,L 0-45,5,30,3,15,8,45,2020,2020_13_LAC_NWE
GNB,2020-12-06,5,Sun,12,13,,PHI,W 30-16,5,30,4,40,9,70,2020,2020_13_GNB_PHI
ARI,2020-12-06,5,Sun,12,13,,LAR,L 28-38,5,21,6,75,11,96,2020,2020_13_ARI_LAR
PIT,2020-12-02,5,Wed,11,12,,BAL,W 19-14,5,40,7,86,12,126,2020,2020_12_PIT_BAL
LAC,2020-11-29,5,Sun,11,12,@,BUF,L 17-27,5,91,9,85,14,176,2020,2020_12_LAC_BUF
NYG,2020-11-29,5,Sun,11,12,@,CIN,W 19-17,5,51,3,27,8,78,2020,2020_12_NYG_CIN
JAX,2020-11-29,5,Sun,11,12,,CLE,L 25-27,5,24,6,47,11,71,2020,2020_12_JAX_CLE
NOR,2020-11-29,5,Sun,11,12,@,DEN,W 31-3,5,35,2,10,7,45,2020,2020_12_NOR_DEN
CHI,2020-11-29,5,Sun,11,12,@,GNB,L 25-41,5,45,3,17,8,62,2020,2020_12_CHI_GNB
SFO,2020-11-29,5,Sun,11,12,@,LAR,W 23-20,5,40,3,27,8,67,2020,2020_12_SFO_LAR
WAS,2020-11-26,5,Thu,11,12,@,DAL,W 41-16,5,53,5,45,10,98,2020,2020_12_WAS_DAL
DAL,2020-11-26,5,Thu,11,12,,WAS,L 16-41,5,45,5,53,10,98,2020,2020_12_DAL_WAS
LAR,2020-11-23,5,Mon,10,11,@,TAM,W 27-24,5,65,2,7,7,72,2020,2020_11_LAR_TAM
NOR,2020-11-22,5,Sun,10,11,,ATL,W 24-9,5,35,7,53,12,88,2020,2020_11_NOR_ATL
PHI,2020-11-22,5,Sun,10,11,@,CLE,L 17-22,5,33,3,53,8,86,2020,2020_11_PHI_CLE
MIA,2020-11-22,5,Sun,10,11,@,DEN,L 13-20,5,50,8,70,13,120,2020,2020_11_MIA_DEN
HOU,2020-11-22,5,Sun,10,11,,NWE,W 27-20,5,35,7,55,12,90,2020,2020_11_HOU_NWE
LAC,2020-11-15,5,Sun,9,10,@,MIA,L 21-29,5,31,3,15,8,46,2020,2020_10_LAC_MIA
NOR,2020-11-15,5,Sun,9,10,,SFO,W 27-13,5,61,6,51,11,112,2020,2020_10_NOR_SFO
CAR,2020-11-15,5,Sun,10,10,,TAM,L 23-46,5,40,3,30,8,70,2020,2020_10_CAR_TAM
DEN,2020-11-08,5,Sun,8,9,@,ATL,L 27-34,5,65,5,61,10,126,2020,2020_09_DEN_ATL
BAL,2020-11-08,5,Sun,8,9,@,IND,W 24-10,5,55,4,30,9,85,2020,2020_09_BAL_IND
ATL,2020-11-08,5,Sun,9,9,,DEN,W 34-27,5,61,5,65,10,126,2020,2020_09_ATL_DEN
TAM,2020-11-08,5,Sun,9,9,,NOR,L 3-38,5,39,3,28,8,67,2020,2020_09_TAM_NOR
CHI,2020-11-08,5,Sun,9,9,@,TEN,L 17-24,5,35,6,57,11,92,2020,2020_09_CHI_TEN
LAC,2020-11-08,5,Sun,8,9,,LVR,L 26-31,5,45,2,10,7,55,2020,2020_09_LAC_LVR
GNB,2020-11-05,5,Thu,8,9,@,SFO,W 34-17,5,45,4,33,9,78,2020,2020_09_GNB_SFO
NWE,2020-11-01,5,Sun,7,8,@,BUF,L 21-24,5,35,5,30,10,65,2020,2020_08_NWE_BUF
NOR,2020-11-01,5,Sun,7,8,@,CHI,W 26-23 (OT),5,45,7,53,12,98,2020,2020_08_NOR_CHI
LVR,2020-11-01,5,Sun,7,8,@,CLE,W 16-6,5,25,7,59,12,84,2020,2020_08_LVR_CLE
LAR,2020-11-01,5,Sun,8,8,@,MIA,L 17-28,5,45,3,30,8,75,2020,2020_08_LAR_MIA
BUF,2020-11-01,5,Sun,8,8,,NWE,W 24-21,5,30,5,35,10,65,2020,2020_08_BUF_NWE
DET,2020-10-25,5,Sun,6,7,@,ATL,W 23-22,5,50,8,53,13,103,2020,2020_07_DET_ATL
CLE,2020-10-25,5,Sun,7,7,@,CIN,W 37-34,5,40,7,45,12,85,2020,2020_07_CLE_CIN
GNB,2020-10-25,5,Sun,6,7,@,HOU,W 35-20,5,40,6,55,11,95,2020,2020_07_GNB_HOU
DEN,2020-10-25,5,Sun,6,7,,KAN,L 16-43,5,34,1,15,6,49,2020,2020_07_DEN_KAN
JAX,2020-10-18,5,Sun,6,6,,DET,L 16-34,5,56,7,60,12,116,2020,2020_06_JAX_DET
ATL,2020-10-18,5,Sun,6,6,@,MIN,W 40-23,5,25,3,30,8,55,2020,2020_06_ATL_MIN
MIA,2020-10-18,5,Sun,6,6,,NYJ,W 24-0,5,25,7,80,12,105,2020,2020_06_MIA_NYJ
NOR,2020-10-12,5,Mon,5,5,,LAC,W 30-27 (OT),5,60,1,10,6,70,2020,2020_05_NOR_LAC
IND,2020-10-11,5,Sun,5,5,@,CLE,L 23-32,5,34,2,10,7,44,2020,2020_05_IND_CLE
HOU,2020-10-11,5,Sun,5,5,,JAX,W 30-14,5,25,4,35,9,60,2020,2020_05_HOU_JAX
CIN,2020-10-11,5,Sun,5,5,@,BAL,L 3-27,5,40,4,25,9,65,2020,2020_05_CIN_BAL
LAR,2020-10-11,5,Sun,5,5,@,WAS,W 30-10,5,60,3,40,8,100,2020,2020_05_LAR_WAS
ARI,2020-10-04,5,Sun,4,4,@,CAR,L 21-31,5,29,10,72,15,101,2020,2020_04_ARI_CAR
CLE,2020-10-04,5,Sun,4,4,@,DAL,W 49-38,5,40,6,65,11,105,2020,2020_04_CLE_DAL
DET,2020-10-04,5,Sun,4,4,,NOR,L 29-35,5,49,4,67,9,116,2020,2020_04_DET_NOR
BUF,2020-10-04,5,Sun,4,4,@,LVR,W 30-23,5,81,7,65,12,146,2020,2020_04_BUF_LVR
BAL,2020-10-04,5,Sun,4,4,@,WAS,W 31-17,5,30,2,20,7,50,2020,2020_04_BAL_WAS
SEA,2020-09-27,5,Sun,3,3,,DAL,W 38-31,5,30,10,59,15,89,2020,2020_03_SEA_DAL
BUF,2020-09-27,5,Sun,3,3,,LAR,W 35-32,5,55,3,30,8,85,2020,2020_03_BUF_LAR
NYG,2020-09-27,5,Sun,3,3,,SFO,L 9-36,5,28,6,45,11,73,2020,2020_03_NYG_SFO
TAM,2020-09-20,5,Sun,2,2,,CAR,W 31-17,5,37,9,77,14,114,2020,2020_02_TAM_CAR
CHI,2020-09-20,5,Sun,2,2,,NYG,W 17-13,5,48,3,10,8,58,2020,2020_02_CHI_NYG
SFO,2020-09-20,5,Sun,2,2,@,NYJ,W 31-13,5,59,5,65,10,124,2020,2020_02_SFO_NYJ
PHI,2020-09-20,5,Sun,2,2,,LAR,L 19-37,5,30,4,24,9,54,2020,2020_02_PHI_LAR
NYJ,2020-09-20,5,Sun,2,2,,SFO,L 13-31,5,65,5,59,10,124,2020,2020_02_NYJ_SFO
TEN,2020-09-14,5,Mon,1,1,@,DEN,W 16-14,5,37,5,56,10,93,2020,2020_01_TEN_DEN
DEN,2020-09-14,5,Mon,1,1,,TEN,L 14-16,5,56,5,37,10,93,2020,2020_01_DEN_TEN
SFO,2020-09-13,5,Sun,1,1,,ARI,L 20-24,5,53,9,102,14,155,2020,2020_01_SFO_ARI
LAR,2020-09-13,5,Sun,1,1,,DAL,W 20-17,5,34,7,50,12,84,2020,2020_01_LAR_DAL
MIN,2020-09-13,5,Sun,1,1,,GNB,L 34-43,5,20,6,63,11,83,2020,2020_01_MIN_GNB
IND,2020-09-13,5,Sun,1,1,@,JAX,L 20-27,5,80,6,61,11,141,2020,2020_01_IND_JAX
CAR,2020-09-13,5,Sun,1,1,,LVR,L 30-34,5,65,3,40,8,105,2020,2020_01_CAR_LVR
HOU,2020-09-10,5,Thu,1,1,@,KAN,L 20-34,5,37,1,5,6,42,2020,2020_01_HOU_KAN
TEN,2019-12-29,5,Sun,16,17,@,HOU,W 35-14,5,37,5,35,10,72,2019,2019_17_TEN_HOU
CAR,2019-12-29,5,Sun,16,17,,NOR,L 10-42,5,54,3,44,8,98,2019,2019_17_CAR_NOR
BUF,2019-12-29,5,Sun,16,17,,NYJ,L 6-13,5,40,2,13,7,53,2019,2019_17_BUF_NYJ
HOU,2019-12-29,5,Sun,16,17,,TEN,L 14-35,5,35,5,37,10,72,2019,2019_17_HOU_TEN
KAN,2019-12-29,5,Sun,16,17,,LAC,W 31-21,5,39,8,40,13,79,2019,2019_17_KAN_LAC
SEA,2019-12-29,5,Sun,16,17,,SFO,L 21-26,5,29,8,57,13,86,2019,2019_17_SEA_SFO
ATL,2019-12-29,5,Sun,16,17,@,TAM,W 28-22 (OT),5,53,12,97,17,150,2019,2019_17_ATL_TAM
OAK,2019-12-22,5,Sun,15,16,@,LAC,W 24-17,5,47,2,15,7,62,2019,2019_16_OAK_LAC
ARI,2019-12-22,5,Sun,15,16,@,SEA,W 27-13,5,47,7,55,12,102,2019,2019_16_ARI_SEA
LAC,2019-12-15,5,Sun,14,15,,MIN,L 10-39,5,48,5,41,10,89,2019,2019_15_LAC_MIN
CIN,2019-12-15,5,Sun,14,15,,NWE,L 13-34,5,25,4,30,9,55,2019,2019_15_CIN_NWE
HOU,2019-12-15,5,Sun,14,15,@,TEN,W 24-21,5,27,4,30,9,57,2019,2019_15_HOU_TEN
WAS,2019-12-15,5,Sun,14,15,,PHI,L 27-37,5,60,7,54,12,114,2019,2019_15_WAS_PHI
MIN,2019-12-15,5,Sun,14,15,@,LAC,W 39-10,5,41,5,48,10,89,2019,2019_15_MIN_LAC
SEA,2019-12-15,5,Sun,14,15,@,CAR,W 30-24,5,40,2,15,7,55,2019,2019_15_SEA_CAR
ARI,2019-12-15,5,Sun,14,15,,CLE,W 38-24,5,34,6,55,11,89,2019,2019_15_ARI_CLE
LAR,2019-12-15,5,Sun,14,15,@,DAL,L 21-44,5,29,4,16,9,45,2019,2019_15_LAR_DAL
KAN,2019-12-15,5,Sun,14,15,,DEN,W 23-3,5,45,7,72,12,117,2019,2019_15_KAN_DEN
NWE,2019-12-08,5,Sun,13,14,,KAN,L 16-23,5,25,10,136,15,161,2019,2019_14_NWE_KAN
NYJ,2019-12-08,5,Sun,13,14,,MIA,W 22-21,5,88,5,48,10,136,2019,2019_14_NYJ_MIA
MIA,2019-12-08,5,Sun,13,14,@,NYJ,L 21-22,5,48,5,88,10,136,2019,2019_14_MIA_NYJ
BUF,2019-12-08,5,Sun,13,14,,BAL,L 17-24,5,49,9,99,14,148,2019,2019_14_BUF_BAL
NOR,2019-12-08,5,Sun,13,14,,SFO,L 46-48,5,50,10,67,15,117,2019,2019_14_NOR_SFO
GNB,2019-12-08,5,Sun,13,14,,WAS,W 20-15,5,34,3,25,8,59,2019,2019_14_GNB_WAS
CLE,2019-12-01,5,Sun,12,13,@,PIT,L 13-20,5,34,10,65,15,99,2019,2019_13_CLE_PIT
CAR,2019-12-01,5,Sun,12,13,,WAS,L 21-29,5,43,6,65,11,108,2019,2019_13_CAR_WAS
DAL,2019-11-28,5,Thu,12,13,,BUF,L 15-26,5,66,7,53,12,119,2019,2019_13_DAL_BUF
GNB,2019-11-24,5,Sun,11,12,@,SFO,L 8-37,5,50,9,78,14,128,2019,2019_12_GNB_SFO
BUF,2019-11-17,5,Sun,10,11,@,MIA,W 37-20,5,50,6,44,11,94,2019,2019_11_BUF_MIA
HOU,2019-11-17,5,Sun,10,11,@,BAL,L 7-41,5,60,8,65,13,125,2019,2019_11_HOU_BAL
MIN,2019-11-17,5,Sun,11,11,,DEN,W 27-23,5,49,6,35,11,84,2019,2019_11_MIN_DEN
SFO,2019-11-11,5,Mon,9,10,,SEA,L 24-27 (OT),5,40,9,75,14,115,2019,2019_10_SFO_SEA
DAL,2019-11-10,5,Sun,9,10,,MIN,L 24-28,5,39,5,35,10,74,2019,2019_10_DAL_MIN
BAL,2019-11-10,5,Sun,9,10,@,CIN,W 49-13,5,35,1,5,6,40,2019,2019_10_BAL_CIN
MIN,2019-11-10,5,Sun,10,10,@,DAL,W 28-24,5,35,5,39,10,74,2019,2019_10_MIN_DAL
CAR,2019-11-10,5,Sun,9,10,@,GNB,L 16-24,5,46,10,64,15,110,2019,2019_10_CAR_GNB
PIT,2019-11-03,5,Sun,8,9,,IND,W 26-24,5,70,7,89,12,159,2019,2019_09_PIT_IND
CLE,2019-11-03,5,Sun,8,9,@,DEN,L 19-24,5,40,7,55,12,95,2019,2019_09_CLE_DEN
LAC,2019-11-03,5,Sun,9,9,,GNB,W 26-11,5,45,8,45,13,90,2019,2019_09_LAC_GNB
DET,2019-11-03,5,Sun,8,9,@,OAK,L 24-31,5,35,10,96,15,131,2019,2019_09_DET_OAK
MIA,2019-10-28,5,Mon,7,8,@,PIT,L 14-27,5,45,9,70,14,115,2019,2019_08_MIA_PIT
ARI,2019-10-27,5,Sun,8,8,@,NOR,L 9-31,5,35,2,15,7,50,2019,2019_08_ARI_NOR
CHI,2019-10-27,5,Sun,7,8,,LAC,L 16-17,5,42,8,53,13,95,2019,2019_08_CHI_LAC
ATL,2019-10-27,5,Sun,8,8,,SEA,L 20-27,5,40,9,60,14,100,2019,2019_08_ATL_SEA
NYG,2019-10-27,5,Sun,8,8,@,DET,L 26-31,5,44,7,75,12,119,2019,2019_08_NYG_DET
LAR,2019-10-20,5,Sun,7,7,@,ATL,W 37-10,5,24,5,48,10,72,2019,2019_07_LAR_ATL
PHI,2019-10-20,5,Sun,7,7,@,DAL,L 10-37,5,40,6,65,11,105,2019,2019_07_PHI_DAL
ATL,2019-10-20,5,Sun,7,7,,LAR,L 10-37,5,48,5,24,10,72,2019,2019_07_ATL_LAR
MIA,2019-10-13,5,Sun,5,6,,WAS,L 16-17,5,45,6,56,11,101,2019,2019_06_MIA_WAS
NYG,2019-10-10,5,Thu,6,6,@,NWE,L 14-35,5,40,3,20,8,60,2019,2019_06_NYG_NWE
NYG,2019-10-06,5,Sun,5,5,,MIN,L 10-28,5,45,12,112,17,157,2019,2019_05_NYG_MIN
SEA,2019-10-03,5,Thu,5,5,,LAR,W 30-29,5,45,6,45,11,90,2019,2019_05_SEA_LAR
DEN,2019-09-29,5,Sun,4,4,,JAX,L 24-26,5,48,12,104,17,152,2019,2019_04_DEN_JAX
IND,2019-09-29,5,Sun,4,4,,OAK,L 24-31,5,35,11,80,16,115,2019,2019_04_IND_OAK
MIA,2019-09-29,5,Sun,4,4,,LAC,L 10-30,5,53,10,89,15,142,2019,2019_04_MIA_LAC
NYG,2019-09-29,5,Sun,4,4,,WAS,W 24-3,5,45,12,58,17,103,2019,2019_04_NYG_WAS
TEN,2019-09-29,5,Sun,4,4,@,ATL,W 24-10,5,77,7,50,12,127,2019,2019_04_TEN_ATL
GNB,2019-09-26,5,Thu,4,4,,PHI,L 27-34,5,50,9,93,14,143,2019,2019_04_GNB_PHI
NYJ,2019-09-22,5,Sun,3,3,@,NWE,L 14-30,5,67,8,70,13,137,2019,2019_03_NYJ_NWE
SFO,2019-09-22,5,Sun,3,3,,PIT,W 24-20,5,71,6,42,11,113,2019,2019_03_SFO_PIT
MIA,2019-09-22,5,Sun,3,3,@,DAL,L 6-31,5,35,8,100,13,135,2019,2019_03_MIA_DAL
TEN,2019-09-15,5,Sun,2,2,,IND,L 17-19,5,75,8,65,13,140,2019,2019_02_TEN_IND
NWE,2019-09-15,5,Sun,2,2,@,MIA,W 43-0,5,54,4,22,9,76,2019,2019_02_NWE_MIA
PIT,2019-09-15,5,Sun,2,2,,SEA,L 26-28,5,78,10,93,15,171,2019,2019_02_PIT_SEA
CAR,2019-09-12,5,Thu,2,2,,TAM,L 14-20,5,50,12,66,17,116,2019,2019_02_CAR_TAM
KAN,2019-09-08,5,Sun,1,1,@,JAX,W 40-26,5,55,10,71,15,126,2019,2019_01_KAN_JAX
LAR,2019-09-08,5,Sun,1,1,@,CAR,W 30-27,5,43,6,46,11,89,2019,2019_01_LAR_CAR
GNB,2018-12-30,5,Sun,16,17,,DET,L 0-31,5,38,3,34,8,72,2018,2018_17_GNB_DET
SFO,2018-12-30,5,Sun,16,17,@,LAR,L 32-48,5,41,6,57,11,98,2018,2018_17_SFO_LAR
PHI,2018-12-30,5,Sun,16,17,@,WAS,W 24-0,5,25,2,15,7,40,2018,2018_17_PHI_WAS
NWE,2018-12-23,5,Sun,15,16,,BUF,W 24-12,5,49,3,29,8,78,2018,2018_16_NWE_BUF
LAR,2018-12-16,5,Sun,14,15,,PHI,L 23-30,5,50,6,49,11,99,2018,2018_15_LAR_PHI
HOU,2018-12-15,5,Sat,14,15,@,NYJ,W 29-22,5,43,9,60,14,103,2018,2018_15_HOU_NYJ
PHI,2018-12-09,5,Sun,13,14,@,DAL,L 23-29 (OT),5,49,11,110,16,159,2018,2018_14_PHI_DAL
NWE,2018-12-09,5,Sun,13,14,@,MIA,L 33-34,5,30,7,81,12,111,2018,2018_14_NWE_MIA
PHI,2018-12-03,5,Mon,12,13,,WAS,W 28-13,5,38,10,69,15,107,2018,2018_13_PHI_WAS
HOU,2018-12-02,5,Sun,12,13,,CLE,W 29-13,5,77,6,45,11,122,2018,2018_13_HOU_CLE
MIN,2018-12-02,5,Sun,12,13,@,NWE,L 10-24,5,55,7,60,12,115,2018,2018_13_MIN_NWE
LAC,2018-12-02,5,Sun,12,13,@,PIT,W 33-30,5,80,7,59,12,139,2018,2018_13_LAC_PIT
NOR,2018-11-29,5,Thu,12,13,@,DAL,L 10-13,5,48,8,80,13,128,2018,2018_13_NOR_DAL
PIT,2018-11-25,5,Sun,11,12,@,DEN,L 17-24,5,34,6,50,11,84,2018,2018_12_PIT_DEN
DET,2018-11-22,5,Thu,11,12,,CHI,L 16-23,5,54,3,20,8,74,2018,2018_12_DET_CHI
BAL,2018-11-18,5,Sun,10,11,,CIN,W 24-21,5,31,7,58,12,89,2018,2018_11_BAL_CIN
CHI,2018-11-18,5,Sun,10,11,,MIN,W 25-20,5,46,4,50,9,96,2018,2018_11_CHI_MIN
GNB,2018-11-15,5,Thu,10,11,@,SEA,L 24-27,5,80,6,30,11,110,2018,2018_11_GNB_SEA
DAL,2018-11-11,5,Sun,9,10,@,PHI,W 27-20,5,37,0,0,5,37,2018,2018_10_DAL_PHI
TAM,2018-11-11,5,Sun,9,10,,WAS,L 3-16,5,50,8,52,13,102,2018,2018_10_TAM_WAS
CAR,2018-11-08,5,Thu,9,10,@,PIT,L 21-52,5,42,1,24,6,66,2018,2018_10_CAR_PIT
NWE,2018-11-04,5,Sun,9,9,,GNB,W 31-17,5,30,7,63,12,93,2018,2018_09_NWE_GNB
NYJ,2018-11-04,5,Sun,9,9,@,MIA,L 6-13,5,45,5,55,10,100,2018,2018_09_NYJ_MIA
MIA,2018-11-04,5,Sun,9,9,,NYJ,W 13-6,5,55,5,45,10,100,2018,2018_09_MIA_NYJ
BAL,2018-11-04,5,Sun,9,9,,PIT,L 16-23,5,25,8,103,13,128,2018,2018_09_BAL_PIT
NWE,2018-10-29,5,Mon,8,8,@,BUF,W 25-6,5,33,6,51,11,84,2018,2018_08_NWE_BUF
SFO,2018-10-28,5,Sun,8,8,@,ARI,L 15-18,5,59,9,62,14,121,2018,2018_08_SFO_ARI
JAX,2018-10-28,5,Sun,8,8,,PHI,L 18-24,5,45,4,36,9,81,2018,2018_08_JAX_PHI
MIA,2018-10-25,5,Thu,8,8,@,HOU,L 23-42,5,63,8,57,13,120,2018,2018_08_MIA_HOU
ATL,2018-10-22,5,Mon,7,7,,NYG,W 23-20,5,29,4,58,9,87,2018,2018_07_ATL_NYG
WAS,2018-10-21,5,Sun,6,7,,DAL,W 20-17,5,35,8,65,13,100,2018,2018_07_WAS_DAL
BAL,2018-10-21,5,Sun,7,7,,NOR,L 23-24,5,54,6,52,11,106,2018,2018_07_BAL_NOR
CHI,2018-10-21,5,Sun,6,7,,NWE,L 31-38,5,40,7,64,12,104,2018,2018_07_CHI_NWE
CAR,2018-10-21,5,Sun,6,7,@,PHI,W 21-17,5,78,4,35,9,113,2018,2018_07_CAR_PHI
DEN,2018-10-18,5,Thu,7,7,@,ARI,W 45-10,5,50,7,45,12,95,2018,2018_07_DEN_ARI
WAS,2018-10-14,5,Sun,5,6,,CAR,W 23-17,5,43,8,55,13,98,2018,2018_06_WAS_CAR
ARI,2018-10-14,5,Sun,6,6,@,MIN,L 17-27,5,30,9,52,14,82,2018,2018_06_ARI_MIN
KAN,2018-10-14,5,Sun,6,6,@,NWE,L 40-43,5,58,0,0,5,58,2018,2018_06_KAN_NWE
OAK,2018-10-14,5,Sun,6,6,,SEA,L 3-27,5,38,8,64,13,102,2018,2018_06_OAK_SEA
ATL,2018-10-14,5,Sun,6,6,,TAM,W 34-29,5,30,4,20,9,50,2018,2018_06_ATL_TAM
NYG,2018-10-11,5,Thu,6,6,,PHI,L 13-34,5,61,4,25,9,86,2018,2018_06_NYG_PHI
TEN,2018-10-07,5,Sun,5,5,@,BUF,L 12-13,5,40,4,30,9,70,2018,2018_05_TEN_BUF
HOU,2018-10-07,5,Sun,5,5,,DAL,W 19-16 (OT),5,25,7,72,12,97,2018,2018_05_HOU_DAL
JAX,2018-10-07,5,Sun,5,5,@,KAN,L 14-30,5,45,11,105,16,150,2018,2018_05_JAX_KAN
ARI,2018-10-07,5,Sun,5,5,@,SFO,W 28-18,5,46,9,65,14,111,2018,2018_05_ARI_SFO
GNB,2018-09-30,5,Sun,4,4,,BUF,W 22-0,5,60,3,20,8,80,2018,2018_04_GNB_BUF
NOR,2018-09-30,5,Sun,4,4,@,NYG,W 33-18,5,51,6,67,11,118,2018,2018_04_NOR_NYG
PIT,2018-09-30,5,Sun,4,4,,BAL,L 14-26,5,40,7,50,12,90,2018,2018_04_PIT_BAL
ARI,2018-09-30,5,Sun,4,4,,SEA,L 17-20,5,38,8,57,13,95,2018,2018_04_ARI_SEA
LAC,2018-09-30,5,Sun,4,4,,SFO,W 29-27,5,49,4,29,9,78,2018,2018_04_LAC_SFO
NWE,2018-09-23,5,Sun,3,3,@,DET,L 10-26,5,38,6,70,11,108,2018,2018_03_NWE_DET
ATL,2018-09-23,5,Sun,3,3,,NOR,L 37-43 (OT),5,54,11,120,16,174,2018,2018_03_ATL_NOR
CLE,2018-09-20,5,Thu,3,3,,NYJ,W 21-17,5,41,6,55,11,96,2018,2018_03_CLE_NYJ
SEA,2018-09-17,5,Mon,2,2,@,CHI,L 17-24,5,37,7,55,12,92,2018,2018_02_SEA_CHI
LAR,2018-09-16,5,Sun,2,2,,ARI,W 34-0,5,49,9,47,14,96,2018,2018_02_LAR_ARI
CHI,2018-09-09,5,Sun,1,1,@,GNB,L 23-24,5,35,8,72,13,107,2018,2018_01_CHI_GNB
TEN,2018-09-09,5,Sun,1,1,@,MIA,L 20-27,5,48,7,51,12,99,2018,2018_01_TEN_MIA
CAR,2017-12-31,5,Sun,16,17,@,ATL,L 10-22,5,35,7,60,12,95,2017,2017_17_CAR_ATL
BAL,2017-12-31,5,Sun,16,17,,CIN,L 27-31,5,47,6,60,11,107,2017,2017_17_BAL_CIN
DET,2017-12-31,5,Sun,16,17,,GNB,W 35-11,5,62,8,68,13,130,2017,2017_17_DET_GNB
CIN,2017-12-24,5,Sun,15,16,,DET,W 26-17,5,60,9,74,14,134,2017,2017_16_CIN_DET
CIN,2017-12-24,5,Sun,15,16,,DET,W 26-17,5,60,9,74,14,134,2017,2017_16_CIN_DET
NYJ,2017-12-24,5,Sun,15,16,,LAC,L 7-14,5,34,8,80,13,114,2017,2017_16_NYJ_LAC
KAN,2017-12-24,5,Sun,15,16,,MIA,W 29-13,5,40,11,75,16,115,2017,2017_16_KAN_MIA
LAR,2017-12-24,5,Sun,15,16,@,TEN,W 27-23,5,44,5,54,10,98,2017,2017_16_LAR_TEN
BAL,2017-12-23,5,Sat,15,16,,IND,W 23-16,5,25,2,19,7,44,2017,2017_16_BAL_IND
CIN,2017-12-17,5,Sun,14,15,@,MIN,L 7-34,5,44,11,93,16,137,2017,2017_15_CIN_MIN
NYG,2017-12-17,5,Sun,14,15,,PHI,L 29-34,5,67,7,44,12,111,2017,2017_15_NYG_PHI
CAR,2017-12-17,5,Sun,14,15,,GNB,W 31-24,5,40,6,28,11,68,2017,2017_15_CAR_GNB
BAL,2017-12-10,5,Sun,13,14,@,PIT,L 38-39,5,35,6,101,11,136,2017,2017_14_BAL_PIT
LAC,2017-12-10,5,Sun,13,14,,WAS,W 30-13,5,40,4,48,9,88,2017,2017_14_LAC_WAS
ARI,2017-12-10,5,Sun,13,14,,TEN,W 12-7,5,30,6,48,11,78,2017,2017_14_ARI_TEN
LAC,2017-12-03,5,Sun,12,13,,CLE,W 19-10,5,62,4,24,9,86,2017,2017_13_LAC_CLE
NYJ,2017-12-03,5,Sun,12,13,,KAN,W 38-31,5,40,8,30,13,70,2017,2017_13_NYJ_KAN
SEA,2017-12-03,5,Sun,12,13,,PHI,W 24-10,5,46,7,64,12,110,2017,2017_13_SEA_PHI
PIT,2017-11-26,5,Sun,11,12,,GNB,W 31-28,5,45,3,27,8,72,2017,2017_12_PIT_GNB
JAX,2017-11-26,5,Sun,11,12,@,ARI,L 24-27,5,45,10,98,15,143,2017,2017_12_JAX_ARI
LAC,2017-11-23,5,Thu,11,12,@,DAL,W 28-6,5,56,7,60,12,116,2017,2017_12_LAC_DAL
DEN,2017-11-19,5,Sun,10,11,,CIN,L 17-20,5,50,3,14,8,64,2017,2017_11_DEN_CIN
NYG,2017-11-19,5,Sun,10,11,,KAN,W 12-9 (OT),5,48,9,87,14,135,2017,2017_11_NYG_KAN
GNB,2017-11-19,5,Sun,10,11,,BAL,L 0-23,5,53,3,30,8,83,2017,2017_11_GNB_BAL
CHI,2017-11-19,5,Sun,10,11,,DET,L 24-27,5,64,6,49,11,113,2017,2017_11_CHI_DET
TEN,2017-11-12,5,Sun,9,10,,CIN,W 24-20,5,55,12,84,17,139,2017,2017_10_TEN_CIN
DEN,2017-11-12,5,Sun,9,10,,NWE,L 16-41,5,28,1,5,6,33,2017,2017_10_DEN_NWE
DAL,2017-11-12,5,Sun,9,10,@,ATL,L 7-27,5,54,5,35,10,89,2017,2017_10_DAL_ATL
ATL,2017-11-12,5,Sun,9,10,,DAL,W 27-7,5,35,5,54,10,89,2017,2017_10_ATL_DAL
GNB,2017-11-12,5,Sun,9,10,@,CHI,W 23-16,5,35,8,78,13,113,2017,2017_10_GNB_CHI
JAX,2017-11-05,5,Sun,8,9,,CIN,W 23-7,5,50,8,77,13,127,2017,2017_09_JAX_CIN
CAR,2017-11-05,5,Sun,9,9,,ATL,W 20-17,5,29,8,70,13,99,2017,2017_09_CAR_ATL
DAL,2017-11-05,5,Sun,8,9,,KAN,W 28-17,5,65,8,52,13,117,2017,2017_09_DAL_KAN
PHI,2017-11-05,5,Sun,9,9,,DEN,W 51-23,5,35,14,105,19,140,2017,2017_09_PHI_DEN
MIN,2017-10-29,5,Sun,8,8,@,CLE,W 33-16,5,58,5,74,10,132,2017,2017_08_MIN_CLE
WAS,2017-10-29,5,Sun,7,8,,DAL,L 19-33,5,32,8,89,13,121,2017,2017_08_WAS_DAL
CLE,2017-10-29,5,Sun,8,8,,MIN,L 16-33,5,74,5,58,10,132,2017,2017_08_CLE_MIN
CIN,2017-10-29,5,Sun,7,8,,IND,W 24-23,5,54,7,45,12,99,2017,2017_08_CIN_IND
PIT,2017-10-29,5,Sun,8,8,@,DET,W 20-15,5,37,6,57,11,94,2017,2017_08_PIT_DET
CAR,2017-10-29,5,Sun,8,8,@,TAM,W 17-3,5,51,6,55,11,106,2017,2017_08_CAR_TAM
BAL,2017-10-26,5,Thu,8,8,,MIA,W 40-0,5,40,7,43,12,83,2017,2017_08_BAL_MIA
WAS,2017-10-23,5,Mon,6,7,@,PHI,L 24-34,5,55,9,55,14,110,2017,2017_07_WAS_PHI
CIN,2017-10-22,5,Sun,6,7,@,PIT,L 14-29,5,54,1,5,6,59,2017,2017_07_CIN_PIT
CHI,2017-10-22,5,Sun,7,7,,CAR,W 17-3,5,40,4,35,9,75,2017,2017_07_CHI_CAR
TEN,2017-10-22,5,Sun,7,7,@,CLE,W 12-9 (OT),5,35,12,81,17,116,2017,2017_07_TEN_CLE
IND,2017-10-22,5,Sun,7,7,,JAX,L 0-27,5,55,4,34,9,89,2017,2017_07_IND_JAX
TAM,2017-10-22,5,Sun,6,7,@,BUF,L 27-30,5,55,4,35,9,90,2017,2017_07_TAM_BUF
DAL,2017-10-22,5,Sun,6,7,@,SFO,W 40-10,5,36,2,22,7,58,2017,2017_07_DAL_SFO
IND,2017-10-16,5,Mon,6,6,@,TEN,L 22-36,5,51,4,45,9,96,2017,2017_06_IND_TEN
JAX,2017-10-15,5,Sun,6,6,,LAR,L 17-27,5,40,7,70,12,110,2017,2017_06_JAX_LAR
DEN,2017-10-15,5,Sun,5,6,,NYG,L 10-23,5,46,5,77,10,123,2017,2017_06_DEN_NYG
CHI,2017-10-15,5,Sun,6,6,@,BAL,W 27-24 (OT),5,44,8,69,13,113,2017,2017_06_CHI_BAL
OAK,2017-10-15,5,Sun,6,6,,LAC,L 16-17,5,40,4,32,9,72,2017,2017_06_OAK_LAC
NYG,2017-10-15,5,Sun,6,6,@,DEN,W 23-10,5,77,5,46,10,123,2017,2017_06_NYG_DEN
WAS,2017-10-15,5,Sun,5,6,,SFO,W 26-24,5,43,7,40,12,83,2017,2017_06_WAS_SFO
LAR,2017-10-08,5,Sun,5,5,,SEA,L 10-16,5,45,7,40,12,85,2017,2017_05_LAR_SEA
PIT,2017-10-08,5,Sun,5,5,,JAX,L 9-30,5,37,4,19,9,56,2017,2017_05_PIT_JAX
PHI,2017-10-08,5,Sun,5,5,,ARI,W 34-7,5,60,7,61,12,121,2017,2017_05_PHI_ARI
MIA,2017-10-08,5,Sun,4,5,,TEN,W 16-10,5,23,11,77,16,100,2017,2017_05_MIA_TEN
IND,2017-10-01,5,Sun,4,4,@,SEA,L 18-46,5,31,6,45,11,76,2017,2017_04_IND_SEA
TEN,2017-09-24,5,Sun,3,3,,SEA,W 33-27,5,45,11,98,16,143,2017,2017_03_TEN_SEA
NWE,2017-09-24,5,Sun,3,3,,HOU,W 36-33,5,69,10,60,15,129,2017,2017_03_NWE_HOU
MIN,2017-09-24,5,Sun,3,3,,TAM,W 34-17,5,53,7,37,12,90,2017,2017_03_MIN_TAM
NOR,2017-09-17,5,Sun,2,2,,NWE,L 20-36,5,35,9,66,14,101,2017,2017_02_NOR_NWE
BUF,2017-09-17,5,Sun,2,2,@,CAR,L 3-9,5,44,6,40,11,84,2017,2017_02_BUF_CAR
NYJ,2017-09-17,5,Sun,2,2,@,OAK,L 20-45,5,47,9,79,14,126,2017,2017_02_NYJ_OAK
MIA,2017-09-17,5,Sun,1,2,@,LAC,W 19-17,5,23,6,56,11,79,2017,2017_02_MIA_LAC
KAN,2017-09-17,5,Sun,2,2,,PHI,W 27-20,5,40,4,30,9,70,2017,2017_02_KAN_PHI
MIN,2017-09-11,5,Mon,1,1,,NOR,W 29-19,5,50,6,52,11,102,2017,2017_01_MIN_NOR
DAL,2017-09-10,5,Sun,1,1,,NYG,W 19-3,5,50,6,55,11,105,2017,2017_01_DAL_NYG
TEN,2017-09-10,5,Sun,1,1,,OAK,L 16-26,5,49,5,49,10,98,2017,2017_01_TEN_OAK
NYJ,2017-09-10,5,Sun,1,1,@,BUF,L 12-21,5,62,6,50,11,112,2017,2017_01_NYJ_BUF
CAR,2017-09-10,5,Sun,1,1,@,SFO,W 23-3,5,40,10,74,15,114,2017,2017_01_CAR_SFO
OAK,2017-09-10,5,Sun,1,1,@,TEN,W 26-16,5,49,5,49,10,98,2017,2017_01_OAK_TEN
SEA,2023-01-08,4,Sun,17,18,,LAR,W 19-16 (OT),4,20,3,35,7,55,2022,2022_18_SEA_LAR
PIT,2023-01-08,4,Sun,17,18,,CLE,W 28-14,4,20,9,65,13,85,2022,2022_18_PIT_CLE
PHI,2023-01-08,4,Sun,17,18,,NYG,W 22-16,4,30,8,66,12,96,2022,2022_18_PHI_NYG
GNB,2023-01-08,4,Sun,17,18,,DET,L 16-20,4,35,5,75,9,110,2022,2022_18_GNB_DET
JAX,2023-01-07,4,Sat,17,18,,TEN,W 20-16,4,25,6,40,10,65,2022,2022_18_JAX_TEN
BAL,2023-01-01,4,Sun,16,17,,PIT,L 13-16,4,30,6,43,10,73,2022,2022_17_BAL_PIT
HOU,2022-12-24,4,Sat,15,16,@,TEN,W 19-14,4,35,5,30,9,65,2022,2022_16_HOU_TEN
CLE,2022-12-24,4,Sat,15,16,,NOR,L 10-17,4,45,2,15,6,60,2022,2022_16_CLE_NOR
DET,2022-12-24,4,Sat,15,16,@,CAR,L 23-37,4,30,10,74,14,104,2022,2022_16_DET_CAR
SFO,2022-12-24,4,Sat,15,16,,WAS,W 37-20,4,25,6,51,10,76,2022,2022_16_SFO_WAS
DAL,2022-12-24,4,Sat,15,16,,PHI,W 40-34,4,36,2,10,6,46,2022,2022_16_DAL_PHI
GNB,2022-12-19,4,Mon,14,15,,LAR,W 24-12,4,80,8,76,12,156,2022,2022_15_GNB_LAR
CIN,2022-12-18,4,Sun,14,15,@,TAM,W 34-23,4,27,7,58,11,85,2022,2022_15_CIN_TAM
DEN,2022-12-18,4,Sun,14,15,,ARI,W 24-15,4,31,7,46,11,77,2022,2022_15_DEN_ARI
JAX,2022-12-18,4,Sun,14,15,,DAL,W 40-34 (OT),4,37,2,18,6,55,2022,2022_15_JAX_DAL
HOU,2022-12-18,4,Sun,14,15,,KAN,L 24-30 (OT),4,33,10,102,14,135,2022,2022_15_HOU_KAN
KAN,2022-12-11,4,Sun,13,14,@,DEN,W 34-28,4,70,6,38,10,108,2022,2022_14_KAN_DEN
CIN,2022-12-11,4,Sun,13,14,,CLE,W 23-10,4,36,9,98,13,134,2022,2022_14_CIN_CLE
HOU,2022-12-11,4,Sun,13,14,@,DAL,L 23-27,4,25,3,10,7,35,2022,2022_14_HOU_DAL
TAM,2022-12-05,4,Mon,12,13,,NOR,W 17-16,4,39,6,84,10,123,2022,2022_13_TAM_NOR
SFO,2022-12-04,4,Sun,12,13,,MIA,W 33-17,4,45,8,68,12,113,2022,2022_13_SFO_MIA
KAN,2022-12-04,4,Sun,12,13,@,CIN,L 24-27,4,35,6,65,10,100,2022,2022_13_KAN_CIN
LAR,2022-12-04,4,Sun,12,13,,SEA,L 23-27,4,39,6,42,10,81,2022,2022_13_LAR_SEA
NYG,2022-12-04,4,Sun,12,13,,WAS,T 20-20 (OT),4,34,7,55,11,89,2022,2022_13_NYG_WAS
DEN,2022-12-04,4,Sun,12,13,@,BAL,L 9-10,4,48,3,15,7,63,2022,2022_13_DEN_BAL
LAC,2022-12-04,4,Sun,12,13,@,LVR,L 20-27,4,20,3,15,7,35,2022,2022_13_LAC_LVR
CAR,2022-11-27,4,Sun,12,12,,DEN,W 23-10,4,34,4,44,8,78,2022,2022_12_CAR_DEN
LAC,2022-11-27,4,Sun,11,12,@,ARI,W 25-24,4,30,3,19,7,49,2022,2022_12_LAC_ARI
DEN,2022-11-27,4,Sun,11,12,@,CAR,L 10-23,4,44,4,34,8,78,2022,2022_12_DEN_CAR
WAS,2022-11-27,4,Sun,12,12,,ATL,W 19-13,4,28,2,20,6,48,2022,2022_12_WAS_ATL
MIA,2022-11-27,4,Sun,11,12,,HOU,W 30-15,4,35,5,45,9,80,2022,2022_12_MIA_HOU
JAX,2022-11-27,4,Sun,11,12,,BAL,W 28-27,4,19,3,20,7,39,2022,2022_12_JAX_BAL
GNB,2022-11-27,4,Sun,12,12,@,PHI,L 33-40,4,35,3,25,7,60,2022,2022_12_GNB_PHI
LAC,2022-11-20,4,Sun,10,11,,KAN,L 27-30,4,25,4,54,8,79,2022,2022_11_LAC_KAN
KAN,2022-11-20,4,Sun,10,11,@,LAC,W 30-27,4,54,4,25,8,79,2022,2022_11_KAN_LAC
TAM,2022-11-13,4,Sun,10,10,,SEA,W 21-16,4,40,6,46,10,86,2022,2022_10_TAM_SEA
IND,2022-11-13,4,Sun,10,10,@,LVR,W 25-20,4,25,10,74,14,99,2022,2022_10_IND_LVR
ATL,2022-11-10,4,Thu,10,10,@,CAR,L 15-25,4,37,10,89,14,126,2022,2022_10_ATL_CAR
LAR,2022-11-06,4,Sun,8,9,@,TAM,L 13-16,4,53,7,55,11,108,2022,2022_09_LAR_TAM
CHI,2022-11-06,4,Sun,9,9,,MIA,L 32-35,4,92,3,38,7,130,2022,2022_09_CHI_MIA
NWE,2022-11-06,4,Sun,9,9,,IND,W 26-3,4,35,2,15,6,50,2022,2022_09_NWE_IND
JAX,2022-11-06,4,Sun,9,9,,LVR,W 27-20,4,30,5,45,9,75,2022,2022_09_JAX_LVR
PHI,2022-11-03,4,Thu,8,9,@,HOU,W 29-17,4,31,4,24,8,55,2022,2022_09_PHI_HOU
HOU,2022-11-03,4,Thu,8,9,,PHI,L 17-29,4,24,4,31,8,55,2022,2022_09_HOU_PHI
BUF,2022-10-30,4,Sun,7,8,,GNB,W 27-17,4,35,8,58,12,93,2022,2022_08_BUF_GNB
LAR,2022-10-30,4,Sun,7,8,,SFO,L 14-31,4,50,3,8,7,58,2022,2022_08_LAR_SFO
NYJ,2022-10-30,4,Sun,8,8,,NWE,L 17-22,4,41,6,54,10,95,2022,2022_08_NYJ_NWE
TAM,2022-10-27,4,Thu,8,8,,BAL,L 22-27,4,35,7,101,11,136,2022,2022_08_TAM_BAL
NWE,2022-10-24,4,Mon,7,7,,CHI,L 14-33,4,30,4,35,8,65,2022,2022_07_NWE_CHI
CHI,2022-10-24,4,Mon,7,7,@,NWE,W 33-14,4,35,4,30,8,65,2022,2022_07_CHI_NWE
IND,2022-10-23,4,Sun,7,7,@,TEN,L 10-19,4,28,2,15,6,43,2022,2022_07_IND_TEN
TAM,2022-10-23,4,Sun,7,7,@,CAR,L 3-21,4,30,3,15,7,45,2022,2022_07_TAM_CAR
DEN,2022-10-23,4,Sun,7,7,,NYJ,L 9-16,4,34,11,85,15,119,2022,2022_07_DEN_NYJ
ARI,2022-10-20,4,Thu,7,7,,NOR,W 42-34,4,20,8,49,12,69,2022,2022_07_ARI_NOR
NOR,2022-10-16,4,Sun,6,6,,CIN,L 26-30,4,34,3,30,7,64,2022,2022_06_NOR_CIN
JAX,2022-10-16,4,Sun,6,6,@,IND,L 27-34,4,44,7,52,11,96,2022,2022_06_JAX_IND
CHI,2022-10-13,4,Thu,6,6,,WAS,L 7-12,4,42,7,36,11,78,2022,2022_06_CHI_WAS
LAC,2022-10-09,4,Sun,5,5,@,CLE,W 30-28,4,17,6,65,10,82,2022,2022_05_LAC_CLE
HOU,2022-10-09,4,Sun,5,5,@,JAX,W 13-6,4,25,6,48,10,73,2022,2022_05_HOU_JAX
CIN,2022-10-09,4,Sun,5,5,@,BAL,L 17-19,4,20,6,48,10,68,2022,2022_05_CIN_BAL
SFO,2022-10-03,4,Mon,4,4,,LAR,W 24-9,4,25,1,5,5,30,2022,2022_04_SFO_LAR
KAN,2022-10-02,4,Sun,4,4,@,TAM,W 41-31,4,32,5,40,9,72,2022,2022_04_KAN_TAM
LVR,2022-10-02,4,Sun,4,4,,DEN,W 32-23,4,25,7,50,11,75,2022,2022_04_LVR_DEN
GNB,2022-10-02,4,Sun,4,4,,NWE,W 27-24 (OT),4,40,7,75,11,115,2022,2022_04_GNB_NWE
DAL,2022-10-02,4,Sun,4,4,,WAS,W 25-10,4,20,11,136,15,156,2022,2022_04_DAL_WAS
BUF,2022-10-02,4,Sun,4,4,@,BAL,W 23-20,4,31,9,70,13,101,2022,2022_04_BUF_BAL
JAX,2022-10-02,4,Sun,4,4,@,PHI,L 21-29,4,38,3,20,7,58,2022,2022_04_JAX_PHI
MIA,2022-09-25,4,Sun,3,3,,BUF,W 21-19,4,20,7,52,11,72,2022,2022_03_MIA_BUF
NYJ,2022-09-25,4,Sun,3,3,,CIN,L 12-27,4,55,5,30,9,85,2022,2022_03_NYJ_CIN
CAR,2022-09-25,4,Sun,3,3,,NOR,W 22-14,4,40,7,58,11,98,2022,2022_03_CAR_NOR
IND,2022-09-25,4,Sun,3,3,,KAN,W 20-17,4,34,6,45,10,79,2022,2022_03_IND_KAN
WAS,2022-09-25,4,Sun,3,3,,PHI,L 8-24,4,48,5,52,9,100,2022,2022_03_WAS_PHI
MIA,2022-09-11,4,Sun,1,1,,NWE,W 20-7,4,20,3,15,7,35,2022,2022_01_MIA_NWE
CIN,2022-09-11,4,Sun,1,1,,PIT,L 20-23 (OT),4,27,8,59,12,86,2022,2022_01_CIN_PIT
LAR,2022-09-08,4,Thu,1,1,,BUF,L 10-31,4,30,5,35,9,65,2022,2022_01_LAR_BUF
NOR,2022-01-09,4,Sun,17,18,@,ATL,W 30-20,4,40,5,46,9,86,2021,2021_18_NOR_ATL
CIN,2022-01-09,4,Sun,17,18,@,CLE,L 16-21,4,32,4,46,8,78,2021,2021_18_CIN_CLE
IND,2022-01-09,4,Sun,17,18,@,JAX,L 11-26,4,52,6,49,10,101,2021,2021_18_IND_JAX
LVR,2022-01-09,4,Sun,17,18,,LAC,W 35-32 (OT),4,38,10,108,14,146,2021,2021_18_LVR_LAC
BUF,2022-01-09,4,Sun,17,18,,NYJ,W 27-10,4,40,4,27,8,67,2021,2021_18_BUF_NYJ
NYJ,2022-01-09,4,Sun,17,18,@,BUF,L 10-27,4,27,4,40,8,67,2021,2021_18_NYJ_BUF
SEA,2022-01-09,4,Sun,17,18,@,ARI,W 38-30,4,30,6,46,10,76,2021,2021_18_SEA_ARI
MIN,2022-01-09,4,Sun,17,18,,CHI,W 31-17,4,47,2,10,6,57,2021,2021_18_MIN_CHI
HOU,2022-01-09,4,Sun,17,18,,TEN,L 25-28,4,65,5,42,9,107,2021,2021_18_HOU_TEN
CLE,2022-01-09,4,Sun,17,18,,CIN,W 21-16,4,46,4,32,8,78,2021,2021_18_CLE_CIN
LAR,2022-01-02,4,Sun,16,17,@,BAL,W 20-19,4,35,4,24,8,59,2021,2021_17_LAR_BAL
TAM,2022-01-02,4,Sun,16,17,@,NYJ,W 28-24,4,39,2,14,6,53,2021,2021_17_TAM_NYJ
ATL,2022-01-02,4,Sun,16,17,@,BUF,L 15-29,4,27,7,47,11,74,2021,2021_17_ATL_BUF
BAL,2022-01-02,4,Sun,16,17,,LAR,L 19-20,4,24,4,35,8,59,2021,2021_17_BAL_LAR
DET,2022-01-02,4,Sun,16,17,@,SEA,L 29-51,4,30,5,31,9,61,2021,2021_17_DET_SEA
LAR,2021-12-21,4,Tue,14,15,,SEA,W 20-10,4,34,8,65,12,99,2021,2021_15_LAR_SEA
PHI,2021-12-21,4,Tue,14,15,,WAS,W 27-17,4,48,2,25,6,73,2021,2021_15_PHI_WAS
ATL,2021-12-19,4,Sun,14,15,@,SFO,L 13-31,4,29,5,35,9,64,2021,2021_15_ATL_SFO
JAX,2021-12-19,4,Sun,14,15,,HOU,L 16-30,4,40,9,65,13,105,2021,2021_15_JAX_HOU
KAN,2021-12-16,4,Thu,14,15,@,LAC,W 34-28 (OT),4,36,5,60,9,96,2021,2021_15_KAN_LAC
CLE,2021-12-12,4,Sun,13,14,,BAL,W 24-22,4,42,10,129,14,171,2021,2021_14_CLE_BAL
NOR,2021-12-12,4,Sun,13,14,@,NYJ,W 30-9,4,42,5,45,9,87,2021,2021_14_NOR_NYJ
TAM,2021-12-12,4,Sun,13,14,,BUF,W 33-27 (OT),4,24,7,65,11,89,2021,2021_14_TAM_BUF
HOU,2021-12-05,4,Sun,12,13,,IND,L 0-31,4,25,5,25,9,50,2021,2021_13_HOU_IND
WAS,2021-11-29,4,Mon,11,12,,SEA,W 17-15,4,38,6,51,10,89,2021,2021_12_WAS_SEA
PHI,2021-11-28,4,Sun,12,12,@,NYG,L 7-13,4,26,2,15,6,41,2021,2021_12_PHI_NYG
TAM,2021-11-28,4,Sun,11,12,@,IND,W 38-31,4,44,6,66,10,110,2021,2021_12_TAM_IND
HOU,2021-11-28,4,Sun,11,12,,NYJ,L 14-21,4,32,5,40,9,72,2021,2021_12_HOU_NYJ
LAR,2021-11-28,4,Sun,11,12,@,GNB,L 28-36,4,30,3,32,7,62,2021,2021_12_LAR_GNB
NWE,2021-11-28,4,Sun,12,12,,TEN,W 36-13,4,35,5,50,9,85,2021,2021_12_NWE_TEN
PIT,2021-11-28,4,Sun,11,12,@,CIN,L 10-41,4,30,3,18,7,48,2021,2021_12_PIT_CIN
NOR,2021-11-25,4,Thu,11,12,,BUF,L 6-31,4,24,4,35,8,59,2021,2021_12_NOR_BUF
BUF,2021-11-25,4,Thu,11,12,@,NOR,W 31-6,4,35,4,24,8,59,2021,2021_12_BUF_NOR
NYG,2021-11-22,4,Mon,10,11,@,TAM,L 10-30,4,30,6,39,10,69,2021,2021_11_NYG_TAM
KAN,2021-11-14,4,Sun,10,10,@,LVR,W 41-14,4,34,9,68,13,102,2021,2021_10_KAN_LVR
DEN,2021-11-14,4,Sun,10,10,,PHI,L 13-30,4,29,7,89,11,118,2021,2021_10_DEN_PHI
ARI,2021-11-14,4,Sun,10,10,,CAR,L 10-34,4,58,9,115,13,173,2021,2021_10_ARI_CAR
BAL,2021-11-11,4,Thu,9,10,@,MIA,L 10-22,4,20,11,97,15,117,2021,2021_10_BAL_MIA
NYG,2021-11-07,4,Sun,9,9,,LVR,W 23-16,4,35,6,65,10,100,2021,2021_09_NYG_LVR
LAC,2021-11-07,4,Sun,8,9,@,PHI,W 27-24,4,30,3,25,7,55,2021,2021_09_LAC_PHI
TEN,2021-11-07,4,Sun,9,9,@,LAR,W 28-16,4,19,12,115,16,134,2021,2021_09_TEN_LAR
CIN,2021-11-07,4,Sun,9,9,,CLE,L 16-41,4,31,10,84,14,115,2021,2021_09_CIN_CLE
GNB,2021-11-07,4,Sun,9,9,@,KAN,L 7-13,4,19,6,33,10,52,2021,2021_09_GNB_KAN
DEN,2021-10-31,4,Sun,8,8,,WAS,W 17-10,4,35,4,29,8,64,2021,2021_08_DEN_WAS
NWE,2021-10-31,4,Sun,8,8,@,LAC,W 27-24,4,30,5,40,9,70,2021,2021_08_NWE_LAC
WAS,2021-10-31,4,Sun,8,8,@,DEN,L 10-17,4,29,4,35,8,64,2021,2021_08_WAS_DEN
CHI,2021-10-31,4,Sun,8,8,,SFO,L 22-33,4,30,7,55,11,85,2021,2021_08_CHI_SFO
GNB,2021-10-24,4,Sun,7,7,,WAS,W 24-10,4,36,4,50,8,86,2021,2021_07_GNB_WAS
LAR,2021-10-24,4,Sun,7,7,,DET,W 28-19,4,35,8,77,12,112,2021,2021_07_LAR_DET
PHI,2021-10-24,4,Sun,7,7,@,LVR,L 22-33,4,37,7,65,11,102,2021,2021_07_PHI_LVR
CHI,2021-10-24,4,Sun,7,7,@,TAM,L 3-38,4,32,1,10,5,42,2021,2021_07_CHI_TAM
WAS,2021-10-24,4,Sun,7,7,@,GNB,L 10-24,4,50,4,36,8,86,2021,2021_07_WAS_GNB
LAC,2021-10-17,4,Sun,6,6,@,BAL,L 6-34,4,35,2,15,6,50,2021,2021_06_LAC_BAL
HOU,2021-10-17,4,Sun,6,6,@,IND,L 3-31,4,25,2,10,6,35,2021,2021_06_HOU_IND
CIN,2021-10-17,4,Sun,6,6,@,DET,W 34-11,4,31,9,77,13,108,2021,2021_06_CIN_DET
PHI,2021-10-14,4,Thu,6,6,,TAM,L 22-28,4,41,7,120,11,161,2021,2021_06_PHI_TAM
JAX,2021-10-10,4,Sun,5,5,,TEN,L 19-37,4,33,7,44,11,77,2021,2021_05_JAX_TEN
ATL,2021-10-10,4,Sun,5,5,,NYJ,W 27-20,4,66,7,58,11,124,2021,2021_05_ATL_NYJ
DET,2021-10-03,4,Sun,4,4,@,CHI,L 14-24,4,26,7,61,11,87,2021,2021_04_DET_CHI
DEN,2021-10-03,4,Sun,4,4,,BAL,L 7-23,4,25,6,55,10,80,2021,2021_04_DEN_BAL
DAL,2021-09-27,4,Mon,3,3,,PHI,W 41-21,4,37,13,86,17,123,2021,2021_03_DAL_PHI
IND,2021-09-26,4,Sun,3,3,@,TEN,L 16-25,4,66,4,24,8,90,2021,2021_03_IND_TEN
MIN,2021-09-26,4,Sun,3,3,,SEA,W 30-17,4,40,4,35,8,75,2021,2021_03_MIN_SEA
TEN,2021-09-26,4,Sun,3,3,,IND,W 25-16,4,24,4,66,8,90,2021,2021_03_TEN_IND
JAX,2021-09-26,4,Sun,3,3,,ARI,L 19-31,4,40,7,58,11,98,2021,2021_03_JAX_ARI
SFO,2021-09-26,4,Sun,3,3,,GNB,L 28-30,4,86,7,87,11,173,2021,2021_03_SFO_GNB
SEA,2021-09-26,4,Sun,3,3,@,MIN,L 17-30,4,35,4,40,8,75,2021,2021_03_SEA_MIN
NWE,2021-09-26,4,Sun,3,3,,NOR,L 13-28,4,30,2,15,6,45,2021,2021_03_NWE_NOR
ATL,2021-09-26,4,Sun,3,3,@,NYG,W 17-14,4,28,8,53,12,81,2021,2021_03_ATL_NYG
CIN,2021-09-19,4,Sun,2,2,@,CHI,L 17-20,4,57,8,70,12,127,2021,2021_02_CIN_CHI
LAR,2021-09-12,4,Sun,1,1,,CHI,W 34-14,4,36,3,35,7,71,2021,2021_01_LAR_CHI
NYG,2021-09-12,4,Sun,1,1,,DEN,L 13-27,4,48,5,51,9,99,2021,2021_01_NYG_DEN
NOR,2021-01-03,4,Sun,16,17,@,CAR,W 33-7,4,31,1,5,5,36,2020,2020_17_NOR_CAR
GNB,2021-01-03,4,Sun,16,17,@,CHI,W 35-16,4,30,1,16,5,46,2020,2020_17_GNB_CHI
MIN,2021-01-03,4,Sun,16,17,@,DET,W 37-35,4,35,7,51,11,86,2020,2020_17_MIN_DET
LAC,2021-01-03,4,Sun,16,17,@,KAN,W 38-21,4,23,5,69,9,92,2020,2020_17_LAC_KAN
CLE,2021-01-03,4,Sun,16,17,,PIT,W 24-22,4,19,2,15,6,34,2020,2020_17_CLE_PIT
DEN,2021-01-03,4,Sun,16,17,,LVR,L 31-32,4,28,14,111,18,139,2020,2020_17_DEN_LVR
SEA,2021-01-03,4,Sun,16,17,@,SFO,W 26-23,4,35,2,25,6,60,2020,2020_17_SEA_SFO
ATL,2021-01-03,4,Sun,16,17,@,TAM,L 27-44,4,48,3,23,7,71,2020,2020_17_ATL_TAM
NWE,2020-12-28,4,Mon,15,16,,BUF,L 9-38,4,25,3,27,7,52,2020,2020_16_NWE_BUF
CHI,2020-12-27,4,Sun,15,16,@,JAX,W 41-17,4,40,10,115,14,155,2020,2020_16_CHI_JAX
SFO,2020-12-26,4,Sat,15,16,@,ARI,W 20-12,4,27,4,20,8,47,2020,2020_16_SFO_ARI
LVR,2020-12-26,4,Sat,15,16,,MIA,L 25-26,4,40,5,76,9,116,2020,2020_16_LVR_MIA
ARI,2020-12-26,4,Sat,15,16,,SFO,L 12-20,4,20,4,27,8,47,2020,2020_16_ARI_SFO
NOR,2020-12-25,4,Fri,15,16,,MIN,W 52-33,4,38,3,20,7,58,2020,2020_16_NOR_MIN
PIT,2020-12-21,4,Mon,14,15,@,CIN,L 17-27,4,30,2,16,6,46,2020,2020_15_PIT_CIN
SFO,2020-12-20,4,Sun,14,15,@,DAL,L 33-41,4,39,5,58,9,97,2020,2020_15_SFO_DAL
IND,2020-12-20,4,Sun,14,15,,HOU,W 27-20,4,35,5,24,9,59,2020,2020_15_IND_HOU
BAL,2020-12-20,4,Sun,14,15,,JAX,W 40-14,4,40,7,67,11,107,2020,2020_15_BAL_JAX
CHI,2020-12-20,4,Sun,14,15,@,MIN,W 33-27,4,36,1,5,5,41,2020,2020_15_CHI_MIN
SEA,2020-12-20,4,Sun,14,15,@,WAS,W 20-15,4,45,6,41,10,86,2020,2020_15_SEA_WAS
DET,2020-12-13,4,Sun,13,14,,GNB,L 24-31,4,30,12,68,16,98,2020,2020_14_DET_GNB
ARI,2020-12-13,4,Sun,13,14,@,NYG,W 26-7,4,22,2,10,6,32,2020,2020_14_ARI_NYG
SEA,2020-12-13,4,Sun,13,14,,NYJ,W 40-3,4,35,7,50,11,85,2020,2020_14_SEA_NYJ
ATL,2020-12-13,4,Sun,13,14,@,LAC,L 17-20,4,35,6,40,10,75,2020,2020_14_ATL_LAC
BAL,2020-12-08,4,Tue,12,13,,DAL,W 34-17,4,23,7,58,11,81,2020,2020_13_BAL_DAL
BUF,2020-12-07,4,Mon,12,13,@,SFO,W 34-24,4,50,7,43,11,93,2020,2020_13_BUF_SFO
PHI,2020-12-06,4,Sun,12,13,@,GNB,L 16-30,4,40,5,30,9,70,2020,2020_13_PHI_GNB
DEN,2020-12-06,4,Sun,12,13,@,KAN,L 16-22,4,31,5,44,9,75,2020,2020_13_DEN_KAN
DET,2020-11-26,4,Thu,11,12,,HOU,L 25-41,4,44,10,74,14,118,2020,2020_12_DET_HOU
DET,2020-11-22,4,Sun,10,11,@,CAR,L 0-20,4,20,7,45,11,65,2020,2020_11_DET_CAR
DAL,2020-11-22,4,Sun,10,11,@,MIN,W 31-28,4,30,8,80,12,110,2020,2020_11_DAL_MIN
TEN,2020-11-22,4,Sun,10,11,@,BAL,W 30-24 (OT),4,44,6,81,10,125,2020,2020_11_TEN_BAL
MIN,2020-11-16,4,Mon,9,10,@,CHI,W 19-13,4,35,1,5,5,40,2020,2020_10_MIN_CHI
GNB,2020-11-15,4,Sun,9,10,,JAX,W 24-20,4,35,7,86,11,121,2020,2020_10_GNB_JAX
SEA,2020-11-15,4,Sun,9,10,@,LAR,L 16-23,4,23,4,49,8,72,2020,2020_10_SEA_LAR
LAR,2020-11-15,4,Sun,9,10,,SEA,W 23-16,4,49,4,23,8,72,2020,2020_10_LAR_SEA
NYJ,2020-11-09,4,Mon,9,9,,NWE,L 27-30,4,32,6,81,10,113,2020,2020_09_NYJ_NWE
SEA,2020-11-08,4,Sun,8,9,@,BUF,L 34-44,4,13,6,70,10,83,2020,2020_09_SEA_BUF
JAX,2020-11-08,4,Sun,8,9,,HOU,L 25-27,4,78,3,18,7,96,2020,2020_09_JAX_HOU
IND,2020-11-08,4,Sun,8,9,,BAL,L 10-24,4,30,5,55,9,85,2020,2020_09_IND_BAL
NYG,2020-11-08,4,Sun,9,9,@,WAS,W 23-20,4,40,6,45,10,85,2020,2020_09_NYG_WAS
SFO,2020-11-05,4,Thu,9,9,,GNB,L 17-34,4,33,5,45,9,78,2020,2020_09_SFO_GNB
DET,2020-11-01,4,Sun,7,8,,IND,L 21-41,4,76,3,19,7,95,2020,2020_08_DET_IND
PHI,2020-11-01,4,Sun,8,8,,DAL,W 23-9,4,28,7,68,11,96,2020,2020_08_PHI_DAL
LAR,2020-10-26,4,Mon,7,7,,CHI,W 24-10,4,46,6,46,10,92,2020,2020_07_LAR_CHI
WAS,2020-10-25,4,Sun,7,7,,DAL,W 25-3,4,30,6,49,10,79,2020,2020_07_WAS_DAL
TAM,2020-10-25,4,Sun,7,7,@,LVR,W 45-20,4,20,4,35,8,55,2020,2020_07_TAM_LVR
LVR,2020-10-25,4,Sun,6,7,,TAM,L 20-45,4,35,4,20,8,55,2020,2020_07_LVR_TAM
BUF,2020-10-19,4,Mon,6,6,,KAN,L 17-26,4,39,8,68,12,107,2020,2020_06_BUF_KAN
HOU,2020-10-18,4,Sun,6,6,@,TEN,L 36-42 (OT),4,46,7,73,11,119,2020,2020_06_HOU_TEN
NYG,2020-10-18,4,Sun,6,6,,WAS,W 20-19,4,30,8,50,12,80,2020,2020_06_NYG_WAS
CAR,2020-10-11,4,Sun,5,5,@,ATL,W 23-16,4,25,3,40,7,65,2020,2020_05_CAR_ATL
BAL,2020-10-11,4,Sun,5,5,,CIN,W 27-3,4,25,5,40,9,65,2020,2020_05_BAL_CIN
JAX,2020-10-11,4,Sun,5,5,@,HOU,L 14-30,4,35,5,25,9,60,2020,2020_05_JAX_HOU
NWE,2020-10-05,4,Mon,4,4,@,KAN,L 10-26,4,43,4,38,8,81,2020,2020_04_NWE_KAN
KAN,2020-10-05,4,Mon,4,4,,NWE,W 26-10,4,38,4,43,8,81,2020,2020_04_KAN_NWE
NOR,2020-10-04,4,Sun,4,4,@,DET,W 35-29,4,67,5,49,9,116,2020,2020_04_NOR_DET
MIN,2020-10-04,4,Sun,4,4,@,HOU,W 31-23,4,36,2,15,6,51,2020,2020_04_MIN_HOU
NYG,2020-10-04,4,Sun,4,4,@,LAR,L 9-17,4,20,1,5,5,25,2020,2020_04_NYG_LAR
WAS,2020-09-27,4,Sun,3,3,@,CLE,L 20-34,4,40,6,50,10,90,2020,2020_03_WAS_CLE
TEN,2020-09-27,4,Sun,3,3,@,MIN,W 31-30,4,45,3,20,7,65,2020,2020_03_TEN_MIN
IND,2020-09-27,4,Sun,3,3,,NYJ,W 36-7,4,40,7,57,11,97,2020,2020_03_IND_NYJ
HOU,2020-09-27,4,Sun,3,3,@,PIT,L 21-28,4,49,2,14,6,63,2020,2020_03_HOU_PIT
DEN,2020-09-27,4,Sun,3,3,,TAM,L 10-28,4,30,9,71,13,101,2020,2020_03_DEN_TAM
TEN,2020-09-20,4,Sun,2,2,,JAX,W 33-30,4,30,8,60,12,90,2020,2020_02_TEN_JAX
LAR,2020-09-20,4,Sun,2,2,@,PHI,W 37-19,4,24,5,30,9,54,2020,2020_02_LAR_PHI
DEN,2020-09-20,4,Sun,2,2,@,PIT,L 21-26,4,30,10,89,14,119,2020,2020_02_DEN_PIT
HOU,2020-09-20,4,Sun,2,2,,BAL,L 16-33,4,22,3,21,7,43,2020,2020_02_HOU_BAL
CIN,2020-09-17,4,Thu,2,2,@,CLE,L 30-35,4,45,8,76,12,121,2020,2020_02_CIN_CLE
NYG,2020-09-14,4,Mon,1,1,,PIT,L 16-26,4,25,3,21,7,46,2020,2020_01_NYG_PIT
MIA,2020-09-13,4,Sun,1,1,@,NWE,L 11-21,4,35,3,47,7,82,2020,2020_01_MIA_NWE
IND,2019-12-29,4,Sun,16,17,@,JAX,L 20-38,4,36,3,27,7,63,2019,2019_17_IND_JAX
MIA,2019-12-29,4,Sun,16,17,@,NWE,W 27-24,4,35,6,54,10,89,2019,2019_17_MIA_NWE
NYG,2019-12-29,4,Sun,16,17,,PHI,L 17-34,4,48,7,55,11,103,2019,2019_17_NYG_PHI
CLE,2019-12-29,4,Sun,16,17,@,CIN,L 23-33,4,33,3,20,7,53,2019,2019_17_CLE_CIN
DET,2019-12-29,4,Sun,16,17,,GNB,L 20-23,4,50,9,97,13,147,2019,2019_17_DET_GNB
PHI,2019-12-22,4,Sun,15,16,,DAL,W 17-9,4,30,2,20,6,50,2019,2019_16_PHI_DAL
PIT,2019-12-22,4,Sun,15,16,@,NYJ,L 10-16,4,34,3,30,7,64,2019,2019_16_PIT_NYJ
NYG,2019-12-22,4,Sun,15,16,@,WAS,W 41-35 (OT),4,33,6,51,10,84,2019,2019_16_NYG_WAS
HOU,2019-12-21,4,Sat,15,16,@,TAM,W 23-20,4,35,6,45,10,80,2019,2019_16_HOU_TAM
TEN,2019-12-15,4,Sun,14,15,,HOU,L 21-24,4,30,5,27,9,57,2019,2019_15_TEN_HOU
NYG,2019-12-15,4,Sun,14,15,,MIA,W 36-20,4,32,7,42,11,74,2019,2019_15_NYG_MIA
DAL,2019-12-15,4,Sun,14,15,,LAR,W 44-21,4,16,5,29,9,45,2019,2019_15_DAL_LAR
GNB,2019-12-15,4,Sun,14,15,,CHI,W 21-13,4,30,4,35,8,65,2019,2019_15_GNB_CHI
NWE,2019-12-15,4,Sun,14,15,@,CIN,W 34-13,4,30,5,25,9,55,2019,2019_15_NWE_CIN
CHI,2019-12-15,4,Sun,14,15,@,GNB,L 13-21,4,35,4,30,8,65,2019,2019_15_CHI_GNB
PHI,2019-12-09,4,Mon,13,14,,NYG,W 23-17 (OT),4,30,7,54,11,84,2019,2019_14_PHI_NYG
DET,2019-12-08,4,Sun,13,14,@,MIN,L 7-20,4,28,8,55,12,83,2019,2019_14_DET_MIN
TEN,2019-12-08,4,Sun,13,14,@,OAK,W 42-21,4,21,3,20,7,41,2019,2019_14_TEN_OAK
PIT,2019-12-08,4,Sun,13,14,@,ARI,W 23-17,4,20,7,75,11,95,2019,2019_14_PIT_ARI
CHI,2019-12-05,4,Thu,13,14,,DAL,W 31-24,4,30,6,52,10,82,2019,2019_14_CHI_DAL
NYG,2019-12-01,4,Sun,12,13,,GNB,L 13-31,4,31,7,54,11,85,2019,2019_13_NYG_GNB
ATL,2019-11-28,4,Thu,12,13,,NOR,L 18-26,4,18,9,121,13,139,2019,2019_13_ATL_NOR
OAK,2019-11-24,4,Sun,11,12,@,NYJ,L 3-34,4,35,4,37,8,72,2019,2019_12_OAK_NYJ
NYJ,2019-11-24,4,Sun,11,12,,OAK,W 34-3,4,37,4,35,8,72,2019,2019_12_NYJ_OAK
HOU,2019-11-21,4,Thu,11,12,,IND,W 20-17,4,27,3,29,7,56,2019,2019_12_HOU_IND
CIN,2019-11-17,4,Sun,10,11,@,OAK,L 10-17,4,40,7,42,11,82,2019,2019_11_CIN_OAK
CLE,2019-11-10,4,Sun,9,10,,BUF,W 19-16,4,70,7,40,11,110,2019,2019_10_CLE_BUF
MIA,2019-11-10,4,Sun,9,10,@,IND,W 16-12,4,30,3,25,7,55,2019,2019_10_MIA_IND
JAX,2019-11-03,4,Sun,9,9,,HOU,L 3-26,4,34,7,60,11,94,2019,2019_09_JAX_HOU
KAN,2019-11-03,4,Sun,9,9,,MIN,W 26-23,4,25,3,25,7,50,2019,2019_09_KAN_MIN
BAL,2019-11-03,4,Sun,8,9,,NWE,W 37-20,4,34,7,48,11,82,2019,2019_09_BAL_NWE
SEA,2019-11-03,4,Sun,9,9,,TAM,W 40-34 (OT),4,45,10,82,14,127,2019,2019_09_SEA_TAM
GNB,2019-10-27,4,Sun,8,8,@,KAN,W 31-24,4,25,3,30,7,55,2019,2019_08_GNB_KAN
PHI,2019-10-27,4,Sun,8,8,@,BUF,W 31-13,4,44,8,57,12,101,2019,2019_08_PHI_BUF
SFO,2019-10-27,4,Sun,7,8,,CAR,W 51-13,4,31,9,70,13,101,2019,2019_08_SFO_CAR
NWE,2019-10-27,4,Sun,8,8,,CLE,W 27-13,4,32,13,85,17,117,2019,2019_08_NWE_CLE
WAS,2019-10-24,4,Thu,8,8,@,MIN,L 9-19,4,46,7,74,11,120,2019,2019_08_WAS_MIN
LAC,2019-10-20,4,Sun,7,7,@,TEN,L 20-23,4,29,7,54,11,83,2019,2019_07_LAC_TEN
NOR,2019-10-20,4,Sun,7,7,@,CHI,W 36-25,4,35,3,10,7,45,2019,2019_07_NOR_CHI
DEN,2019-10-17,4,Thu,7,7,,KAN,L 6-30,4,33,6,46,10,79,2019,2019_07_DEN_KAN
MIN,2019-10-13,4,Sun,6,6,,PHI,W 38-20,4,30,7,49,11,79,2019,2019_06_MIN_PHI
SFO,2019-10-13,4,Sun,5,6,@,LAR,W 20-7,4,30,8,59,12,89,2019,2019_06_SFO_LAR
CIN,2019-10-13,4,Sun,6,6,@,BAL,L 17-23,4,20,10,81,14,101,2019,2019_06_CIN_BAL
SFO,2019-10-07,4,Mon,4,5,,CLE,W 31-3,4,34,7,55,11,89,2019,2019_05_SFO_CLE
LAC,2019-10-06,4,Sun,5,5,,DEN,L 13-20,4,43,12,122,16,165,2019,2019_05_LAC_DEN
TAM,2019-10-06,4,Sun,5,5,@,NOR,L 24-31,4,30,6,40,10,70,2019,2019_05_TAM_NOR
PIT,2019-09-30,4,Mon,4,4,,CIN,W 27-3,4,37,8,60,12,97,2019,2019_04_PIT_CIN
IND,2019-09-22,4,Sun,3,3,,ATL,W 27-24,4,39,16,128,20,167,2019,2019_03_IND_ATL
PHI,2019-09-22,4,Sun,3,3,,DET,L 24-27,4,30,9,61,13,91,2019,2019_03_PHI_DET
TAM,2019-09-22,4,Sun,3,3,,NYG,L 31-32,4,30,6,59,10,89,2019,2019_03_TAM_NYG
KAN,2019-09-22,4,Sun,3,3,,BAL,W 33-28,4,31,7,60,11,91,2019,2019_03_KAN_BAL
JAX,2019-09-19,4,Thu,3,3,,TEN,W 20-7,4,30,9,101,13,131,2019,2019_03_JAX_TEN
MIA,2019-09-15,4,Sun,2,2,,NWE,L 0-43,4,22,5,54,9,76,2019,2019_02_MIA_NWE
BAL,2019-09-08,4,Sun,1,1,@,MIA,W 59-10,4,40,9,64,13,104,2019,2019_01_BAL_MIA
MIA,2018-12-30,4,Sun,16,17,@,BUF,L 17-42,4,35,3,24,7,59,2018,2018_17_MIA_BUF
OAK,2018-12-30,4,Sun,16,17,@,KAN,L 3-35,4,22,4,50,8,72,2018,2018_17_OAK_KAN
NYJ,2018-12-30,4,Sun,16,17,@,NWE,L 3-38,4,30,4,30,8,60,2018,2018_17_NYJ_NWE
NWE,2018-12-30,4,Sun,16,17,,NYJ,W 38-3,4,30,4,30,8,60,2018,2018_17_NWE_NYJ
KAN,2018-12-30,4,Sun,16,17,,OAK,W 35-3,4,50,4,22,8,72,2018,2018_17_KAN_OAK
CLE,2018-12-30,4,Sun,16,17,@,BAL,L 24-26,4,35,10,65,14,100,2018,2018_17_CLE_BAL
ATL,2018-12-23,4,Sun,15,16,@,CAR,W 24-10,4,41,10,86,14,127,2018,2018_16_ATL_CAR
CHI,2018-12-23,4,Sun,15,16,@,SFO,W 14-9,4,30,6,45,10,75,2018,2018_16_CHI_SFO
BAL,2018-12-22,4,Sat,15,16,@,LAC,W 22-10,4,40,8,69,12,109,2018,2018_16_BAL_LAC
CAR,2018-12-17,4,Mon,14,15,,NOR,L 9-12,4,48,9,80,13,128,2018,2018_15_CAR_NOR
DET,2018-12-16,4,Sun,14,15,@,BUF,L 13-14,4,81,3,20,7,101,2018,2018_15_DET_BUF
CHI,2018-12-16,4,Sun,14,15,,GNB,W 24-17,4,24,7,48,11,72,2018,2018_15_CHI_GNB
PIT,2018-12-16,4,Sun,14,15,,NWE,W 17-10,4,40,14,106,18,146,2018,2018_15_PIT_NWE
TEN,2018-12-16,4,Sun,14,15,@,NYG,W 17-0,4,35,10,58,14,93,2018,2018_15_TEN_NYG
SEA,2018-12-10,4,Mon,13,14,,MIN,W 21-7,4,45,4,51,8,96,2018,2018_14_SEA_MIN
MIN,2018-12-10,4,Mon,13,14,@,SEA,L 7-21,4,51,4,45,8,96,2018,2018_14_MIN_SEA
SEA,2018-11-25,4,Sun,11,12,@,CAR,W 30-27,4,36,3,30,7,66,2018,2018_12_SEA_CAR
LAC,2018-11-25,4,Sun,11,12,,ARI,W 45-10,4,30,3,35,7,65,2018,2018_12_LAC_ARI
GNB,2018-11-25,4,Sun,11,12,@,MIN,L 17-24,4,20,6,55,10,75,2018,2018_12_GNB_MIN
OAK,2018-11-25,4,Sun,11,12,@,BAL,L 17-34,4,24,6,45,10,69,2018,2018_12_OAK_BAL
WAS,2018-11-22,4,Thu,11,12,@,DAL,L 23-31,4,25,4,30,8,55,2018,2018_12_WAS_DAL
DAL,2018-11-22,4,Thu,11,12,,WAS,W 31-23,4,30,4,25,8,55,2018,2018_12_DAL_WAS
MIN,2018-11-18,4,Sun,10,11,@,CHI,L 20-25,4,50,5,46,9,96,2018,2018_11_MIN_CHI
OAK,2018-11-18,4,Sun,10,11,@,ARI,W 23-21,4,20,7,62,11,82,2018,2018_11_OAK_ARI
TAM,2018-11-18,4,Sun,10,11,@,NYG,L 35-38,4,40,8,60,12,100,2018,2018_11_TAM_NYG
CIN,2018-11-11,4,Sun,9,10,,NOR,L 14-51,4,26,1,5,5,31,2018,2018_10_CIN_NOR
TEN,2018-11-11,4,Sun,9,10,,NWE,W 34-10,4,35,4,31,8,66,2018,2018_10_TEN_NWE
BUF,2018-11-11,4,Sun,10,10,@,NYJ,W 41-10,4,30,1,10,5,40,2018,2018_10_BUF_NYJ
NWE,2018-11-11,4,Sun,10,10,@,TEN,L 10-34,4,31,4,35,8,66,2018,2018_10_NWE_TEN
CLE,2018-11-04,4,Sun,9,9,,KAN,L 21-37,4,20,11,86,15,106,2018,2018_09_CLE_KAN
LAR,2018-11-04,4,Sun,9,9,@,NOR,L 35-45,4,32,2,20,6,52,2018,2018_09_LAR_NOR
PHI,2018-10-28,4,Sun,8,8,@,JAX,W 24-18,4,36,5,45,9,81,2018,2018_08_PHI_JAX
CAR,2018-10-28,4,Sun,7,8,,BAL,W 36-21,4,30,9,68,13,98,2018,2018_08_CAR_BAL
DET,2018-10-28,4,Sun,7,8,,SEA,L 14-28,4,32,7,111,11,143,2018,2018_08_DET_SEA
CIN,2018-10-28,4,Sun,8,8,,TAM,W 37-34,4,46,11,75,15,121,2018,2018_08_CIN_TAM
NYG,2018-10-22,4,Mon,7,7,@,ATL,L 20-23,4,58,5,29,9,87,2018,2018_07_NYG_ATL
IND,2018-10-21,4,Sun,7,7,,BUF,W 37-5,4,35,7,59,11,94,2018,2018_07_IND_BUF
PHI,2018-10-21,4,Sun,7,7,,CAR,L 17-21,4,35,5,78,9,113,2018,2018_07_PHI_CAR
MIA,2018-10-21,4,Sun,7,7,,DET,L 21-32,4,50,6,43,10,93,2018,2018_07_MIA_DET
LAC,2018-10-21,4,Sun,7,7,,TEN,W 20-19,4,31,4,32,8,63,2018,2018_07_LAC_TEN
TEN,2018-10-21,4,Sun,7,7,@,LAC,L 19-20,4,32,4,31,8,63,2018,2018_07_TEN_LAC
TAM,2018-10-14,4,Sun,5,6,@,ATL,L 29-34,4,20,5,30,9,50,2018,2018_06_TAM_ATL
JAX,2018-10-14,4,Sun,6,6,@,DAL,L 7-40,4,30,3,25,7,55,2018,2018_06_JAX_DAL
TEN,2018-10-14,4,Sun,6,6,,BAL,L 0-21,4,35,10,70,14,105,2018,2018_06_TEN_BAL
PHI,2018-10-11,4,Thu,6,6,@,NYG,W 34-13,4,25,5,61,9,86,2018,2018_06_PHI_NYG
NOR,2018-10-08,4,Mon,5,5,,WAS,W 43-19,4,45,6,38,10,83,2018,2018_05_NOR_WAS
BAL,2018-10-07,4,Sun,5,5,@,CLE,L 9-12 (OT),4,41,10,66,14,107,2018,2018_05_BAL_CLE
NYJ,2018-10-07,4,Sun,5,5,,DEN,W 34-16,4,33,6,45,10,78,2018,2018_05_NYJ_DEN
CAR,2018-10-07,4,Sun,4,5,,NYG,W 33-31,4,22,8,62,12,84,2018,2018_05_CAR_NYG
BUF,2018-10-07,4,Sun,5,5,,TEN,W 13-12,4,30,5,40,9,70,2018,2018_05_BUF_TEN
MIN,2018-10-07,4,Sun,5,5,@,PHI,W 23-21,4,23,8,52,12,75,2018,2018_05_MIN_PHI
IND,2018-10-04,4,Thu,5,5,@,NWE,L 24-38,4,35,7,50,11,85,2018,2018_05_IND_NWE
TEN,2018-09-30,4,Sun,4,4,,PHI,W 26-23 (OT),4,30,8,77,12,107,2018,2018_04_TEN_PHI
SFO,2018-09-30,4,Sun,4,4,@,LAC,L 27-29,4,29,5,49,9,78,2018,2018_04_SFO_LAC
CHI,2018-09-30,4,Sun,4,4,,TAM,W 48-10,4,38,11,99,15,137,2018,2018_04_CHI_TAM
MIN,2018-09-27,4,Thu,4,4,@,LAR,L 31-38,4,35,2,15,6,50,2018,2018_04_MIN_LAR
CIN,2018-09-23,4,Sun,3,3,@,CAR,L 21-31,4,36,3,17,7,53,2018,2018_03_CIN_CAR
TEN,2018-09-23,4,Sun,3,3,@,JAX,W 9-6,4,30,8,75,12,105,2018,2018_03_TEN_JAX
