Team,Date,Pts,Day,G#,Week,,Opp,Result,Pts,PtsO,PtDif,PC,Season,game_id
BAL,2019-09-08,59,Sun,1,1,@,MIA,W 59-10,59,10,49,69,2019,2019_01_BAL_MIA
HOU,2017-10-01,57,Sun,4,4,,TEN,W 57-14,57,14,43,71,2017,2017_04_HOU_TEN
DAL,2021-12-26,56,Sun,15,16,,WAS,W 56-14,56,14,42,70,2021,2021_16_DAL_WAS
BUF,2021-01-03,56,Sun,16,17,,MIA,W 56-26,56,26,30,82,2020,2020_17_BUF_MIA
TAM,2019-09-29,55,Sun,4,4,@,LAR,W 55-40,55,40,15,95,2019,2019_04_TAM_LAR
DAL,2022-12-04,54,Sun,12,13,,IND,W 54-19,54,19,35,73,2022,2022_13_DAL_IND
NWE,2021-10-24,54,Sun,7,7,,NYJ,W 54-13,54,13,41,67,2021,2021_07_NWE_NYJ
LAR,2018-11-19,54,Mon,11,11,,KAN,W 54-51,54,51,3,105,2018,2018_11_LAR_KAN
LAC,2017-11-19,54,Sun,10,11,,BUF,W 54-24,54,24,30,78,2017,2017_11_LAC_BUF
HOU,2019-10-06,53,Sun,5,5,,ATL,W 53-32,53,32,21,85,2019,2019_05_HOU_ATL
NOR,2020-12-25,52,Fri,15,16,,MIN,W 52-33,52,33,19,85,2020,2020_16_NOR_MIN
PIT,2018-11-08,52,Thu,9,10,,CAR,W 52-21,52,21,31,73,2018,2018_10_PIT_CAR
NOR,2017-10-15,52,Sun,5,6,,DET,W 52-38,52,38,14,90,2017,2017_06_NOR_DET
LAR,2022-12-25,51,Sun,15,16,,DEN,W 51-14,51,14,37,65,2022,2022_16_LAR_DEN
DAL,2022-01-08,51,Sat,17,18,@,PHI,W 51-26,51,26,25,77,2021,2021_18_DAL_PHI
SEA,2022-01-02,51,Sun,16,17,,DET,W 51-29,51,29,22,80,2021,2021_17_SEA_DET
SFO,2019-10-27,51,Sun,7,8,,CAR,W 51-13,51,13,38,64,2019,2019_08_SFO_CAR
KAN,2018-11-19,51,Mon,11,11,@,LAR,L 51-54,51,54,-3,105,2018,2018_11_KAN_LAR
NOR,2018-11-11,51,Sun,9,10,@,CIN,W 51-14,51,14,37,65,2018,2018_10_NOR_CIN
LAR,2017-11-05,51,Sun,8,9,@,NYG,W 51-17,51,17,34,68,2017,2017_09_LAR_NYG
PHI,2017-11-05,51,Sun,9,9,,DEN,W 51-23,51,23,28,74,2017,2017_09_PHI_DEN
NWE,2022-01-02,50,Sun,16,17,,JAX,W 50-10,50,10,40,60,2021,2021_17_NWE_JAX
DAL,2022-10-30,49,Sun,8,8,,CHI,W 49-29,49,29,20,78,2022,2022_08_DAL_CHI
CLE,2020-10-04,49,Sun,4,4,@,DAL,W 49-38,49,38,11,87,2020,2020_04_CLE_DAL
BAL,2019-11-10,49,Sun,9,10,@,CIN,W 49-13,49,13,36,62,2019,2019_10_BAL_CIN
PHI,2022-12-11,48,Sun,13,14,@,NYG,W 48-22,48,22,26,70,2022,2022_14_PHI_NYG
SEA,2022-10-02,48,Sun,4,4,@,DET,W 48-45,48,45,3,93,2022,2022_04_SEA_DET
KAN,2021-12-12,48,Sun,13,14,,LVR,W 48-9,48,9,39,57,2021,2021_14_KAN_LVR
TAM,2021-09-19,48,Sun,2,2,,ATL,W 48-25,48,25,23,73,2021,2021_02_TAM_ATL
BUF,2020-12-19,48,Sat,14,15,@,DEN,W 48-19,48,19,29,67,2020,2020_15_BUF_DEN
SFO,2019-12-08,48,Sun,13,14,@,NOR,W 48-46,48,46,2,94,2019,2019_14_SFO_NOR
LAR,2018-12-30,48,Sun,16,17,,SFO,W 48-32,48,32,16,80,2018,2018_17_LAR_SFO
NOR,2018-11-18,48,Sun,10,11,,PHI,W 48-7,48,7,41,55,2018,2018_11_NOR_PHI
CHI,2018-09-30,48,Sun,4,4,,TAM,W 48-10,48,10,38,58,2018,2018_04_CHI_TAM
NYJ,2018-09-10,48,Mon,1,1,@,DET,W 48-17,48,17,31,65,2018,2018_01_NYJ_DET
TAM,2018-09-09,48,Sun,1,1,@,NOR,W 48-40,48,40,8,88,2018,2018_01_TAM_NOR
LAC,2021-10-10,47,Sun,5,5,,CLE,W 47-42,47,42,5,89,2021,2021_05_LAC_CLE
TAM,2020-12-26,47,Sat,15,16,@,DET,W 47-7,47,7,40,54,2020,2020_16_TAM_DET
BAL,2020-12-14,47,Mon,13,14,@,CLE,W 47-42,47,42,5,89,2020,2020_14_BAL_CLE
DAL,2019-12-29,47,Sun,16,17,,WAS,W 47-16,47,16,31,63,2019,2019_17_DAL_WAS
BAL,2018-09-09,47,Sun,1,1,,BUF,W 47-3,47,3,44,50,2018,2018_01_BAL_BUF
NOR,2017-11-12,47,Sun,9,10,@,BUF,W 47-10,47,10,37,57,2017,2017_10_NOR_BUF
TEN,2020-12-20,46,Sun,14,15,,DET,W 46-25,46,25,21,71,2020,2020_15_TEN_DET
TAM,2020-11-15,46,Sun,10,10,@,CAR,W 46-23,46,23,23,69,2020,2020_10_TAM_CAR
NOR,2019-12-08,46,Sun,13,14,,SFO,L 46-48,46,48,-2,94,2019,2019_14_NOR_SFO
SEA,2017-10-01,46,Sun,4,4,,IND,W 46-18,46,18,28,64,2017,2017_04_SEA_IND
LAR,2017-09-10,46,Sun,1,1,,IND,W 46-9,46,9,37,55,2017,2017_01_LAR_IND
DET,2022-10-02,45,Sun,4,4,,SEA,L 45-48,45,48,-3,93,2022,2022_04_DET_SEA
GNB,2021-12-12,45,Sun,13,14,,CHI,W 45-30,45,30,15,75,2021,2021_14_GNB_CHI
NWE,2021-11-14,45,Sun,10,10,,CLE,W 45-7,45,7,38,52,2021,2021_10_NWE_CLE
BUF,2021-11-14,45,Sun,9,10,@,NYJ,W 45-17,45,17,28,62,2021,2021_10_BUF_NYJ
IND,2021-11-04,45,Thu,9,9,,NYJ,W 45-30,45,30,15,75,2021,2021_09_IND_NYJ
TAM,2021-10-10,45,Sun,5,5,,MIA,W 45-17,45,17,28,62,2021,2021_05_TAM_MIA
NWE,2020-12-06,45,Sun,12,13,@,LAC,W 45-0,45,0,45,45,2020,2020_13_NWE_LAC
TEN,2020-11-29,45,Sun,11,12,@,IND,W 45-26,45,26,19,71,2020,2020_12_TEN_IND
TAM,2020-10-25,45,Sun,7,7,@,LVR,W 45-20,45,20,25,65,2020,2020_07_TAM_LVR
LAC,2019-12-08,45,Sun,13,14,@,JAX,W 45-10,45,10,35,55,2019,2019_14_LAC_JAX
BAL,2019-11-25,45,Mon,11,12,@,LAR,W 45-6,45,6,39,51,2019,2019_12_BAL_LAR
LAC,2018-11-25,45,Sun,11,12,,ARI,W 45-10,45,10,35,55,2018,2018_12_LAC_ARI
NOR,2018-11-04,45,Sun,8,9,,LAR,W 45-35,45,35,10,80,2018,2018_09_NOR_LAR
KAN,2018-10-21,45,Sun,7,7,,CIN,W 45-10,45,10,35,55,2018,2018_07_KAN_CIN
DEN,2018-10-18,45,Thu,7,7,@,ARI,W 45-10,45,10,35,55,2018,2018_07_DEN_ARI
OAK,2018-09-30,45,Sun,4,4,,CLE,W 45-42 (OT),45,42,3,87,2018,2018_04_OAK_CLE
JAX,2017-12-17,45,Sun,14,15,,HOU,W 45-7,45,7,38,52,2017,2017_15_JAX_HOU
CAR,2017-11-13,45,Mon,10,10,,MIA,W 45-21,45,21,24,66,2017,2017_10_CAR_MIA
OAK,2017-09-17,45,Sun,2,2,,NYJ,W 45-20,45,20,25,65,2017,2017_02_OAK_NYJ
KAN,2022-10-23,44,Sun,7,7,@,SFO,W 44-23,44,23,21,67,2022,2022_07_KAN_SFO
KAN,2022-09-11,44,Sun,1,1,@,ARI,W 44-21,44,21,23,65,2022,2022_01_KAN_ARI
PHI,2021-10-31,44,Sun,8,8,@,DET,W 44-6,44,6,38,50,2021,2021_08_PHI_DET
DAL,2021-10-10,44,Sun,5,5,,NYG,W 44-20,44,20,24,64,2021,2021_05_DAL_NYG
TAM,2021-01-03,44,Sun,16,17,,ATL,W 44-27,44,27,17,71,2020,2020_17_TAM_ATL
IND,2020-12-13,44,Sun,13,14,@,LVR,W 44-27,44,27,17,71,2020,2020_14_IND_LVR
BUF,2020-11-08,44,Sun,9,9,,SEA,W 44-34,44,34,10,78,2020,2020_09_BUF_SEA
DAL,2019-12-15,44,Sun,14,15,,LAR,W 44-21,44,21,23,65,2019,2019_15_DAL_LAR
GNB,2018-12-23,44,Sun,15,16,@,NYJ,W 44-38 (OT),44,38,6,82,2018,2018_16_GNB_NYJ
SFO,2017-12-24,44,Sun,15,16,,JAX,W 44-33,44,33,11,77,2017,2017_16_SFO_JAX
BAL,2017-12-03,44,Sun,12,13,,DET,W 44-20,44,20,24,64,2017,2017_13_BAL_DET
JAX,2017-09-24,44,Sun,3,3,,BAL,W 44-7,44,7,37,51,2017,2017_03_JAX_BAL
DAL,2021-11-14,43,Sun,9,10,,ATL,W 43-3,43,3,40,46,2021,2021_10_DAL_ATL
BUF,2021-09-26,43,Sun,3,3,,WAS,W 43-21,43,21,22,64,2021,2021_03_BUF_WAS
ATL,2020-11-29,43,Sun,11,12,,LVR,W 43-6,43,6,37,49,2020,2020_12_ATL_LVR
KAN,2020-10-25,43,Sun,7,7,@,DEN,W 43-16,43,16,27,59,2020,2020_07_KAN_DEN
MIA,2020-10-11,43,Sun,5,5,@,SFO,W 43-17,43,17,26,60,2020,2020_05_MIA_SFO
GNB,2020-09-13,43,Sun,1,1,@,MIN,W 43-34,43,34,9,77,2020,2020_01_GNB_MIN
NWE,2019-09-15,43,Sun,2,2,@,MIA,W 43-0,43,0,43,43,2019,2019_02_NWE_MIA
TEN,2019-09-08,43,Sun,1,1,@,CLE,W 43-13,43,13,30,56,2019,2019_01_TEN_CLE
SEA,2018-12-02,43,Sun,12,13,,SFO,W 43-16,43,16,27,59,2018,2018_13_SEA_SFO
NWE,2018-10-14,43,Sun,6,6,,KAN,W 43-40,43,40,3,83,2018,2018_06_NWE_KAN
NOR,2018-10-08,43,Mon,5,5,,WAS,W 43-19,43,19,24,62,2018,2018_05_NOR_WAS
NOR,2018-09-23,43,Sun,3,3,@,ATL,W 43-37 (OT),43,37,6,80,2018,2018_03_NOR_ATL
PHI,2017-12-10,43,Sun,13,14,@,LAR,W 43-35,43,35,8,78,2017,2017_14_PHI_LAR
CIN,2022-11-06,42,Sun,9,9,,CAR,W 42-21,42,21,21,63,2022,2022_09_CIN_CAR
ARI,2022-10-20,42,Thu,7,7,,NOR,W 42-34,42,34,8,76,2022,2022_07_ARI_NOR
MIA,2022-09-18,42,Sun,2,2,@,BAL,W 42-38,42,38,4,80,2022,2022_02_MIA_BAL
CLE,2021-10-10,42,Sun,5,5,@,LAC,L 42-47,42,47,-5,89,2021,2021_05_CLE_LAC
KAN,2021-10-03,42,Sun,4,4,@,PHI,W 42-30,42,30,12,72,2021,2021_04_KAN_PHI
CLE,2020-12-14,42,Mon,13,14,,BAL,L 42-47,42,47,-5,89,2020,2020_14_CLE_BAL
TEN,2020-10-18,42,Sun,5,6,,HOU,W 42-36 (OT),42,36,6,78,2020,2020_06_TEN_HOU
TEN,2020-10-13,42,Tue,4,5,,BUF,W 42-16,42,16,26,58,2020,2020_05_TEN_BUF
GNB,2020-09-20,42,Sun,2,2,,DET,W 42-21,42,21,21,63,2020,2020_02_GNB_DET
NOR,2019-12-29,42,Sun,16,17,@,CAR,W 42-10,42,10,32,52,2019,2019_17_NOR_CAR
BAL,2019-12-12,42,Thu,14,15,,NYJ,W 42-21,42,21,21,63,2019,2019_15_BAL_NYJ
TEN,2019-12-08,42,Sun,13,14,@,OAK,W 42-21,42,21,21,63,2019,2019_14_TEN_OAK
TEN,2019-11-24,42,Sun,11,12,,JAX,W 42-20,42,20,22,62,2019,2019_12_TEN_JAX
MIN,2019-10-20,42,Sun,7,7,@,DET,W 42-30,42,30,12,72,2019,2019_07_MIN_DET
GNB,2019-10-20,42,Sun,7,7,,OAK,W 42-24,42,24,18,66,2019,2019_07_GNB_OAK
BUF,2018-12-30,42,Sun,16,17,,MIA,W 42-17,42,17,25,59,2018,2018_17_BUF_MIA
CAR,2018-11-04,42,Sun,8,9,,TAM,W 42-28,42,28,14,70,2018,2018_09_CAR_TAM
IND,2018-10-28,42,Sun,8,8,@,OAK,W 42-28,42,28,14,70,2018,2018_08_IND_OAK
HOU,2018-10-25,42,Thu,8,8,,MIA,W 42-23,42,23,19,65,2018,2018_08_HOU_MIA
NYJ,2018-10-14,42,Sun,6,6,,IND,W 42-34,42,34,8,76,2018,2018_06_NYJ_IND
CLE,2018-09-30,42,Sun,4,4,@,OAK,L 42-45 (OT),42,45,-3,87,2018,2018_04_CLE_OAK
KAN,2018-09-16,42,Sun,2,2,@,PIT,W 42-37,42,37,5,79,2018,2018_02_KAN_PIT
LAR,2017-12-17,42,Sun,14,15,@,SEA,W 42-7,42,7,35,49,2017,2017_15_LAR_SEA
KAN,2017-10-08,42,Sun,5,5,@,HOU,W 42-34,42,34,8,76,2017,2017_05_KAN_HOU
DEN,2017-09-17,42,Sun,2,2,,DAL,W 42-17,42,17,25,59,2017,2017_02_DEN_DAL
KAN,2017-09-07,42,Thu,1,1,@,NWE,W 42-27,42,27,15,69,2017,2017_01_KAN_NWE
DET,2023-01-01,41,Sun,16,17,,CHI,W 41-10,41,10,31,51,2022,2022_17_DET_CHI
GNB,2023-01-01,41,Sun,16,17,,MIN,W 41-17,41,17,24,58,2022,2022_17_GNB_MIN
KAN,2022-10-02,41,Sun,4,4,@,TAM,W 41-31,41,31,10,72,2022,2022_04_KAN_TAM
BUF,2022-09-19,41,Mon,2,2,,TEN,W 41-7,41,7,34,48,2022,2022_02_BUF_TEN
TAM,2022-01-09,41,Sun,17,18,,CAR,W 41-17,41,17,24,58,2021,2021_18_TAM_CAR
HOU,2021-12-26,41,Sun,15,16,,LAC,W 41-29,41,29,12,70,2021,2021_16_HOU_LAC
CIN,2021-12-26,41,Sun,15,16,,BAL,W 41-21,41,21,20,62,2021,2021_16_CIN_BAL
LAC,2021-12-05,41,Sun,12,13,@,CIN,W 41-22,41,22,19,63,2021,2021_13_LAC_CIN
CIN,2021-11-28,41,Sun,11,12,,PIT,W 41-10,41,10,31,51,2021,2021_12_CIN_PIT
IND,2021-11-21,41,Sun,11,11,@,BUF,W 41-15,41,15,26,56,2021,2021_11_IND_BUF
LAC,2021-11-21,41,Sun,10,11,,PIT,W 41-37,41,37,4,78,2021,2021_11_LAC_PIT
KAN,2021-11-14,41,Sun,10,10,@,LVR,W 41-14,41,14,27,55,2021,2021_10_KAN_LVR
CLE,2021-11-07,41,Sun,9,9,@,CIN,W 41-16,41,16,25,57,2021,2021_09_CLE_CIN
CIN,2021-10-24,41,Sun,7,7,@,BAL,W 41-17,41,17,24,58,2021,2021_07_CIN_BAL
DAL,2021-09-27,41,Mon,3,3,,PHI,W 41-21,41,21,20,62,2021,2021_03_DAL_PHI
SFO,2021-09-12,41,Sun,1,1,@,DET,W 41-33,41,33,8,74,2021,2021_01_SFO_DET
TEN,2021-01-03,41,Sun,16,17,@,HOU,W 41-38,41,38,3,79,2020,2020_17_TEN_HOU
CHI,2020-12-27,41,Sun,15,16,@,JAX,W 41-17,41,17,24,58,2020,2020_16_CHI_JAX
DAL,2020-12-20,41,Sun,14,15,,SFO,W 41-33,41,33,8,74,2020,2020_15_DAL_SFO
CLE,2020-12-06,41,Sun,12,13,@,TEN,W 41-35,41,35,6,76,2020,2020_13_CLE_TEN
GNB,2020-11-29,41,Sun,11,12,,CHI,W 41-25,41,25,16,66,2020,2020_12_GNB_CHI
HOU,2020-11-26,41,Thu,11,12,@,DET,W 41-25,41,25,16,66,2020,2020_12_HOU_DET
WAS,2020-11-26,41,Thu,11,12,@,DAL,W 41-16,41,16,25,57,2020,2020_12_WAS_DAL
IND,2020-11-01,41,Sun,7,8,@,DET,W 41-21,41,21,20,62,2020,2020_08_IND_DET
NYG,2019-12-22,41,Sun,15,16,@,WAS,W 41-35 (OT),41,35,6,76,2019,2019_16_NYG_WAS
CLE,2019-11-24,41,Sun,11,12,,MIA,W 41-24,41,24,17,65,2019,2019_12_CLE_MIA
BAL,2019-11-17,41,Sun,10,11,,HOU,W 41-7,41,7,34,48,2019,2019_11_BAL_HOU
SFO,2019-09-15,41,Sun,2,2,@,CIN,W 41-17,41,17,24,58,2019,2019_02_SFO_CIN
MIN,2018-12-16,41,Sun,14,15,,MIA,W 41-17,41,17,24,58,2018,2018_15_MIN_MIA
BUF,2018-11-11,41,Sun,10,10,@,NYJ,W 41-10,41,10,31,51,2018,2018_10_BUF_NYJ
CHI,2018-11-04,41,Sun,8,9,@,BUF,W 41-9,41,9,32,50,2018,2018_09_CHI_BUF
PIT,2018-10-07,41,Sun,5,5,,ATL,W 41-17,41,17,24,58,2018,2018_05_PIT_ATL
NWE,2017-11-12,41,Sun,9,10,@,DEN,W 41-16,41,16,25,57,2017,2017_10_NWE_DEN
SEA,2017-10-29,41,Sun,7,8,,HOU,W 41-38,41,38,3,79,2017,2017_08_SEA_HOU
LAR,2017-09-21,41,Thu,3,3,@,SFO,W 41-39,41,39,2,80,2017,2017_03_LAR_SFO
DAL,2022-12-24,40,Sat,15,16,,PHI,W 40-34,40,34,6,74,2022,2022_16_DAL_PHI
JAX,2022-12-18,40,Sun,14,15,,DAL,W 40-34 (OT),40,34,6,74,2022,2022_15_JAX_DAL
DET,2022-12-04,40,Sun,12,13,,JAX,W 40-14,40,14,26,54,2022,2022_13_DET_JAX
PHI,2022-11-27,40,Sun,11,12,,GNB,W 40-33,40,33,7,73,2022,2022_12_PHI_GNB
LVR,2022-11-27,40,Sun,11,12,@,SEA,W 40-34 (OT),40,34,6,74,2022,2022_12_LVR_SEA
DAL,2022-11-20,40,Sun,10,11,@,MIN,W 40-3,40,3,37,43,2022,2022_11_DAL_MIN
NYJ,2022-10-09,40,Sun,5,5,,MIA,W 40-17,40,17,23,57,2022,2022_05_NYJ_MIA
PHI,2021-11-21,40,Sun,11,11,,NOR,W 40-29,40,29,11,69,2021,2021_11_PHI_NOR
BUF,2021-10-03,40,Sun,4,4,,HOU,W 40-0,40,0,40,40,2021,2021_04_BUF_HOU
GNB,2020-12-27,40,Sun,15,16,,TEN,W 40-14,40,14,26,54,2020,2020_16_GNB_TEN
BAL,2020-12-20,40,Sun,14,15,,JAX,W 40-14,40,14,26,54,2020,2020_15_BAL_JAX
SEA,2020-12-13,40,Sun,13,14,,NYJ,W 40-3,40,3,37,43,2020,2020_14_SEA_NYJ
ATL,2020-10-18,40,Sun,6,6,@,MIN,W 40-23,40,23,17,63,2020,2020_06_ATL_MIN
LVR,2020-10-11,40,Sun,5,5,@,KAN,W 40-32,40,32,8,72,2020,2020_05_LVR_KAN
DAL,2020-09-20,40,Sun,2,2,,ATL,W 40-39,40,39,1,79,2020,2020_02_DAL_ATL
ATL,2019-12-08,40,Sun,13,14,,CAR,W 40-20,40,20,20,60,2019,2019_14_ATL_CAR
KAN,2019-12-01,40,Sun,12,13,,OAK,W 40-9,40,9,31,49,2019,2019_13_KAN_OAK
SEA,2019-11-03,40,Sun,9,9,,TAM,W 40-34 (OT),40,34,6,74,2019,2019_09_SEA_TAM
CLE,2019-09-29,40,Sun,4,4,@,BAL,W 40-25,40,25,15,65,2019,2019_04_CLE_BAL
LAR,2019-09-29,40,Sun,4,4,,TAM,L 40-55,40,55,-15,95,2019,2019_04_LAR_TAM
KAN,2019-09-08,40,Sun,1,1,@,JAX,W 40-26,40,26,14,66,2019,2019_01_KAN_JAX
ATL,2018-12-16,40,Sun,14,15,,ARI,W 40-14,40,14,26,54,2018,2018_15_ATL_ARI
NYG,2018-12-09,40,Sun,13,14,@,WAS,W 40-16,40,16,24,56,2018,2018_14_NYG_WAS
KAN,2018-12-02,40,Sun,12,13,@,OAK,W 40-33,40,33,7,73,2018,2018_13_KAN_OAK
KAN,2018-10-14,40,Sun,6,6,@,NWE,L 40-43,40,43,-3,83,2018,2018_06_KAN_NWE
DAL,2018-10-14,40,Sun,6,6,,JAX,W 40-7,40,7,33,47,2018,2018_06_DAL_JAX
NOR,2018-09-09,40,Sun,1,1,,TAM,L 40-48,40,48,-8,88,2018,2018_01_NOR_TAM
PIT,2017-11-16,40,Thu,10,11,,TEN,W 40-17,40,17,23,57,2017,2017_11_PIT_TEN
BAL,2017-10-26,40,Thu,8,8,,MIA,W 40-0,40,0,40,40,2017,2017_08_BAL_MIA
DAL,2017-10-22,40,Sun,6,7,@,SFO,W 40-10,40,10,30,50,2017,2017_07_DAL_SFO
MIN,2022-12-17,39,Sat,14,15,,IND,W 39-36 (OT),39,36,3,75,2022,2022_15_MIN_IND
MIA,2022-11-13,39,Sun,10,10,,CLE,W 39-17,39,17,22,56,2022,2022_10_MIA_CLE
NOR,2022-10-09,39,Sun,5,5,,SEA,W 39-32,39,32,7,71,2022,2022_05_NOR_SEA
LAC,2020-10-25,39,Sun,6,7,,JAX,W 39-29,39,29,10,68,2020,2020_07_LAC_JAX
ATL,2020-09-20,39,Sun,2,2,@,DAL,L 39-40,39,40,-1,79,2020,2020_02_ATL_DAL
MIN,2019-12-15,39,Sun,14,15,@,LAC,W 39-10,39,10,29,49,2019,2019_15_MIN_LAC
LAR,2018-10-21,39,Sun,7,7,@,SFO,W 39-10,39,10,29,49,2018,2018_07_LAR_SFO
PIT,2017-12-10,39,Sun,13,14,,BAL,W 39-38,39,38,1,77,2017,2017_14_PIT_BAL
SFO,2017-09-21,39,Thu,3,3,,LAR,L 39-41,39,41,-2,80,2017,2017_03_SFO_LAR
SFO,2023-01-08,38,Sun,17,18,,ARI,W 38-13,38,13,25,51,2022,2022_18_SFO_ARI
NYG,2023-01-01,38,Sun,16,17,,IND,W 38-10,38,10,28,48,2022,2022_17_NYG_IND
SFO,2022-11-21,38,Mon,10,11,@,ARI,W 38-10,38,10,28,48,2022,2022_11_SFO_ARI
LVR,2022-10-23,38,Sun,6,7,,HOU,W 38-20,38,20,18,58,2022,2022_07_LVR_HOU
NWE,2022-10-16,38,Sun,6,6,@,CLE,W 38-15,38,15,23,53,2022,2022_06_NWE_CLE
BUF,2022-10-09,38,Sun,5,5,,PIT,W 38-3,38,3,35,41,2022,2022_05_BUF_PIT
JAX,2022-09-25,38,Sun,3,3,@,LAC,W 38-10,38,10,28,48,2022,2022_03_JAX_LAC
BAL,2022-09-18,38,Sun,2,2,,MIA,L 38-42,38,42,-4,80,2022,2022_02_BAL_MIA
PHI,2022-09-11,38,Sun,1,1,@,DET,W 38-35,38,35,3,73,2022,2022_01_PHI_DET
SEA,2022-01-09,38,Sun,17,18,@,ARI,W 38-30,38,30,8,68,2021,2021_18_SEA_ARI
DEN,2021-12-12,38,Sun,13,14,,DET,W 38-10,38,10,28,48,2021,2021_14_DEN_DET
TAM,2021-11-28,38,Sun,11,12,@,IND,W 38-31,38,31,7,69,2021,2021_12_TAM_IND
LAR,2021-10-31,38,Sun,8,8,@,HOU,W 38-22,38,22,16,60,2021,2021_08_LAR_HOU
TAM,2021-10-24,38,Sun,7,7,,CHI,W 38-3,38,3,35,41,2021,2021_07_TAM_CHI
LAR,2021-10-17,38,Sun,6,6,@,NYG,W 38-11,38,11,27,49,2021,2021_06_LAR_NYG
BUF,2021-10-10,38,Sun,5,5,@,KAN,W 38-20,38,20,18,58,2021,2021_05_BUF_KAN
ARI,2021-09-12,38,Sun,1,1,@,TEN,W 38-13,38,13,25,51,2021,2021_01_ARI_TEN
NOR,2021-09-12,38,Sun,1,1,,GNB,W 38-3,38,3,35,41,2021,2021_01_NOR_GNB
HOU,2021-01-03,38,Sun,16,17,,TEN,L 38-41,38,41,-3,79,2020,2020_17_HOU_TEN
BAL,2021-01-03,38,Sun,16,17,@,CIN,W 38-3,38,3,35,41,2020,2020_17_BAL_CIN
LAC,2021-01-03,38,Sun,16,17,@,KAN,W 38-21,38,21,17,59,2020,2020_17_LAC_KAN
BUF,2020-12-28,38,Mon,15,16,@,NWE,W 38-9,38,9,29,47,2020,2020_16_BUF_NWE
LAR,2020-12-06,38,Sun,12,13,@,ARI,W 38-28,38,28,10,66,2020,2020_13_LAR_ARI
NOR,2020-11-08,38,Sun,8,9,@,TAM,W 38-3,38,3,35,41,2020,2020_09_NOR_TAM
ARI,2020-10-19,38,Mon,6,6,@,DAL,W 38-10,38,10,28,48,2020,2020_06_ARI_DAL
PIT,2020-10-18,38,Sun,5,6,,CLE,W 38-7,38,7,31,45,2020,2020_06_PIT_CLE
TAM,2020-10-18,38,Sun,6,6,,GNB,W 38-10,38,10,28,48,2020,2020_06_TAM_GNB
PIT,2020-10-11,38,Sun,4,5,,PHI,W 38-29,38,29,9,67,2020,2020_05_PIT_PHI
TAM,2020-10-04,38,Sun,4,4,,LAC,W 38-31,38,31,7,69,2020,2020_04_TAM_LAC
DAL,2020-10-04,38,Sun,4,4,,CLE,L 38-49,38,49,-11,87,2020,2020_04_DAL_CLE
SEA,2020-09-27,38,Sun,3,3,,DAL,W 38-31,38,31,7,69,2020,2020_03_SEA_DAL
SEA,2020-09-13,38,Sun,1,1,@,ATL,W 38-25,38,25,13,63,2020,2020_01_SEA_ATL
BAL,2020-09-13,38,Sun,1,1,,CLE,W 38-6,38,6,32,44,2020,2020_01_BAL_CLE
JAX,2019-12-29,38,Sun,16,17,,IND,W 38-20,38,20,18,58,2019,2019_17_JAX_IND
IND,2019-12-22,38,Sun,15,16,,CAR,W 38-6,38,6,32,44,2019,2019_16_IND_CAR
MIA,2019-12-22,38,Sun,15,16,,CIN,W 38-35 (OT),38,35,3,73,2019,2019_16_MIA_CIN
NOR,2019-12-22,38,Sun,15,16,@,TEN,W 38-28,38,28,10,66,2019,2019_16_NOR_TEN
ARI,2019-12-15,38,Sun,14,15,,CLE,W 38-24,38,24,14,62,2019,2019_15_ARI_CLE
TAM,2019-12-15,38,Sun,14,15,@,DET,W 38-17,38,17,21,55,2019,2019_15_TAM_DET
TAM,2019-12-08,38,Sun,13,14,,IND,W 38-35,38,35,3,73,2019,2019_14_TAM_IND
DEN,2019-12-08,38,Sun,13,14,@,HOU,W 38-24,38,24,14,62,2019,2019_14_DEN_HOU
MIN,2019-10-13,38,Sun,6,6,,PHI,W 38-20,38,20,18,58,2019,2019_06_MIN_PHI
CAR,2019-09-22,38,Sun,3,3,@,ARI,W 38-20,38,20,18,58,2019,2019_03_CAR_ARI
NWE,2018-12-30,38,Sun,16,17,,NYJ,W 38-3,38,3,35,41,2018,2018_17_NWE_NYJ
NYJ,2018-12-23,38,Sun,15,16,,GNB,L 38-44 (OT),38,44,-6,82,2018,2018_16_NYJ_GNB
SEA,2018-12-23,38,Sun,15,16,,KAN,W 38-31,38,31,7,69,2018,2018_16_SEA_KAN
IND,2018-11-18,38,Sun,10,11,,TEN,W 38-10,38,10,28,48,2018,2018_11_IND_TEN
NYG,2018-11-18,38,Sun,10,11,,TAM,W 38-35,38,35,3,73,2018,2018_11_NYG_TAM
ATL,2018-11-04,38,Sun,8,9,@,WAS,W 38-14,38,14,24,52,2018,2018_09_ATL_WAS
NWE,2018-10-21,38,Sun,7,7,@,CHI,W 38-31,38,31,7,69,2018,2018_07_NWE_CHI
LAC,2018-10-14,38,Sun,6,6,@,CLE,W 38-14,38,14,24,52,2018,2018_06_LAC_CLE
NWE,2018-10-04,38,Thu,5,5,,IND,W 38-24,38,24,14,62,2018,2018_05_NWE_IND
NWE,2018-09-30,38,Sun,4,4,,MIA,W 38-7,38,7,31,45,2018,2018_04_NWE_MIA
LAR,2018-09-27,38,Thu,4,4,,MIN,W 38-31,38,31,7,69,2018,2018_04_LAR_MIN
KAN,2018-09-23,38,Sun,3,3,,SFO,W 38-27,38,27,11,65,2018,2018_03_KAN_SFO
KAN,2018-09-09,38,Sun,1,1,@,LAC,W 38-28,38,28,10,66,2018,2018_01_KAN_LAC
BAL,2017-12-10,38,Sun,13,14,@,PIT,L 38-39,38,39,-1,77,2017,2017_14_BAL_PIT
NYJ,2017-12-03,38,Sun,12,13,,KAN,W 38-31,38,31,7,69,2017,2017_13_NYJ_KAN
DAL,2017-11-30,38,Thu,12,13,,WAS,W 38-14,38,14,24,52,2017,2017_13_DAL_WAS
DET,2017-11-12,38,Sun,9,10,,CLE,W 38-24,38,24,14,62,2017,2017_10_DET_CLE
MIN,2017-11-12,38,Sun,9,10,@,WAS,W 38-30,38,30,8,68,2017,2017_10_MIN_WAS
HOU,2017-10-29,38,Sun,7,8,@,SEA,L 38-41,38,41,-3,79,2017,2017_08_HOU_SEA
DET,2017-10-15,38,Sun,6,6,@,NOR,L 38-52,38,52,-14,90,2017,2017_06_DET_NOR
ARI,2017-10-15,38,Sun,6,6,,TAM,W 38-33,38,33,5,71,2017,2017_06_ARI_TAM
SFO,2023-01-01,37,Sun,16,17,@,LVR,W 37-34 (OT),37,34,3,71,2022,2022_17_SFO_LVR
SFO,2022-12-24,37,Sat,15,16,,WAS,W 37-20,37,20,17,57,2022,2022_16_SFO_WAS
CAR,2022-12-24,37,Sat,15,16,,DET,W 37-23,37,23,14,60,2022,2022_16_CAR_DET
CIN,2022-11-20,37,Sun,10,11,@,PIT,W 37-30,37,30,7,67,2022,2022_11_CIN_PIT
ATL,2022-10-30,37,Sun,8,8,,CAR,W 37-34 (OT),37,34,3,71,2022,2022_08_ATL_CAR
SEA,2022-10-23,37,Sun,7,7,@,LAC,W 37-23,37,23,14,60,2022,2022_07_SEA_LAC
SFO,2022-10-09,37,Sun,5,5,@,CAR,W 37-15,37,15,22,52,2022,2022_05_SFO_CAR
BAL,2022-09-25,37,Sun,3,3,@,NWE,W 37-26,37,26,11,63,2022,2022_03_BAL_NWE
DET,2022-01-09,37,Sun,17,18,,GNB,W 37-30,37,30,7,67,2021,2021_18_DET_GNB
GNB,2022-01-02,37,Sun,16,17,,MIN,W 37-10,37,10,27,47,2021,2021_17_GNB_MIN
LAC,2021-12-12,37,Sun,13,14,,NYG,W 37-21,37,21,16,58,2021,2021_14_LAC_NYG
LAR,2021-12-05,37,Sun,12,13,,JAX,W 37-7,37,7,30,44,2021,2021_13_LAR_JAX
PIT,2021-11-21,37,Sun,10,11,@,LAC,L 37-41,37,41,-4,78,2021,2021_11_PIT_LAC
ARI,2021-10-17,37,Sun,6,6,@,CLE,W 37-14,37,14,23,51,2021,2021_06_ARI_CLE
TEN,2021-10-10,37,Sun,5,5,@,JAX,W 37-19,37,19,18,56,2021,2021_05_TEN_JAX
ARI,2021-10-03,37,Sun,4,4,@,LAR,W 37-20,37,20,17,57,2021,2021_04_ARI_LAR
HOU,2021-09-12,37,Sun,1,1,,JAX,W 37-21,37,21,16,58,2021,2021_01_HOU_JAX
MIN,2021-01-03,37,Sun,16,17,@,DET,W 37-35,37,35,2,72,2020,2020_17_MIN_DET
DAL,2020-12-27,37,Sun,15,16,,PHI,W 37-17,37,17,20,54,2020,2020_16_DAL_PHI
CIN,2020-12-27,37,Sun,15,16,@,HOU,W 37-31,37,31,6,68,2020,2020_16_CIN_HOU
LVR,2020-11-15,37,Sun,9,10,,DEN,W 37-12,37,12,25,49,2020,2020_10_LVR_DEN
SEA,2020-11-01,37,Sun,7,8,,SFO,W 37-27,37,27,10,64,2020,2020_08_SEA_SFO
ARI,2020-10-25,37,Sun,7,7,,SEA,W 37-34 (OT),37,34,3,71,2020,2020_07_ARI_SEA
CLE,2020-10-25,37,Sun,7,7,@,CIN,W 37-34,37,34,3,71,2020,2020_07_CLE_CIN
DAL,2020-10-11,37,Sun,5,5,,NYG,W 37-34,37,34,3,71,2020,2020_05_DAL_NYG
DEN,2020-10-01,37,Thu,4,4,@,NYJ,W 37-28,37,28,9,65,2020,2020_04_DEN_NYJ
GNB,2020-09-27,37,Sun,3,3,@,NOR,W 37-30,37,30,7,67,2020,2020_03_GNB_NOR
LAR,2020-09-20,37,Sun,2,2,@,PHI,W 37-19,37,19,18,56,2020,2020_02_LAR_PHI
PHI,2019-12-15,37,Sun,14,15,@,WAS,W 37-27,37,27,10,64,2019,2019_15_PHI_WAS
SEA,2019-12-02,37,Mon,12,13,,MIN,W 37-30,37,30,7,67,2019,2019_13_SEA_MIN
MIA,2019-12-01,37,Sun,12,13,,PHI,W 37-31,37,31,6,68,2019,2019_13_MIA_PHI
SFO,2019-11-24,37,Sun,11,12,,GNB,W 37-8,37,8,29,45,2019,2019_12_SFO_GNB
BUF,2019-11-17,37,Sun,10,11,@,MIA,W 37-20,37,20,17,57,2019,2019_11_BUF_MIA
DAL,2019-11-04,37,Mon,8,9,@,NYG,W 37-18,37,18,19,55,2019,2019_09_DAL_NYG
BAL,2019-11-03,37,Sun,8,9,,NWE,W 37-20,37,20,17,57,2019,2019_09_BAL_NWE
LAR,2019-10-20,37,Sun,7,7,@,ATL,W 37-10,37,10,27,47,2019,2019_07_LAR_ATL
DAL,2019-10-20,37,Sun,7,7,,PHI,W 37-10,37,10,27,47,2019,2019_07_DAL_PHI
CAR,2019-10-13,37,Sun,6,6,@,TAM,W 37-26,37,26,11,63,2019,2019_06_CAR_TAM
KAN,2018-11-04,37,Sun,9,9,@,CLE,W 37-21,37,21,16,58,2018,2018_09_KAN_CLE
CIN,2018-10-28,37,Sun,8,8,,TAM,W 37-34,37,34,3,71,2018,2018_08_CIN_TAM
MIN,2018-10-21,37,Sun,7,7,@,NYJ,W 37-17,37,17,20,54,2018,2018_07_MIN_NYJ
IND,2018-10-21,37,Sun,7,7,,BUF,W 37-5,37,5,32,42,2018,2018_07_IND_BUF
CIN,2018-09-30,37,Sun,4,4,@,ATL,W 37-36,37,36,1,73,2018,2018_04_CIN_ATL
HOU,2018-09-30,37,Sun,4,4,@,IND,W 37-34 (OT),37,34,3,71,2018,2018_04_HOU_IND
ATL,2018-09-23,37,Sun,3,3,,NOR,L 37-43 (OT),37,43,-6,80,2018,2018_03_ATL_NOR
PIT,2018-09-16,37,Sun,2,2,,KAN,L 37-42,37,42,-5,79,2018,2018_02_PIT_KAN
NWE,2017-12-24,37,Sun,15,16,,BUF,W 37-16,37,16,21,53,2017,2017_16_NWE_BUF
PHI,2017-11-19,37,Sun,10,11,@,DAL,W 37-9,37,9,28,46,2017,2017_11_PHI_DAL
TEN,2017-09-17,37,Sun,2,2,@,JAX,W 37-16,37,16,21,53,2017,2017_02_TEN_JAX
IND,2022-12-17,36,Sat,14,15,@,MIN,L 36-39 (OT),36,39,-3,75,2022,2022_15_IND_MIN
JAX,2022-12-11,36,Sun,13,14,@,TEN,W 36-22,36,22,14,58,2022,2022_14_JAX_TEN
DET,2022-09-18,36,Sun,2,2,,WAS,W 36-27,36,27,9,63,2022,2022_02_DET_WAS
KAN,2021-12-26,36,Sun,15,16,,PIT,W 36-10,36,10,26,46,2021,2021_16_KAN_PIT
MIN,2021-12-09,36,Thu,13,14,,PIT,W 36-28,36,28,8,64,2021,2021_14_MIN_PIT
NWE,2021-11-28,36,Sun,12,12,,TEN,W 36-13,36,13,23,49,2021,2021_12_NWE_TEN
GNB,2021-11-28,36,Sun,12,12,,LAR,W 36-28,36,28,8,64,2021,2021_12_GNB_LAR
LVR,2021-11-25,36,Thu,11,12,@,DAL,W 36-33 (OT),36,33,3,69,2021,2021_12_LVR_DAL
NOR,2021-10-31,36,Sun,7,8,,TAM,W 36-27,36,27,9,63,2021,2021_08_NOR_TAM
DAL,2021-10-03,36,Sun,4,4,,CAR,W 36-28,36,28,8,64,2021,2021_04_DAL_CAR
BAL,2021-09-19,36,Sun,2,2,,KAN,W 36-35,36,35,1,71,2021,2021_02_BAL_KAN
CHI,2020-12-13,36,Sun,13,14,,HOU,W 36-7,36,7,29,43,2020,2020_14_CHI_HOU
PIT,2020-11-15,36,Sun,9,10,,CIN,W 36-10,36,10,26,46,2020,2020_10_PIT_CIN
HOU,2020-10-18,36,Sun,6,6,@,TEN,L 36-42 (OT),36,42,-6,78,2020,2020_06_HOU_TEN
NWE,2020-09-27,36,Sun,3,3,,LVR,W 36-20,36,20,16,56,2020,2020_03_NWE_LVR
SFO,2020-09-27,36,Sun,3,3,@,NYG,W 36-9,36,9,27,45,2020,2020_03_SFO_NYG
IND,2020-09-27,36,Sun,3,3,,NYJ,W 36-7,36,7,29,43,2020,2020_03_IND_NYJ
NYG,2019-12-15,36,Sun,14,15,,MIA,W 36-20,36,20,16,56,2019,2019_15_NYG_MIA
SFO,2019-11-17,36,Sun,10,11,,ARI,W 36-26,36,26,10,62,2019,2019_11_SFO_ARI
NOR,2019-10-20,36,Sun,7,7,@,CHI,W 36-25,36,25,11,61,2019,2019_07_NOR_CHI
DAL,2018-12-30,36,Sun,16,17,@,NYG,W 36-35,36,35,1,71,2018,2018_17_DAL_NYG
LAR,2018-11-11,36,Sun,10,10,,SEA,W 36-31,36,31,5,67,2018,2018_10_LAR_SEA
CAR,2018-10-28,36,Sun,7,8,,BAL,W 36-21,36,21,15,57,2018,2018_08_CAR_BAL
ATL,2018-09-30,36,Sun,4,4,,CIN,L 36-37,36,37,-1,73,2018,2018_04_ATL_CIN
TEN,2017-10-16,36,Mon,6,6,,IND,W 36-22,36,22,14,58,2017,2017_06_TEN_IND
NWE,2017-09-24,36,Sun,3,3,,HOU,W 36-33,36,33,3,69,2017,2017_03_NWE_HOU
NWE,2017-09-17,36,Sun,2,2,@,NOR,W 36-20,36,20,16,56,2017,2017_02_NWE_NOR
BUF,2023-01-08,35,Sun,16,18,,NWE,W 35-23,35,23,12,58,2022,2022_18_BUF_NWE
BUF,2022-12-24,35,Sat,15,16,@,CHI,W 35-13,35,13,22,48,2022,2022_16_BUF_CHI
SFO,2022-12-11,35,Sun,13,14,,TAM,W 35-7,35,7,28,42,2022,2022_14_SFO_TAM
PHI,2022-12-04,35,Sun,12,13,,TEN,W 35-10,35,10,25,45,2022,2022_13_PHI_TEN
MIA,2022-11-06,35,Sun,9,9,@,CHI,W 35-32,35,32,3,67,2022,2022_09_MIA_CHI
PHI,2022-10-30,35,Sun,7,8,,PIT,W 35-13,35,13,22,48,2022,2022_08_PHI_PIT
CIN,2022-10-23,35,Sun,7,7,,ATL,W 35-17,35,17,18,52,2022,2022_07_CIN_ATL
DET,2022-09-11,35,Sun,1,1,,PHI,L 35-38,35,38,-3,73,2022,2022_01_DET_PHI
LVR,2022-01-09,35,Sun,17,18,,LAC,W 35-32 (OT),35,32,3,67,2021,2021_18_LVR_LAC
DAL,2021-10-17,35,Sun,6,6,@,NWE,W 35-29 (OT),35,29,6,64,2021,2021_06_DAL_NWE
GNB,2021-09-20,35,Mon,2,2,,DET,W 35-17,35,17,18,52,2021,2021_02_GNB_DET
BUF,2021-09-19,35,Sun,2,2,@,MIA,W 35-0,35,0,35,35,2021,2021_02_BUF_MIA
KAN,2021-09-19,35,Sun,2,2,@,BAL,L 35-36,35,36,-1,71,2021,2021_02_KAN_BAL
GNB,2021-01-03,35,Sun,16,17,@,CHI,W 35-16,35,16,19,51,2020,2020_17_GNB_CHI
DET,2021-01-03,35,Sun,16,17,,MIN,L 35-37,35,37,-2,72,2020,2020_17_DET_MIN
TEN,2020-12-06,35,Sun,12,13,,CLE,L 35-41,35,41,-6,76,2020,2020_13_TEN_CLE
KAN,2020-11-22,35,Sun,10,11,@,LVR,W 35-31,35,31,4,66,2020,2020_11_KAN_LVR
KAN,2020-11-01,35,Sun,8,8,,NYJ,W 35-9,35,9,26,44,2020,2020_08_KAN_NYJ
GNB,2020-10-25,35,Sun,6,7,@,HOU,W 35-20,35,20,15,55,2020,2020_07_GNB_HOU
NOR,2020-10-04,35,Sun,4,4,@,DET,W 35-29,35,29,6,64,2020,2020_04_NOR_DET
BUF,2020-09-27,35,Sun,3,3,,LAR,W 35-32,35,32,3,67,2020,2020_03_BUF_LAR
SEA,2020-09-20,35,Sun,2,2,,NWE,W 35-30,35,30,5,65,2020,2020_02_SEA_NWE
CLE,2020-09-17,35,Thu,2,2,,CIN,W 35-30,35,30,5,65,2020,2020_02_CLE_CIN
TEN,2019-12-29,35,Sun,16,17,@,HOU,W 35-14,35,14,21,49,2019,2019_17_TEN_HOU
CIN,2019-12-22,35,Sun,15,16,@,MIA,L 35-38 (OT),35,38,-3,73,2019,2019_16_CIN_MIA
WAS,2019-12-22,35,Sun,15,16,,NYG,L 35-41 (OT),35,41,-6,76,2019,2019_16_WAS_NYG
IND,2019-12-08,35,Sun,13,14,@,TAM,L 35-38,35,38,-3,73,2019,2019_14_IND_TAM
TAM,2019-11-24,35,Sun,11,12,@,ATL,W 35-22,35,22,13,57,2019,2019_12_TAM_ATL
DAL,2019-11-17,35,Sun,10,11,@,DET,W 35-27,35,27,8,62,2019,2019_11_DAL_DET
TEN,2019-11-10,35,Sun,10,10,,KAN,W 35-32,35,32,3,67,2019,2019_10_TEN_KAN
NWE,2019-10-10,35,Thu,6,6,,NYG,W 35-14,35,14,21,49,2019,2019_06_NWE_NYG
DAL,2019-09-08,35,Sun,1,1,,NYG,W 35-17,35,17,18,52,2019,2019_01_DAL_NYG
KAN,2018-12-30,35,Sun,16,17,,OAK,W 35-3,35,3,32,38,2018,2018_17_KAN_OAK
NYG,2018-12-30,35,Sun,16,17,,DAL,L 35-36,35,36,-1,71,2018,2018_17_NYG_DAL
CLE,2018-11-25,35,Sun,11,12,@,CIN,W 35-20,35,20,15,55,2018,2018_12_CLE_CIN
TAM,2018-11-18,35,Sun,10,11,@,NYG,L 35-38,35,38,-3,73,2018,2018_11_TAM_NYG
LAR,2018-11-04,35,Sun,9,9,@,NOR,L 35-45,35,45,-10,80,2018,2018_09_LAR_NOR
LAR,2018-09-23,35,Sun,3,3,,LAC,W 35-23,35,23,12,58,2018,2018_03_LAR_LAC
DET,2017-12-31,35,Sun,16,17,,GNB,W 35-11,35,11,24,46,2017,2017_17_DET_GNB
LAR,2017-12-10,35,Sun,13,14,,PHI,L 35-43,35,43,-8,78,2017,2017_14_LAR_PHI
MIA,2017-12-03,35,Sun,12,13,,DEN,W 35-9,35,9,26,44,2017,2017_13_MIA_DEN
NWE,2017-11-26,35,Sun,11,12,,MIA,W 35-17,35,17,18,52,2017,2017_12_NWE_MIA
CAR,2017-11-26,35,Sun,11,12,@,NYJ,W 35-27,35,27,8,62,2017,2017_12_CAR_NYJ
GNB,2017-10-08,35,Sun,5,5,@,DAL,W 35-31,35,31,4,66,2017,2017_05_GNB_DAL
LAR,2017-10-01,35,Sun,4,4,@,DAL,W 35-30,35,30,5,65,2017,2017_04_LAR_DAL
GNB,2017-09-28,35,Thu,4,4,,CHI,W 35-14,35,14,21,49,2017,2017_04_GNB_CHI
DET,2017-09-10,35,Sun,1,1,,ARI,W 35-23,35,23,12,58,2017,2017_01_DET_ARI
LVR,2023-01-01,34,Sun,16,17,,SFO,L 34-37 (OT),34,37,-3,71,2022,2022_17_LVR_SFO
PHI,2022-12-24,34,Sat,15,16,@,DAL,L 34-40,34,40,-6,74,2022,2022_16_PHI_DAL
DAL,2022-12-18,34,Sun,14,15,@,JAX,L 34-40 (OT),34,40,-6,74,2022,2022_15_DAL_JAX
CIN,2022-12-18,34,Sun,14,15,@,TAM,W 34-23,34,23,11,57,2022,2022_15_CIN_TAM
KAN,2022-12-11,34,Sun,13,14,@,DEN,W 34-28,34,28,6,62,2022,2022_14_KAN_DEN
DET,2022-12-11,34,Sun,13,14,,MIN,W 34-23,34,23,11,57,2022,2022_14_DET_MIN
SEA,2022-11-27,34,Sun,11,12,,LVR,L 34-40 (OT),34,40,-6,74,2022,2022_12_SEA_LVR
CAR,2022-10-30,34,Sun,8,8,@,ATL,L 34-37 (OT),34,37,-3,71,2022,2022_08_CAR_ATL
MIN,2022-10-30,34,Sun,7,8,,ARI,W 34-26,34,26,8,60,2022,2022_08_MIN_ARI
NOR,2022-10-20,34,Thu,7,7,@,ARI,L 34-42,34,42,-8,76,2022,2022_07_NOR_ARI
IND,2022-10-16,34,Sun,6,6,,JAX,W 34-27,34,27,7,61,2022,2022_06_IND_JAX
LAC,2022-10-02,34,Sun,4,4,@,HOU,W 34-24,34,24,10,58,2022,2022_04_LAC_HOU
TEN,2022-01-02,34,Sun,16,17,,MIA,W 34-3,34,3,31,37,2021,2021_17_TEN_MIA
CIN,2022-01-02,34,Sun,16,17,,KAN,W 34-31,34,31,3,65,2021,2021_17_CIN_KAN
LAC,2022-01-02,34,Sun,16,17,,DEN,W 34-13,34,13,21,47,2021,2021_17_LAC_DEN
PHI,2021-12-26,34,Sun,15,16,,NYG,W 34-10,34,10,24,44,2021,2021_16_PHI_NYG
KAN,2021-12-16,34,Thu,14,15,@,LAC,W 34-28 (OT),34,28,6,62,2021,2021_15_KAN_LAC
SFO,2021-11-28,34,Sun,11,12,,MIN,W 34-26,34,26,8,60,2021,2021_12_SFO_MIN
MIN,2021-11-21,34,Sun,10,11,,GNB,W 34-31,34,31,3,65,2021,2021_11_MIN_GNB
CAR,2021-11-14,34,Sun,10,10,@,ARI,W 34-10,34,10,24,44,2021,2021_10_CAR_ARI
BAL,2021-11-07,34,Sun,8,9,,MIN,W 34-31 (OT),34,31,3,65,2021,2021_09_BAL_MIN
TEN,2021-10-31,34,Sun,8,8,@,IND,W 34-31 (OT),34,31,3,65,2021,2021_08_TEN_IND
TEN,2021-10-31,34,Sun,8,8,@,IND,W 34-31 (OT),34,31,3,65,2021,2021_08_TEN_IND
TEN,2021-10-18,34,Mon,6,6,,BUF,W 34-31,34,31,3,65,2021,2021_06_TEN_BUF
BAL,2021-10-17,34,Sun,6,6,,LAC,W 34-6,34,6,28,40,2021,2021_06_BAL_LAC
MIN,2021-10-17,34,Sun,6,6,@,CAR,W 34-28 (OT),34,28,6,62,2021,2021_06_MIN_CAR
CIN,2021-10-17,34,Sun,6,6,@,DET,W 34-11,34,11,23,45,2021,2021_06_CIN_DET
LVR,2021-10-17,34,Sun,6,6,@,DEN,W 34-24,34,24,10,58,2021,2021_06_LVR_DEN
WAS,2021-10-03,34,Sun,4,4,@,ATL,W 34-30,34,30,4,64,2021,2021_04_WAS_ATL
LAR,2021-09-26,34,Sun,3,3,,TAM,W 34-24,34,24,10,58,2021,2021_03_LAR_TAM
ARI,2021-09-19,34,Sun,2,2,,MIN,W 34-33,34,33,1,67,2021,2021_02_ARI_MIN
LAR,2021-09-12,34,Sun,1,1,,CHI,W 34-14,34,14,20,48,2021,2021_01_LAR_CHI
BAL,2020-12-08,34,Tue,12,13,,DAL,W 34-17,34,17,17,51,2020,2020_13_BAL_DAL
BUF,2020-12-07,34,Mon,12,13,@,SFO,W 34-24,34,24,10,58,2020,2020_13_BUF_SFO
DET,2020-12-06,34,Sun,12,13,@,CHI,W 34-30,34,30,4,64,2020,2020_13_DET_CHI
IND,2020-11-22,34,Sun,10,11,,GNB,W 34-31 (OT),34,31,3,65,2020,2020_11_IND_GNB
LAC,2020-11-22,34,Sun,10,11,,NYJ,W 34-28,34,28,6,62,2020,2020_11_LAC_NYJ
IND,2020-11-12,34,Thu,9,10,@,TEN,W 34-17,34,17,17,51,2020,2020_10_IND_TEN
MIA,2020-11-08,34,Sun,8,9,@,ARI,W 34-31,34,31,3,65,2020,2020_09_MIA_ARI
ATL,2020-11-08,34,Sun,9,9,,DEN,W 34-27,34,27,7,61,2020,2020_09_ATL_DEN
MIN,2020-11-08,34,Sun,8,9,,DET,W 34-20,34,20,14,54,2020,2020_09_MIN_DET
SEA,2020-11-08,34,Sun,8,9,@,BUF,L 34-44,34,44,-10,78,2020,2020_09_SEA_BUF
GNB,2020-11-05,34,Thu,8,9,@,SFO,W 34-17,34,17,17,51,2020,2020_09_GNB_SFO
SEA,2020-10-25,34,Sun,6,7,@,ARI,L 34-37 (OT),34,37,-3,71,2020,2020_07_SEA_ARI
CIN,2020-10-25,34,Sun,7,7,,CLE,L 34-37,34,37,-3,71,2020,2020_07_CIN_CLE
DET,2020-10-18,34,Sun,5,6,@,JAX,W 34-16,34,16,18,50,2020,2020_06_DET_JAX
NYG,2020-10-11,34,Sun,5,5,@,DAL,L 34-37,34,37,-3,71,2020,2020_05_NYG_DAL
KAN,2020-09-28,34,Mon,3,3,@,BAL,W 34-20,34,20,14,54,2020,2020_03_KAN_BAL
CLE,2020-09-27,34,Sun,3,3,,WAS,W 34-20,34,20,14,54,2020,2020_03_CLE_WAS
LVR,2020-09-21,34,Mon,2,2,,NOR,W 34-24,34,24,10,58,2020,2020_02_LVR_NOR
MIN,2020-09-13,34,Sun,1,1,,GNB,L 34-43,34,43,-9,77,2020,2020_01_MIN_GNB
NOR,2020-09-13,34,Sun,1,1,,TAM,W 34-23,34,23,11,57,2020,2020_01_NOR_TAM
LVR,2020-09-13,34,Sun,1,1,@,CAR,W 34-30,34,30,4,64,2020,2020_01_LVR_CAR
KAN,2020-09-10,34,Thu,1,1,,HOU,W 34-20,34,20,14,54,2020,2020_01_KAN_HOU
PHI,2019-12-29,34,Sun,16,17,@,NYG,W 34-17,34,17,17,51,2019,2019_17_PHI_NYG
SFO,2019-12-21,34,Sat,15,16,,LAR,W 34-31,34,31,3,65,2019,2019_16_SFO_LAR
NOR,2019-12-16,34,Mon,14,15,,IND,W 34-7,34,7,27,41,2019,2019_15_NOR_IND
NWE,2019-12-15,34,Sun,14,15,@,CIN,W 34-13,34,13,21,47,2019,2019_15_NWE_CIN
LAR,2019-12-01,34,Sun,12,13,@,ARI,W 34-7,34,7,27,41,2019,2019_13_LAR_ARI
NYJ,2019-11-24,34,Sun,11,12,,OAK,W 34-3,34,3,31,37,2019,2019_12_NYJ_OAK
NOR,2019-11-24,34,Sun,11,12,,CAR,W 34-31,34,31,3,65,2019,2019_12_NOR_CAR
NOR,2019-11-17,34,Sun,10,11,@,TAM,W 34-17,34,17,17,51,2019,2019_11_NOR_TAM
NYJ,2019-11-17,34,Sun,10,11,@,WAS,W 34-17,34,17,17,51,2019,2019_11_NYJ_WAS
NYJ,2019-11-10,34,Sun,9,10,,NYG,W 34-27,34,27,7,61,2019,2019_10_NYJ_NYG
TAM,2019-11-03,34,Sun,8,9,@,SEA,L 34-40 (OT),34,40,-6,74,2019,2019_09_TAM_SEA
ARI,2019-10-13,34,Sun,6,6,,ATL,W 34-33,34,33,1,67,2019,2019_06_ARI_ATL
CAR,2019-10-06,34,Sun,5,5,,JAX,W 34-27,34,27,7,61,2019,2019_05_CAR_JAX
GNB,2019-10-06,34,Sun,5,5,@,DAL,W 34-24,34,24,10,58,2019,2019_05_GNB_DAL
KAN,2019-09-29,34,Sun,4,4,@,DET,W 34-30,34,30,4,64,2019,2019_04_KAN_DET
PHI,2019-09-26,34,Thu,4,4,@,GNB,W 34-27,34,27,7,61,2019,2019_04_PHI_GNB
MIN,2019-09-22,34,Sun,3,3,,OAK,W 34-14,34,14,20,48,2019,2019_03_MIN_OAK
ATL,2018-12-30,34,Sun,16,17,@,TAM,W 34-32,34,32,2,66,2018,2018_17_ATL_TAM
MIA,2018-12-09,34,Sun,13,14,,NWE,W 34-33,34,33,1,67,2018,2018_14_MIA_NWE
GNB,2018-12-09,34,Sun,13,14,,ATL,W 34-20,34,20,14,54,2018,2018_14_GNB_ATL
HOU,2018-11-26,34,Mon,11,12,,TEN,W 34-17,34,17,17,51,2018,2018_12_HOU_TEN
BAL,2018-11-25,34,Sun,11,12,,OAK,W 34-17,34,17,17,51,2018,2018_12_BAL_OAK
TEN,2018-11-11,34,Sun,9,10,,NWE,W 34-10,34,10,24,44,2018,2018_10_TEN_NWE
CHI,2018-11-11,34,Sun,9,10,,DET,W 34-22,34,22,12,56,2018,2018_10_CHI_DET
SFO,2018-11-01,34,Thu,9,9,,OAK,W 34-3,34,3,31,37,2018,2018_09_SFO_OAK
TAM,2018-10-28,34,Sun,7,8,@,CIN,L 34-37,34,37,-3,71,2018,2018_08_TAM_CIN
IND,2018-10-14,34,Sun,6,6,@,NYJ,L 34-42,34,42,-8,76,2018,2018_06_IND_NYJ
ATL,2018-10-14,34,Sun,6,6,,TAM,W 34-29,34,29,5,63,2018,2018_06_ATL_TAM
PHI,2018-10-11,34,Thu,6,6,@,NYG,W 34-13,34,13,21,47,2018,2018_06_PHI_NYG
NYJ,2018-10-07,34,Sun,5,5,,DEN,W 34-16,34,16,18,50,2018,2018_05_NYJ_DEN
IND,2018-09-30,34,Sun,4,4,,HOU,L 34-37 (OT),34,37,-3,71,2018,2018_04_IND_HOU
LAR,2018-09-16,34,Sun,2,2,,ARI,W 34-0,34,0,34,34,2018,2018_02_LAR_ARI
CIN,2018-09-13,34,Thu,2,2,,BAL,W 34-23,34,23,11,57,2018,2018_02_CIN_BAL
CIN,2018-09-09,34,Sun,1,1,@,IND,W 34-23,34,23,11,57,2018,2018_01_CIN_IND
SFO,2017-12-31,34,Sun,16,17,@,LAR,W 34-13,34,13,21,47,2017,2017_17_SFO_LAR
PIT,2017-12-25,34,Mon,15,16,@,HOU,W 34-6,34,6,28,40,2017,2017_16_PIT_HOU
PHI,2017-12-17,34,Sun,14,15,@,NYG,W 34-29,34,29,5,63,2017,2017_15_PHI_NYG
MIN,2017-12-17,34,Sun,14,15,,CIN,W 34-7,34,7,27,41,2017,2017_15_MIN_CIN
ATL,2017-11-26,34,Sun,11,12,,TAM,W 34-20,34,20,14,54,2017,2017_12_ATL_TAM
ATL,2017-11-20,34,Mon,10,11,@,SEA,W 34-31,34,31,3,65,2017,2017_11_ATL_SEA
NOR,2017-11-19,34,Sun,10,11,,WAS,W 34-31 (OT),34,31,3,65,2017,2017_11_NOR_WAS
NYJ,2017-11-02,34,Thu,9,9,,BUF,W 34-21,34,21,13,55,2017,2017_09_NYJ_BUF
BUF,2017-10-29,34,Sun,7,8,,OAK,W 34-14,34,14,20,48,2017,2017_08_BUF_OAK
PHI,2017-10-23,34,Mon,7,7,,WAS,W 34-24,34,24,10,58,2017,2017_07_PHI_WAS
HOU,2017-10-08,34,Sun,5,5,,KAN,L 34-42,34,42,-8,76,2017,2017_05_HOU_KAN
PHI,2017-10-08,34,Sun,5,5,,ARI,W 34-7,34,7,27,41,2017,2017_05_PHI_ARI
NOR,2017-09-24,34,Sun,3,3,@,CAR,W 34-13,34,13,21,47,2017,2017_03_NOR_CAR
MIN,2017-09-24,34,Sun,3,3,,TAM,W 34-17,34,17,17,51,2017,2017_03_MIN_TAM
ATL,2017-09-17,34,Sun,2,2,,GNB,W 34-23,34,23,11,57,2017,2017_02_ATL_GNB
SFO,2022-12-04,33,Sun,12,13,,MIA,W 33-17,33,17,16,50,2022,2022_13_SFO_MIA
GNB,2022-11-27,33,Sun,12,12,@,PHI,L 33-40,33,40,-7,73,2022,2022_12_GNB_PHI
MIN,2022-11-24,33,Thu,11,12,,NWE,W 33-26,33,26,7,59,2022,2022_12_MIN_NWE
MIN,2022-11-13,33,Sun,9,10,@,BUF,W 33-30 (OT),33,30,3,63,2022,2022_10_MIN_BUF
CHI,2022-10-24,33,Mon,7,7,@,NWE,W 33-14,33,14,19,47,2022,2022_07_CHI_NWE
MIA,2022-01-09,33,Sun,17,18,,NWE,W 33-24,33,24,9,57,2021,2021_18_MIA_NWE
BUF,2021-12-26,33,Sun,15,16,@,NWE,W 33-21,33,21,12,54,2021,2021_16_BUF_NWE
TAM,2021-12-12,33,Sun,13,14,,BUF,W 33-27 (OT),33,27,6,60,2021,2021_14_TAM_BUF
SEA,2021-12-12,33,Sun,13,14,@,HOU,W 33-13,33,13,20,46,2021,2021_14_SEA_HOU
PHI,2021-12-05,33,Sun,13,13,@,NYJ,W 33-18,33,18,15,51,2021,2021_13_PHI_NYJ
ARI,2021-12-05,33,Sun,12,13,@,CHI,W 33-22,33,22,11,55,2021,2021_13_ARI_CHI
MIA,2021-11-28,33,Sun,12,12,,CAR,W 33-10,33,10,23,43,2021,2021_12_MIA_CAR
DAL,2021-11-25,33,Thu,11,12,,LVR,L 33-36 (OT),33,36,-3,69,2021,2021_12_DAL_LVR
SFO,2021-10-31,33,Sun,7,8,@,CHI,W 33-22,33,22,11,55,2021,2021_08_SFO_CHI
LVR,2021-10-24,33,Sun,7,7,,PHI,W 33-22,33,22,11,55,2021,2021_07_LVR_PHI
NOR,2021-10-10,33,Sun,5,5,@,WAS,W 33-22,33,22,11,55,2021,2021_05_NOR_WAS
TEN,2021-09-19,33,Sun,2,2,@,SEA,W 33-30 (OT),33,30,3,63,2021,2021_02_TEN_SEA
MIN,2021-09-19,33,Sun,2,2,@,ARI,L 33-34,33,34,-1,67,2021,2021_02_MIN_ARI
LVR,2021-09-13,33,Mon,1,1,,BAL,W 33-27 (OT),33,27,6,60,2021,2021_01_LVR_BAL
DET,2021-09-12,33,Sun,1,1,,SFO,L 33-41,33,41,-8,74,2021,2021_01_DET_SFO
KAN,2021-09-12,33,Sun,1,1,,CLE,W 33-29,33,29,4,62,2021,2021_01_KAN_CLE
NOR,2021-01-03,33,Sun,16,17,@,CAR,W 33-7,33,7,26,40,2020,2020_17_NOR_CAR
MIN,2020-12-25,33,Fri,15,16,@,NOR,L 33-52,33,52,-19,85,2020,2020_16_MIN_NOR
SFO,2020-12-20,33,Sun,14,15,@,DAL,L 33-41,33,41,-8,74,2020,2020_15_SFO_DAL
CHI,2020-12-20,33,Sun,14,15,@,MIN,W 33-27,33,27,6,60,2020,2020_15_CHI_MIN
ARI,2020-12-20,33,Sun,14,15,,PHI,W 33-26,33,26,7,59,2020,2020_15_ARI_PHI
KAN,2020-12-13,33,Sun,13,14,@,MIA,W 33-27,33,27,6,60,2020,2020_14_KAN_MIA
KAN,2020-11-08,33,Sun,9,9,,CAR,W 33-31,33,31,2,64,2020,2020_09_KAN_CAR
SFO,2020-10-25,33,Sun,7,7,@,NWE,W 33-6,33,6,27,39,2020,2020_07_SFO_NWE
CIN,2020-10-04,33,Sun,4,4,,JAX,W 33-25,33,25,8,58,2020,2020_04_CIN_JAX
BAL,2020-09-20,33,Sun,2,2,@,HOU,W 33-16,33,16,17,49,2020,2020_02_BAL_HOU
TEN,2020-09-20,33,Sun,2,2,,JAX,W 33-30,33,30,3,63,2020,2020_02_TEN_JAX
CIN,2019-12-29,33,Sun,16,17,,CLE,W 33-23,33,23,10,56,2019,2019_17_CIN_CLE
IND,2019-11-17,33,Sun,10,11,,JAX,W 33-13,33,13,20,46,2019,2019_11_IND_JAX
NWE,2019-10-21,33,Mon,7,7,@,NYJ,W 33-0,33,0,33,33,2019,2019_07_NWE_NYJ
ATL,2019-10-13,33,Sun,6,6,@,ARI,L 33-34,33,34,-1,67,2019,2019_06_ATL_ARI
NWE,2019-10-06,33,Sun,5,5,@,WAS,W 33-7,33,7,26,40,2019,2019_05_NWE_WAS
NOR,2019-09-22,33,Sun,3,3,@,SEA,W 33-27,33,27,6,60,2019,2019_03_NOR_SEA
KAN,2019-09-22,33,Sun,3,3,,BAL,W 33-28,33,28,5,61,2019,2019_03_KAN_BAL
NWE,2019-09-08,33,Sun,1,1,,PIT,W 33-3,33,3,30,36,2019,2019_01_NWE_PIT
IND,2018-12-30,33,Sun,16,17,@,TEN,W 33-17,33,17,16,50,2018,2018_17_IND_TEN
CAR,2018-12-30,33,Sun,16,17,@,NOR,W 33-14,33,14,19,47,2018,2018_17_CAR_NOR
NWE,2018-12-09,33,Sun,13,14,@,MIA,L 33-34,33,34,-1,67,2018,2018_14_NWE_MIA
LAC,2018-12-02,33,Sun,12,13,@,PIT,W 33-30,33,30,3,63,2018,2018_13_LAC_PIT
OAK,2018-12-02,33,Sun,12,13,,KAN,L 33-40,33,40,-7,73,2018,2018_13_OAK_KAN
PIT,2018-10-28,33,Sun,7,8,,CLE,W 33-18,33,18,15,51,2018,2018_08_PIT_CLE
GNB,2018-10-15,33,Mon,6,6,,SFO,W 33-30,33,30,3,63,2018,2018_06_GNB_SFO
CAR,2018-10-07,33,Sun,4,5,,NYG,W 33-31,33,31,2,64,2018,2018_05_CAR_NYG
LAR,2018-10-07,33,Sun,5,5,@,SEA,W 33-31,33,31,2,64,2018,2018_05_LAR_SEA
NOR,2018-09-30,33,Sun,4,4,@,NYG,W 33-18,33,18,15,51,2018,2018_04_NOR_NYG
LAR,2018-09-10,33,Mon,1,1,@,OAK,W 33-13,33,13,20,46,2018,2018_01_LAR_OAK
JAX,2017-12-24,33,Sun,15,16,@,SFO,L 33-44,33,44,-11,77,2017,2017_16_JAX_SFO
CHI,2017-12-10,33,Sun,13,14,@,CIN,W 33-7,33,7,26,40,2017,2017_14_CHI_CIN
NWE,2017-11-19,33,Sun,10,11,@,OAK,W 33-8,33,8,25,41,2017,2017_11_NWE_OAK
LAR,2017-11-12,33,Sun,9,10,,HOU,W 33-7,33,7,26,40,2017,2017_10_LAR_HOU
PHI,2017-10-29,33,Sun,8,8,,SFO,W 33-10,33,10,23,43,2017,2017_08_PHI_SFO
DAL,2017-10-29,33,Sun,7,8,@,WAS,W 33-19,33,19,14,52,2017,2017_08_DAL_WAS
MIN,2017-10-29,33,Sun,8,8,@,CLE,W 33-16,33,16,17,49,2017,2017_08_MIN_CLE
LAR,2017-10-22,33,Sun,7,7,,ARI,W 33-0,33,0,33,33,2017,2017_07_LAR_ARI
TAM,2017-10-15,33,Sun,5,6,@,ARI,L 33-38,33,38,-5,71,2017,2017_06_TAM_ARI
HOU,2017-10-15,33,Sun,6,6,,CLE,W 33-17,33,17,16,50,2017,2017_06_HOU_CLE
CAR,2017-10-01,33,Sun,4,4,@,NWE,W 33-30,33,30,3,63,2017,2017_04_CAR_NWE
HOU,2017-09-24,33,Sun,3,3,@,NWE,L 33-36,33,36,-3,69,2017,2017_03_HOU_NWE
TEN,2017-09-24,33,Sun,3,3,,SEA,W 33-27,33,27,6,60,2017,2017_03_TEN_SEA
HOU,2023-01-08,32,Sun,17,18,@,IND,W 32-31,32,31,1,63,2022,2022_18_HOU_IND
BUF,2022-12-17,32,Sat,14,15,,MIA,W 32-29,32,29,3,61,2022,2022_15_BUF_MIA
WAS,2022-11-14,32,Mon,10,10,@,PHI,W 32-21,32,21,11,53,2022,2022_10_WAS_PHI
CHI,2022-11-06,32,Sun,9,9,,MIA,L 32-35,32,35,-3,67,2022,2022_09_CHI_MIA
CLE,2022-10-31,32,Mon,8,8,,CIN,W 32-13,32,13,19,45,2022,2022_08_CLE_CIN
SEA,2022-10-09,32,Sun,5,5,@,NOR,L 32-39,32,39,-7,71,2022,2022_05_SEA_NOR
LVR,2022-10-02,32,Sun,4,4,,DEN,W 32-23,32,23,9,55,2022,2022_04_LVR_DEN
LAC,2022-01-09,32,Sun,17,18,@,LVR,L 32-35 (OT),32,35,-3,67,2021,2021_18_LAC_LVR
TAM,2021-12-26,32,Sun,15,16,@,CAR,W 32-6,32,6,26,38,2021,2021_16_TAM_CAR
CIN,2021-11-21,32,Sun,10,11,@,LVR,W 32-13,32,13,19,45,2021,2021_11_CIN_LVR
PHI,2021-09-12,32,Sun,1,1,@,ATL,W 32-6,32,6,26,38,2021,2021_01_PHI_ATL
LVR,2021-01-03,32,Sun,16,17,@,DEN,W 32-31,32,31,1,63,2020,2020_17_LVR_DEN
KAN,2020-12-20,32,Sun,14,15,@,NOR,W 32-29,32,29,3,61,2020,2020_15_KAN_NOR
DEN,2020-12-13,32,Sun,13,14,@,CAR,W 32-27,32,27,5,59,2020,2020_14_DEN_CAR
ARI,2020-11-15,32,Sun,9,10,,BUF,W 32-30,32,30,2,62,2020,2020_10_ARI_BUF
CLE,2020-10-11,32,Sun,5,5,,IND,W 32-23,32,23,9,55,2020,2020_05_CLE_IND
KAN,2020-10-11,32,Sun,5,5,,LVR,L 32-40,32,40,-8,72,2020,2020_05_KAN_LVR
LAR,2020-09-27,32,Sun,3,3,@,BUF,L 32-35,32,35,-3,67,2020,2020_03_LAR_BUF
KAN,2019-11-10,32,Sun,10,10,@,TEN,L 32-35,32,35,-3,67,2019,2019_10_KAN_TEN
SEA,2019-10-13,32,Sun,6,6,@,CLE,W 32-28,32,28,4,60,2019,2019_06_SEA_CLE
ATL,2019-10-06,32,Sun,5,5,@,HOU,L 32-53,32,53,-21,85,2019,2019_05_ATL_HOU
NYG,2019-09-22,32,Sun,3,3,@,TAM,W 32-31,32,31,1,63,2019,2019_03_NYG_TAM
PHI,2019-09-08,32,Sun,1,1,,WAS,W 32-27,32,27,5,59,2019,2019_01_PHI_WAS
SFO,2018-12-30,32,Sun,16,17,@,LAR,L 32-48,32,48,-16,80,2018,2018_17_SFO_LAR
TAM,2018-12-30,32,Sun,16,17,,ATL,L 32-34,32,34,-2,66,2018,2018_17_TAM_ATL
PHI,2018-12-23,32,Sun,15,16,,HOU,W 32-30,32,30,2,62,2018,2018_16_PHI_HOU
DET,2018-10-21,32,Sun,6,7,@,MIA,W 32-21,32,21,11,53,2018,2018_07_DET_MIA
LAR,2017-12-03,32,Sun,12,13,@,ARI,W 32-16,32,16,16,48,2017,2017_13_LAR_ARI
IND,2023-01-08,31,Sun,17,18,,HOU,L 31-32,31,32,-1,63,2022,2022_18_IND_HOU
DEN,2023-01-08,31,Sun,17,18,,LAC,W 31-28,31,28,3,59,2022,2022_18_DEN_LAC
KAN,2023-01-07,31,Sat,17,18,@,LVR,W 31-13,31,13,18,44,2022,2022_18_KAN_LVR
JAX,2023-01-01,31,Sun,16,17,@,HOU,W 31-3,31,3,28,34,2022,2022_17_JAX_HOU
LAC,2023-01-01,31,Sun,16,17,,LAR,W 31-10,31,10,21,41,2022,2022_17_LAC_LAR
NYJ,2022-11-27,31,Sun,11,12,,CHI,W 31-10,31,10,21,41,2022,2022_12_NYJ_CHI
BUF,2022-11-20,31,Sun,10,11,,CLE,W 31-23,31,23,8,54,2022,2022_11_BUF_CLE
DET,2022-11-20,31,Sun,10,11,@,NYG,W 31-18,31,18,13,49,2022,2022_11_DET_NYG
GNB,2022-11-13,31,Sun,10,10,,DAL,W 31-28 (OT),31,28,3,59,2022,2022_10_GNB_DAL
DET,2022-11-13,31,Sun,9,10,@,CHI,W 31-30,31,30,1,61,2022,2022_10_DET_CHI
SEA,2022-11-06,31,Sun,9,9,@,ARI,W 31-21,31,21,10,52,2022,2022_09_SEA_ARI
MIA,2022-10-30,31,Sun,8,8,@,DET,W 31-27,31,27,4,58,2022,2022_08_MIA_DET
SFO,2022-10-30,31,Sun,8,8,@,LAR,W 31-14,31,14,17,45,2022,2022_08_SFO_LAR
TAM,2022-10-02,31,Sun,4,4,,KAN,L 31-41,31,41,-10,72,2022,2022_04_TAM_KAN
NYJ,2022-09-18,31,Sun,2,2,@,CLE,W 31-30,31,30,1,61,2022,2022_02_NYJ_CLE
LAR,2022-09-18,31,Sun,2,2,,ATL,W 31-27,31,27,4,58,2022,2022_02_LAR_ATL
BUF,2022-09-08,31,Thu,1,1,@,LAR,W 31-10,31,10,21,41,2022,2022_01_BUF_LAR
MIN,2022-01-09,31,Sun,17,18,,CHI,W 31-17,31,17,14,48,2021,2021_18_MIN_CHI
KAN,2022-01-02,31,Sun,16,17,@,CIN,L 31-34,31,34,-3,65,2021,2021_17_KAN_CIN
GNB,2021-12-19,31,Sun,14,15,@,BAL,W 31-30,31,30,1,61,2021,2021_15_GNB_BAL
MIA,2021-12-19,31,Sun,14,15,,NYJ,W 31-24,31,24,7,55,2021,2021_15_MIA_NYJ
SFO,2021-12-19,31,Sun,14,15,,ATL,W 31-13,31,13,18,44,2021,2021_15_SFO_ATL
BUF,2021-12-19,31,Sun,14,15,,CAR,W 31-14,31,14,17,45,2021,2021_15_BUF_CAR
IND,2021-12-05,31,Sun,13,13,@,HOU,W 31-0,31,0,31,31,2021,2021_13_IND_HOU
IND,2021-11-28,31,Sun,12,12,,TAM,L 31-38,31,38,-7,69,2021,2021_12_IND_TAM
BUF,2021-11-25,31,Thu,11,12,@,NOR,W 31-6,31,6,25,37,2021,2021_12_BUF_NOR
GNB,2021-11-21,31,Sun,11,11,@,MIN,L 31-34,31,34,-3,65,2021,2021_11_GNB_MIN
SFO,2021-11-15,31,Mon,9,10,,LAR,W 31-10,31,10,21,41,2021,2021_10_SFO_LAR
MIN,2021-11-07,31,Sun,8,9,@,BAL,L 31-34 (OT),31,34,-3,65,2021,2021_09_MIN_BAL
ARI,2021-11-07,31,Sun,9,9,@,SFO,W 31-17,31,17,14,48,2021,2021_09_ARI_SFO
SEA,2021-10-31,31,Sun,8,8,,JAX,W 31-7,31,7,24,38,2021,2021_08_SEA_JAX
CIN,2021-10-31,31,Sun,8,8,@,NYJ,L 31-34,31,34,-3,65,2021,2021_08_CIN_NYJ
IND,2021-10-31,31,Sun,8,8,,TEN,L 31-34 (OT),31,34,-3,65,2021,2021_08_IND_TEN
ARI,2021-10-24,31,Sun,7,7,,HOU,W 31-5,31,5,26,36,2021,2021_07_ARI_HOU
BUF,2021-10-18,31,Mon,6,6,@,TEN,L 31-34,31,34,-3,65,2021,2021_06_BUF_TEN
IND,2021-10-17,31,Sun,6,6,,HOU,W 31-3,31,3,28,34,2021,2021_06_IND_HOU
KAN,2021-10-17,31,Sun,6,6,@,WAS,W 31-13,31,13,18,44,2021,2021_06_KAN_WAS
BAL,2021-10-11,31,Mon,5,5,,IND,W 31-25 (OT),31,25,6,56,2021,2021_05_BAL_IND
ARI,2021-09-26,31,Sun,3,3,@,JAX,W 31-19,31,19,12,50,2021,2021_03_ARI_JAX
LVR,2021-09-26,31,Sun,3,3,,MIA,W 31-28 (OT),31,28,3,59,2021,2021_03_LVR_MIA
CLE,2021-09-19,31,Sun,2,2,,HOU,W 31-21,31,21,10,52,2021,2021_02_CLE_HOU
TAM,2021-09-09,31,Thu,1,1,,DAL,W 31-29,31,29,2,60,2021,2021_01_TAM_DAL
DEN,2021-01-03,31,Sun,16,17,,LVR,L 31-32,31,32,-1,63,2020,2020_17_DEN_LVR
HOU,2020-12-27,31,Sun,15,16,,CIN,L 31-37,31,37,-6,68,2020,2020_16_HOU_CIN
TAM,2020-12-20,31,Sun,14,15,@,ATL,W 31-27,31,27,4,58,2020,2020_15_TAM_ATL
GNB,2020-12-13,31,Sun,13,14,@,DET,W 31-24,31,24,7,55,2020,2020_14_GNB_DET
TEN,2020-12-13,31,Sun,13,14,@,JAX,W 31-10,31,10,21,41,2020,2020_14_TEN_JAX
LVR,2020-12-06,31,Sun,12,13,@,NYJ,W 31-28,31,28,3,59,2020,2020_13_LVR_NYJ
NOR,2020-11-29,31,Sun,11,12,@,DEN,W 31-3,31,3,28,34,2020,2020_12_NOR_DEN
GNB,2020-11-22,31,Sun,10,11,@,IND,L 31-34 (OT),31,34,-3,65,2020,2020_11_GNB_IND
LVR,2020-11-22,31,Sun,10,11,,KAN,L 31-35,31,35,-4,66,2020,2020_11_LVR_KAN
DAL,2020-11-22,31,Sun,10,11,@,MIN,W 31-28,31,28,3,59,2020,2020_11_DAL_MIN
CAR,2020-11-08,31,Sun,9,9,@,KAN,L 31-33,31,33,-2,64,2020,2020_09_CAR_KAN
ARI,2020-11-08,31,Sun,8,9,,MIA,L 31-34,31,34,-3,65,2020,2020_09_ARI_MIA
LVR,2020-11-08,31,Sun,8,9,@,LAC,W 31-26,31,26,5,57,2020,2020_09_LVR_LAC
CIN,2020-11-01,31,Sun,8,8,,TEN,W 31-20,31,20,11,51,2020,2020_08_CIN_TEN
DEN,2020-11-01,31,Sun,7,8,,LAC,W 31-30,31,30,1,61,2020,2020_08_DEN_LAC
IND,2020-10-18,31,Sun,6,6,,CIN,W 31-27,31,27,4,58,2020,2020_06_IND_CIN
CAR,2020-10-04,31,Sun,4,4,,ARI,W 31-21,31,21,10,52,2020,2020_04_CAR_ARI
MIN,2020-10-04,31,Sun,4,4,@,HOU,W 31-23,31,23,8,54,2020,2020_04_MIN_HOU
SEA,2020-10-04,31,Sun,4,4,@,MIA,W 31-23,31,23,8,54,2020,2020_04_SEA_MIA
LAC,2020-10-04,31,Sun,4,4,@,TAM,L 31-38,31,38,-7,69,2020,2020_04_LAC_TAM
BAL,2020-10-04,31,Sun,4,4,@,WAS,W 31-17,31,17,14,48,2020,2020_04_BAL_WAS
TEN,2020-09-27,31,Sun,3,3,@,MIN,W 31-30,31,30,1,61,2020,2020_03_TEN_MIN
DAL,2020-09-27,31,Sun,3,3,@,SEA,L 31-38,31,38,-7,69,2020,2020_03_DAL_SEA
MIA,2020-09-24,31,Thu,3,3,@,JAX,W 31-13,31,13,18,44,2020,2020_03_MIA_JAX
BUF,2020-09-20,31,Sun,2,2,@,MIA,W 31-28,31,28,3,59,2020,2020_02_BUF_MIA
SFO,2020-09-20,31,Sun,2,2,@,NYJ,W 31-13,31,13,18,44,2020,2020_02_SFO_NYJ
TAM,2020-09-20,31,Sun,2,2,,CAR,W 31-17,31,17,14,48,2020,2020_02_TAM_CAR
KAN,2019-12-29,31,Sun,16,17,,LAC,W 31-21,31,21,10,52,2019,2019_17_KAN_LAC
LAR,2019-12-29,31,Sun,16,17,,ARI,W 31-24,31,24,7,55,2019,2019_17_LAR_ARI
BAL,2019-12-22,31,Sun,15,16,@,CLE,W 31-15,31,15,16,46,2019,2019_16_BAL_CLE
LAR,2019-12-21,31,Sat,15,16,@,SFO,L 31-34,31,34,-3,65,2019,2019_16_LAR_SFO
CHI,2019-12-05,31,Thu,13,14,,DAL,W 31-24,31,24,7,55,2019,2019_14_CHI_DAL
GNB,2019-12-01,31,Sun,12,13,@,NYG,W 31-13,31,13,18,44,2019,2019_13_GNB_NYG
PHI,2019-12-01,31,Sun,12,13,@,MIA,L 31-37,31,37,-6,68,2019,2019_13_PHI_MIA
TEN,2019-12-01,31,Sun,12,13,@,IND,W 31-17,31,17,14,48,2019,2019_13_TEN_IND
CAR,2019-11-24,31,Sun,11,12,@,NOR,L 31-34,31,34,-3,65,2019,2019_12_CAR_NOR
OAK,2019-11-03,31,Sun,8,9,,DET,W 31-24,31,24,7,55,2019,2019_09_OAK_DET
DET,2019-10-27,31,Sun,7,8,,NYG,W 31-26,31,26,5,57,2019,2019_08_DET_NYG
GNB,2019-10-27,31,Sun,8,8,@,KAN,W 31-24,31,24,7,55,2019,2019_08_GNB_KAN
NOR,2019-10-27,31,Sun,8,8,,ARI,W 31-9,31,9,22,40,2019,2019_08_NOR_ARI
PHI,2019-10-27,31,Sun,8,8,@,BUF,W 31-13,31,13,18,44,2019,2019_08_PHI_BUF
BUF,2019-10-20,31,Sun,6,7,,MIA,W 31-21,31,21,10,52,2019,2019_07_BUF_MIA
HOU,2019-10-13,31,Sun,6,6,@,KAN,W 31-24,31,24,7,55,2019,2019_06_HOU_KAN
SFO,2019-10-07,31,Mon,4,5,,CLE,W 31-3,31,3,28,34,2019,2019_05_SFO_CLE
PHI,2019-10-06,31,Sun,5,5,,NYJ,W 31-6,31,6,25,37,2019,2019_05_PHI_NYJ
NOR,2019-10-06,31,Sun,5,5,,TAM,W 31-24,31,24,7,55,2019,2019_05_NOR_TAM
OAK,2019-09-29,31,Sun,4,4,@,IND,W 31-24,31,24,7,55,2019,2019_04_OAK_IND
CHI,2019-09-23,31,Mon,3,3,@,WAS,W 31-15,31,15,16,46,2019,2019_03_CHI_WAS
TAM,2019-09-22,31,Sun,3,3,,NYG,L 31-32,31,32,-1,63,2019,2019_03_TAM_NYG
DAL,2019-09-22,31,Sun,3,3,,MIA,W 31-6,31,6,25,37,2019,2019_03_DAL_MIA
DAL,2019-09-15,31,Sun,2,2,@,WAS,W 31-21,31,21,10,52,2019,2019_02_DAL_WAS
SFO,2019-09-08,31,Sun,1,1,@,TAM,W 31-17,31,17,14,48,2019,2019_01_SFO_TAM
DET,2018-12-30,31,Sun,16,17,@,GNB,W 31-0,31,0,31,31,2018,2018_17_DET_GNB
NOR,2018-12-23,31,Sun,15,16,,PIT,W 31-28,31,28,3,59,2018,2018_16_NOR_PIT
KAN,2018-12-23,31,Sun,15,16,@,SEA,L 31-38,31,38,-7,69,2018,2018_16_KAN_SEA
LAR,2018-12-23,31,Sun,15,16,@,ARI,W 31-9,31,9,22,40,2018,2018_16_LAR_ARI
DAL,2018-11-22,31,Thu,11,12,,WAS,W 31-23,31,23,8,54,2018,2018_12_DAL_WAS
NOR,2018-11-22,31,Thu,11,12,,ATL,W 31-17,31,17,14,48,2018,2018_12_NOR_ATL
GNB,2018-11-11,31,Sun,9,10,,MIA,W 31-12,31,12,19,43,2018,2018_10_GNB_MIA
SEA,2018-11-11,31,Sun,9,10,@,LAR,L 31-36,31,36,-5,67,2018,2018_10_SEA_LAR
NWE,2018-11-04,31,Sun,9,9,,GNB,W 31-17,31,17,14,48,2018,2018_09_NWE_GNB
CHI,2018-10-21,31,Sun,6,7,,NWE,L 31-38,31,38,-7,69,2018,2018_07_CHI_NWE
MIA,2018-10-14,31,Sun,6,6,,CHI,W 31-28 (OT),31,28,3,59,2018,2018_06_MIA_CHI
SEA,2018-10-07,31,Sun,5,5,,LAR,L 31-33,31,33,-2,64,2018,2018_05_SEA_LAR
DET,2018-10-07,31,Sun,5,5,,GNB,W 31-23,31,23,8,54,2018,2018_05_DET_GNB
NYG,2018-10-07,31,Sun,5,5,@,CAR,L 31-33,31,33,-2,64,2018,2018_05_NYG_CAR
JAX,2018-09-30,31,Sun,4,4,,NYJ,W 31-12,31,12,19,43,2018,2018_04_JAX_NYJ
MIN,2018-09-27,31,Thu,4,4,@,LAR,L 31-38,31,38,-7,69,2018,2018_04_MIN_LAR
WAS,2018-09-23,31,Sun,3,3,,GNB,W 31-17,31,17,14,48,2018,2018_03_WAS_GNB
CAR,2018-09-23,31,Sun,3,3,,CIN,W 31-21,31,21,10,52,2018,2018_03_CAR_CIN
JAX,2018-09-16,31,Sun,2,2,,NWE,W 31-20,31,20,11,51,2018,2018_02_JAX_NWE
LAC,2018-09-16,31,Sun,2,2,@,BUF,W 31-20,31,20,11,51,2018,2018_02_LAC_BUF
ATL,2018-09-16,31,Sun,2,2,,CAR,W 31-24,31,24,7,55,2018,2018_02_ATL_CAR
TAM,2017-12-31,31,Sun,16,17,,NOR,W 31-24,31,24,7,55,2017,2017_17_TAM_NOR
CIN,2017-12-31,31,Sun,16,17,@,BAL,W 31-27,31,27,4,58,2017,2017_17_CIN_BAL
CAR,2017-12-17,31,Sun,14,15,,GNB,W 31-24,31,24,7,55,2017,2017_15_CAR_GNB
NOR,2017-12-17,31,Sun,14,15,,NYJ,W 31-19,31,19,12,50,2017,2017_15_NOR_NYJ
CAR,2017-12-10,31,Sun,13,14,,MIN,W 31-24,31,24,7,55,2017,2017_14_CAR_MIN
KAN,2017-12-03,31,Sun,12,13,@,NYJ,L 31-38,31,38,-7,69,2017,2017_13_KAN_NYJ
NOR,2017-12-03,31,Sun,12,13,,CAR,W 31-21,31,21,10,52,2017,2017_13_NOR_CAR
PIT,2017-11-26,31,Sun,11,12,,GNB,W 31-28,31,28,3,59,2017,2017_12_PIT_GNB
PHI,2017-11-26,31,Sun,11,12,,CHI,W 31-3,31,3,28,34,2017,2017_12_PHI_CHI
SEA,2017-11-20,31,Mon,10,11,,ATL,L 31-34,31,34,-3,65,2017,2017_11_SEA_ATL
WAS,2017-11-19,31,Sun,10,11,@,NOR,L 31-34 (OT),31,34,-3,65,2017,2017_11_WAS_NOR
HOU,2017-11-19,31,Sun,10,11,,ARI,W 31-21,31,21,10,52,2017,2017_11_HOU_ARI
SFO,2017-11-12,31,Sun,10,10,,NYG,W 31-21,31,21,10,52,2017,2017_10_SFO_NYG
MIA,2017-10-22,31,Sun,6,7,,NYJ,W 31-28,31,28,3,59,2017,2017_07_MIA_NYJ
OAK,2017-10-19,31,Thu,7,7,,KAN,W 31-30,31,30,1,61,2017,2017_07_OAK_KAN
DAL,2017-10-08,31,Sun,5,5,,GNB,L 31-35,31,35,-4,66,2017,2017_05_DAL_GNB
CIN,2017-10-01,31,Sun,4,4,@,CLE,W 31-7,31,7,24,38,2017,2017_04_CIN_CLE
IND,2017-09-24,31,Sun,3,3,,CLE,W 31-28,31,28,3,59,2017,2017_03_IND_CLE
ATL,2023-01-08,30,Sun,17,18,,TAM,W 30-17,30,17,13,47,2022,2022_18_ATL_TAM
TAM,2023-01-01,30,Sun,16,17,,CAR,W 30-24,30,24,6,54,2022,2022_17_TAM_CAR
KAN,2022-12-18,30,Sun,14,15,@,HOU,W 30-24 (OT),30,24,6,54,2022,2022_15_KAN_HOU
LVR,2022-12-18,30,Sun,14,15,,NWE,W 30-24,30,24,6,54,2022,2022_15_LVR_NWE
CAR,2022-12-11,30,Sun,13,14,@,SEA,W 30-24,30,24,6,54,2022,2022_14_CAR_SEA
MIA,2022-11-27,30,Sun,11,12,,HOU,W 30-15,30,15,15,45,2022,2022_12_MIA_HOU
PIT,2022-11-20,30,Sun,10,11,,CIN,L 30-37,30,37,-7,67,2022,2022_11_PIT_CIN
KAN,2022-11-20,30,Sun,10,11,@,LAC,W 30-27,30,27,3,57,2022,2022_11_KAN_LAC
CHI,2022-11-13,30,Sun,10,10,,DET,L 30-31,30,31,-1,61,2022,2022_10_CHI_DET
BUF,2022-11-13,30,Sun,9,10,,MIN,L 30-33 (OT),30,33,-3,63,2022,2022_10_BUF_MIN
CIN,2022-10-16,30,Sun,6,6,@,NOR,W 30-26,30,26,4,56,2022,2022_06_CIN_NOR
KAN,2022-10-10,30,Mon,5,5,,LVR,W 30-29,30,29,1,59,2022,2022_05_KAN_LVR
LAC,2022-10-09,30,Sun,5,5,@,CLE,W 30-28,30,28,2,58,2022,2022_05_LAC_CLE
CLE,2022-09-18,30,Sun,2,2,,NYJ,L 30-31,30,31,-1,61,2022,2022_02_CLE_NYJ
NOR,2022-01-09,30,Sun,17,18,@,ATL,W 30-20,30,20,10,50,2021,2021_18_NOR_ATL
GNB,2022-01-09,30,Sun,17,18,@,DET,L 30-37,30,37,-7,67,2021,2021_18_GNB_DET
ARI,2022-01-09,30,Sun,17,18,,SEA,L 30-38,30,38,-8,68,2021,2021_18_ARI_SEA
LAR,2021-12-26,30,Sun,15,16,@,MIN,W 30-23,30,23,7,53,2021,2021_16_LAR_MIN
DET,2021-12-19,30,Sun,14,15,,ARI,W 30-12,30,12,18,42,2021,2021_15_DET_ARI
BAL,2021-12-19,30,Sun,14,15,,GNB,L 30-31,30,31,-1,61,2021,2021_15_BAL_GNB
HOU,2021-12-19,30,Sun,14,15,@,JAX,W 30-16,30,16,14,46,2021,2021_15_HOU_JAX
LAR,2021-12-13,30,Mon,13,14,@,ARI,W 30-23,30,23,7,53,2021,2021_14_LAR_ARI
CHI,2021-12-12,30,Sun,13,14,@,GNB,L 30-45,30,45,-15,75,2021,2021_14_CHI_GNB
NOR,2021-12-12,30,Sun,13,14,@,NYJ,W 30-9,30,9,21,39,2021,2021_14_NOR_NYJ
TAM,2021-12-05,30,Sun,12,13,@,ATL,W 30-17,30,17,13,47,2021,2021_13_TAM_ATL
SEA,2021-12-05,30,Sun,12,13,,SFO,W 30-23,30,23,7,53,2021,2021_13_SEA_SFO
TAM,2021-11-22,30,Mon,10,11,,NYG,W 30-10,30,10,20,40,2021,2021_11_TAM_NYG
SFO,2021-11-21,30,Sun,10,11,@,JAX,W 30-10,30,10,20,40,2021,2021_11_SFO_JAX
PHI,2021-11-14,30,Sun,10,10,@,DEN,W 30-13,30,13,17,43,2021,2021_10_PHI_DEN
DEN,2021-11-07,30,Sun,9,9,@,DAL,W 30-16,30,16,14,46,2021,2021_09_DEN_DAL
NYJ,2021-11-04,30,Thu,8,9,@,IND,L 30-45,30,45,-15,75,2021,2021_09_NYJ_IND
ATL,2021-10-24,30,Sun,6,7,@,MIA,W 30-28,30,28,2,58,2021,2021_07_ATL_MIA
IND,2021-10-24,30,Sun,7,7,@,SFO,W 30-18,30,18,12,48,2021,2021_07_IND_SFO
PHI,2021-10-03,30,Sun,4,4,,KAN,L 30-42,30,42,-12,72,2021,2021_04_PHI_KAN
ATL,2021-10-03,30,Sun,4,4,,WAS,L 30-34,30,34,-4,64,2021,2021_04_ATL_WAS
LAC,2021-09-26,30,Sun,3,3,@,KAN,W 30-24,30,24,6,54,2021,2021_03_LAC_KAN
MIN,2021-09-26,30,Sun,3,3,,SEA,W 30-17,30,17,13,47,2021,2021_03_MIN_SEA
GNB,2021-09-26,30,Sun,3,3,@,SFO,W 30-28,30,28,2,58,2021,2021_03_GNB_SFO
SEA,2021-09-19,30,Sun,2,2,,TEN,L 30-33 (OT),30,33,-3,63,2021,2021_02_SEA_TEN
WAS,2021-09-16,30,Thu,2,2,,NYG,W 30-29,30,29,1,59,2021,2021_02_WAS_NYG
LAC,2020-12-17,30,Thu,14,15,@,LVR,W 30-27 (OT),30,27,3,57,2020,2020_15_LAC_LVR
DAL,2020-12-13,30,Sun,13,14,@,CIN,W 30-7,30,7,23,37,2020,2020_14_DAL_CIN
CHI,2020-12-06,30,Sun,12,13,,DET,L 30-34,30,34,-4,64,2020,2020_13_CHI_DET
GNB,2020-12-06,30,Sun,12,13,,PHI,W 30-16,30,16,14,46,2020,2020_13_GNB_PHI
TEN,2020-11-22,30,Sun,10,11,@,BAL,W 30-24 (OT),30,24,6,54,2020,2020_11_TEN_BAL
BUF,2020-11-15,30,Sun,10,10,@,ARI,L 30-32,30,32,-2,62,2020,2020_10_BUF_ARI
DET,2020-11-15,30,Sun,9,10,,WAS,W 30-27,30,27,3,57,2020,2020_10_DET_WAS
NWE,2020-11-09,30,Mon,8,9,@,NYJ,W 30-27,30,27,3,57,2020,2020_09_NWE_NYJ
LAC,2020-11-01,30,Sun,7,8,@,DEN,L 30-31,30,31,-1,61,2020,2020_08_LAC_DEN
BAL,2020-10-18,30,Sun,6,6,@,PHI,W 30-28,30,28,2,58,2020,2020_06_BAL_PHI
NOR,2020-10-12,30,Mon,5,5,,LAC,W 30-27 (OT),30,27,3,57,2020,2020_05_NOR_LAC
HOU,2020-10-11,30,Sun,5,5,,JAX,W 30-14,30,14,16,44,2020,2020_05_HOU_JAX
ARI,2020-10-11,30,Sun,5,5,@,NYJ,W 30-10,30,10,20,40,2020,2020_05_ARI_NYJ
LAR,2020-10-11,30,Sun,5,5,@,WAS,W 30-10,30,10,20,40,2020,2020_05_LAR_WAS
GNB,2020-10-05,30,Mon,4,4,,ATL,W 30-16,30,16,14,46,2020,2020_04_GNB_ATL
BUF,2020-10-04,30,Sun,4,4,@,LVR,W 30-23,30,23,7,53,2020,2020_04_BUF_LVR
NOR,2020-09-27,30,Sun,3,3,,GNB,L 30-37,30,37,-7,67,2020,2020_03_NOR_GNB
MIN,2020-09-27,30,Sun,3,3,,TEN,L 30-31,30,31,-1,61,2020,2020_03_MIN_TEN
CHI,2020-09-27,30,Sun,3,3,@,ATL,W 30-26,30,26,4,56,2020,2020_03_CHI_ATL
JAX,2020-09-20,30,Sun,2,2,@,TEN,L 30-33,30,33,-3,63,2020,2020_02_JAX_TEN
NWE,2020-09-20,30,Sun,2,2,@,SEA,L 30-35,30,35,-5,65,2020,2020_02_NWE_SEA
ARI,2020-09-20,30,Sun,2,2,,WAS,W 30-15,30,15,15,45,2020,2020_02_ARI_WAS
CIN,2020-09-17,30,Thu,2,2,@,CLE,L 30-35,30,35,-5,65,2020,2020_02_CIN_CLE
CAR,2020-09-13,30,Sun,1,1,,LVR,L 30-34,30,34,-4,64,2020,2020_01_CAR_LVR
SEA,2019-12-15,30,Sun,14,15,@,CAR,W 30-24,30,24,6,54,2019,2019_15_SEA_CAR
MIN,2019-12-02,30,Mon,12,13,@,SEA,L 30-37,30,37,-7,67,2019,2019_13_MIN_SEA
TAM,2019-11-10,30,Sun,9,10,,ARI,W 30-27,30,27,3,57,2019,2019_10_TAM_ARI
CAR,2019-11-03,30,Sun,8,9,,TEN,W 30-20,30,20,10,50,2019,2019_09_CAR_TEN
BAL,2019-10-20,30,Sun,7,7,@,SEA,W 30-16,30,16,14,46,2019,2019_07_BAL_SEA
DET,2019-10-20,30,Sun,6,7,,MIN,L 30-42,30,42,-12,72,2019,2019_07_DET_MIN
IND,2019-10-20,30,Sun,6,7,,HOU,W 30-23,30,23,7,53,2019,2019_07_IND_HOU
KAN,2019-10-17,30,Thu,7,7,@,DEN,W 30-6,30,6,24,36,2019,2019_07_KAN_DEN
SEA,2019-10-03,30,Thu,5,5,,LAR,W 30-29,30,29,1,59,2019,2019_05_SEA_LAR
LAC,2019-09-29,30,Sun,4,4,@,MIA,W 30-10,30,10,20,40,2019,2019_04_LAC_MIA
DET,2019-09-29,30,Sun,4,4,,KAN,L 30-34,30,34,-4,64,2019,2019_04_DET_KAN
NWE,2019-09-22,30,Sun,3,3,,NYJ,W 30-14,30,14,16,44,2019,2019_03_NWE_NYJ
NOR,2019-09-09,30,Mon,1,1,,HOU,W 30-28,30,28,2,58,2019,2019_01_NOR_HOU
LAC,2019-09-08,30,Sun,1,1,,IND,W 30-24 (OT),30,24,6,54,2019,2019_01_LAC_IND
LAR,2019-09-08,30,Sun,1,1,@,CAR,W 30-27,30,27,3,57,2019,2019_01_LAR_CAR
HOU,2018-12-23,30,Sun,15,16,@,PHI,L 30-32,30,32,-2,62,2018,2018_16_HOU_PHI
CIN,2018-12-16,30,Sun,14,15,,OAK,W 30-16,30,16,14,46,2018,2018_15_CIN_OAK
PHI,2018-12-16,30,Sun,14,15,@,LAR,W 30-23,30,23,7,53,2018,2018_15_PHI_LAR
TEN,2018-12-06,30,Thu,13,14,,JAX,W 30-9,30,9,21,39,2018,2018_14_TEN_JAX
PIT,2018-12-02,30,Sun,12,13,,LAC,L 30-33,30,33,-3,63,2018,2018_13_PIT_LAC
LAR,2018-12-02,30,Sun,12,13,@,DET,W 30-16,30,16,14,46,2018,2018_13_LAR_DET
NYG,2018-12-02,30,Sun,12,13,,CHI,W 30-27 (OT),30,27,3,57,2018,2018_13_NYG_CHI
SEA,2018-11-25,30,Sun,11,12,@,CAR,W 30-27,30,27,3,57,2018,2018_12_SEA_CAR
NOR,2018-10-28,30,Sun,7,8,@,MIN,W 30-20,30,20,10,50,2018,2018_08_NOR_MIN
KAN,2018-10-28,30,Sun,8,8,,DEN,W 30-23,30,23,7,53,2018,2018_08_KAN_DEN
SFO,2018-10-15,30,Mon,6,6,@,GNB,L 30-33,30,33,-3,63,2018,2018_06_SFO_GNB
KAN,2018-10-07,30,Sun,5,5,,JAX,W 30-14,30,14,16,44,2018,2018_05_KAN_JAX
PIT,2018-09-24,30,Mon,3,3,@,TAM,W 30-27,30,27,3,57,2018,2018_03_PIT_TAM
SFO,2018-09-16,30,Sun,2,2,,DET,W 30-27,30,27,3,57,2018,2018_02_SFO_DET
LAC,2017-12-31,30,Sun,16,17,,OAK,W 30-10,30,10,20,40,2017,2017_17_LAC_OAK
KAN,2017-12-16,30,Sat,14,15,,LAC,W 30-13,30,13,17,43,2017,2017_15_KAN_LAC
DAL,2017-12-10,30,Sun,13,14,@,NYG,W 30-10,30,10,20,40,2017,2017_14_DAL_NYG
JAX,2017-12-10,30,Sun,13,14,,SEA,W 30-24,30,24,6,54,2017,2017_14_JAX_SEA
LAC,2017-12-10,30,Sun,13,14,,WAS,W 30-13,30,13,17,43,2017,2017_14_LAC_WAS
JAX,2017-12-03,30,Sun,12,13,,IND,W 30-10,30,10,20,40,2017,2017_13_JAX_IND
CIN,2017-11-26,30,Sun,11,12,,CLE,W 30-16,30,16,14,46,2017,2017_12_CIN_CLE
MIN,2017-11-23,30,Thu,11,12,@,DET,W 30-23,30,23,7,53,2017,2017_12_MIN_DET
TAM,2017-11-19,30,Sun,10,11,@,MIA,W 30-20,30,20,10,50,2017,2017_11_TAM_MIA
WAS,2017-11-12,30,Sun,9,10,,MIN,L 30-38,30,38,-8,68,2017,2017_10_WAS_MIN
DET,2017-11-06,30,Mon,8,9,@,GNB,W 30-17,30,17,13,47,2017,2017_09_DET_GNB
NOR,2017-11-05,30,Sun,8,9,,TAM,W 30-10,30,10,20,40,2017,2017_09_NOR_TAM
BUF,2017-10-22,30,Sun,6,7,,TAM,W 30-27,30,27,3,57,2017,2017_07_BUF_TAM
KAN,2017-10-19,30,Thu,7,7,@,OAK,L 30-31,30,31,-1,61,2017,2017_07_KAN_OAK
JAX,2017-10-08,30,Sun,5,5,@,PIT,W 30-9,30,9,21,39,2017,2017_05_JAX_PIT
BAL,2017-10-08,30,Sun,5,5,@,OAK,W 30-17,30,17,13,47,2017,2017_05_BAL_OAK
NWE,2017-10-01,30,Sun,4,4,,CAR,L 30-33,30,33,-3,63,2017,2017_04_NWE_CAR
DAL,2017-10-01,30,Sun,4,4,,LAR,L 30-35,30,35,-5,65,2017,2017_04_DAL_LAR
ATL,2017-09-24,30,Sun,3,3,@,DET,W 30-26,30,26,4,56,2017,2017_03_ATL_DET
PHI,2017-09-10,30,Sun,1,1,@,WAS,W 30-17,30,17,13,47,2017,2017_01_PHI_WAS
MIN,2023-01-08,29,Sun,17,18,@,CHI,W 29-13,29,13,16,42,2022,2022_18_MIN_CHI
MIA,2022-12-17,29,Sat,14,15,@,BUF,L 29-32,29,32,-3,61,2022,2022_15_MIA_BUF
PHI,2022-11-03,29,Thu,8,9,@,HOU,W 29-17,29,17,12,46,2022,2022_09_PHI_HOU
CHI,2022-10-30,29,Sun,8,8,@,DAL,L 29-49,29,49,-20,78,2022,2022_08_CHI_DAL
LVR,2022-10-10,29,Mon,5,5,@,KAN,L 29-30,29,30,-1,59,2022,2022_05_LVR_KAN
MIN,2022-10-09,29,Sun,5,5,,CHI,W 29-22,29,22,7,51,2022,2022_05_MIN_CHI
NWE,2022-10-09,29,Sun,5,5,,DET,W 29-0,29,0,29,29,2022,2022_05_NWE_DET
PHI,2022-10-02,29,Sun,4,4,,JAX,W 29-21,29,21,8,50,2022,2022_04_PHI_JAX
CLE,2022-09-22,29,Thu,3,3,,PIT,W 29-17,29,17,12,46,2022,2022_03_CLE_PIT
ARI,2022-09-18,29,Sun,2,2,@,LVR,W 29-23 (OT),29,23,6,52,2022,2022_02_ARI_LVR
BUF,2022-01-02,29,Sun,16,17,,ATL,W 29-15,29,15,14,44,2021,2021_17_BUF_ATL
CHI,2022-01-02,29,Sun,16,17,,NYG,W 29-3,29,3,26,32,2021,2021_17_CHI_NYG
DET,2022-01-02,29,Sun,16,17,@,SEA,L 29-51,29,51,-22,80,2021,2021_17_DET_SEA
LAC,2021-12-26,29,Sun,15,16,@,HOU,L 29-41,29,41,-12,70,2021,2021_16_LAC_HOU
ATL,2021-12-12,29,Sun,13,14,@,CAR,W 29-21,29,21,8,50,2021,2021_14_ATL_CAR
DET,2021-12-05,29,Sun,12,13,,MIN,W 29-27,29,27,2,56,2021,2021_13_DET_MIN
NOR,2021-11-21,29,Sun,10,11,@,PHI,L 29-40,29,40,-11,69,2021,2021_11_NOR_PHI
WAS,2021-11-14,29,Sun,9,10,,TAM,W 29-19,29,19,10,48,2021,2021_10_WAS_TAM
PIT,2021-11-08,29,Mon,8,9,,CHI,W 29-27,29,27,2,56,2021,2021_09_PIT_CHI
NWE,2021-10-17,29,Sun,6,6,,DAL,L 29-35 (OT),29,35,-6,64,2021,2021_06_NWE_DAL
NYG,2021-09-16,29,Thu,2,2,@,WAS,L 29-30,29,30,-1,59,2021,2021_02_NYG_WAS
CLE,2021-09-12,29,Sun,1,1,@,KAN,L 29-33,29,33,-4,62,2021,2021_01_CLE_KAN
DAL,2021-09-09,29,Thu,1,1,@,TAM,L 29-31,29,31,-2,60,2021,2021_01_DAL_TAM
NOR,2020-12-20,29,Sun,14,15,,KAN,L 29-32,29,32,-3,61,2020,2020_15_NOR_KAN
MIA,2020-11-15,29,Sun,9,10,,LAC,W 29-21,29,21,8,50,2020,2020_10_MIA_LAC
JAX,2020-10-25,29,Sun,7,7,@,LAC,L 29-39,29,39,-10,68,2020,2020_07_JAX_LAC
PHI,2020-10-11,29,Sun,5,5,@,PIT,L 29-38,29,38,-9,67,2020,2020_05_PHI_PIT
DET,2020-10-04,29,Sun,4,4,,NOR,L 29-35,29,35,-6,64,2020,2020_04_DET_NOR
ATL,2019-12-15,29,Sun,14,15,@,SFO,W 29-22,29,22,7,51,2019,2019_15_ATL_SFO
WAS,2019-12-01,29,Sun,12,13,@,CAR,W 29-21,29,21,8,50,2019,2019_13_WAS_CAR
ATL,2019-11-17,29,Sun,10,11,@,CAR,W 29-3,29,3,26,32,2019,2019_11_ATL_CAR
JAX,2019-10-27,29,Sun,8,8,,NYJ,W 29-15,29,15,14,44,2019,2019_08_JAX_NYJ
LAR,2019-10-03,29,Thu,5,5,@,SEA,L 29-30,29,30,-1,59,2019,2019_05_LAR_SEA
HOU,2018-12-15,29,Sat,14,15,@,NYJ,W 29-22,29,22,7,51,2018,2018_15_HOU_NYJ
LAC,2018-12-13,29,Thu,14,15,@,KAN,W 29-28,29,28,1,57,2018,2018_15_LAC_KAN
DAL,2018-12-09,29,Sun,13,14,,PHI,W 29-23 (OT),29,23,6,52,2018,2018_14_DAL_PHI
HOU,2018-12-02,29,Sun,12,13,,CLE,W 29-13,29,13,16,42,2018,2018_13_HOU_CLE
IND,2018-11-11,29,Sun,9,10,,JAX,W 29-26,29,26,3,55,2018,2018_10_IND_JAX
LAR,2018-10-28,29,Sun,8,8,,GNB,W 29-27,29,27,2,56,2018,2018_08_LAR_GNB
TAM,2018-10-14,29,Sun,5,6,@,ATL,L 29-34,29,34,-5,63,2018,2018_06_TAM_ATL
LAC,2018-09-30,29,Sun,4,4,,SFO,W 29-27,29,27,2,56,2018,2018_04_LAC_SFO
MIN,2018-09-16,29,Sun,2,2,@,GNB,T 29-29 (OT),29,29,0,58,2018,2018_02_MIN_GNB
GNB,2018-09-16,29,Sun,2,2,,MIN,T 29-29 (OT),29,29,0,58,2018,2018_02_GNB_MIN
KAN,2017-12-24,29,Sun,15,16,,MIA,W 29-13,29,13,16,42,2017,2017_16_KAN_MIA
NYG,2017-12-17,29,Sun,14,15,,PHI,L 29-34,29,34,-5,63,2017,2017_15_NYG_PHI
KAN,2017-10-30,29,Mon,8,8,,DEN,W 29-19,29,19,10,48,2017,2017_08_KAN_DEN
PIT,2017-10-22,29,Sun,7,7,,CIN,W 29-14,29,14,15,43,2017,2017_07_PIT_CIN
KAN,2017-10-02,29,Mon,4,4,,WAS,W 29-20,29,20,9,49,2017,2017_04_KAN_WAS
TAM,2017-09-17,29,Sun,1,2,,CHI,W 29-7,29,7,22,36,2017,2017_02_TAM_CHI
MIN,2017-09-11,29,Mon,1,1,,NOR,W 29-19,29,19,10,48,2017,2017_01_MIN_NOR
JAX,2017-09-10,29,Sun,1,1,@,HOU,W 29-7,29,7,22,36,2017,2017_01_JAX_HOU
PIT,2023-01-08,28,Sun,17,18,,CLE,W 28-14,28,14,14,42,2022,2022_18_PIT_CLE
LAC,2023-01-08,28,Sun,17,18,@,DEN,L 28-31,28,31,-3,59,2022,2022_18_LAC_DEN
DEN,2022-12-11,28,Sun,13,14,,KAN,L 28-34,28,34,-6,62,2022,2022_14_DEN_KAN
GNB,2022-12-04,28,Sun,13,13,@,CHI,W 28-19,28,19,9,47,2022,2022_13_GNB_CHI
JAX,2022-11-27,28,Sun,11,12,,BAL,W 28-27,28,27,1,55,2022,2022_12_JAX_BAL
BUF,2022-11-24,28,Thu,11,12,@,DET,W 28-25,28,25,3,53,2022,2022_12_BUF_DET
DAL,2022-11-24,28,Thu,11,12,,NYG,W 28-20,28,20,8,48,2022,2022_12_DAL_NYG
DAL,2022-11-13,28,Sun,9,10,@,GNB,L 28-31 (OT),28,31,-3,59,2022,2022_10_DAL_GNB
ATL,2022-10-16,28,Sun,6,6,,SFO,W 28-14,28,14,14,42,2022,2022_06_ATL_SFO
CLE,2022-10-09,28,Sun,5,5,,LAC,L 28-30,28,30,-2,58,2022,2022_05_CLE_LAC
MIN,2022-10-02,28,Sun,4,4,@,NOR,W 28-25,28,25,3,53,2022,2022_04_MIN_NOR
MIN,2022-09-25,28,Sun,3,3,,DET,W 28-24,28,24,4,52,2022,2022_03_MIN_DET
WAS,2022-09-11,28,Sun,1,1,,JAX,W 28-22,28,22,6,50,2022,2022_01_WAS_JAX
TEN,2022-01-09,28,Sun,17,18,@,HOU,W 28-25,28,25,3,53,2021,2021_18_TEN_HOU
KAN,2022-01-08,28,Sat,17,18,@,DEN,W 28-24,28,24,4,52,2021,2021_18_KAN_DEN
TAM,2022-01-02,28,Sun,16,17,@,NYJ,W 28-24,28,24,4,52,2021,2021_17_TAM_NYJ
LAC,2021-12-16,28,Thu,14,15,,KAN,L 28-34 (OT),28,34,-6,62,2021,2021_15_LAC_KAN
PIT,2021-12-09,28,Thu,13,14,@,MIN,L 28-36,28,36,-8,64,2021,2021_14_PIT_MIN
LAR,2021-11-28,28,Sun,11,12,@,GNB,L 28-36,28,36,-8,64,2021,2021_12_LAR_GNB
DEN,2021-11-28,28,Sun,11,12,,LAC,W 28-13,28,13,15,41,2021,2021_12_DEN_LAC
TEN,2021-11-07,28,Sun,9,9,@,LAR,W 28-16,28,16,12,44,2021,2021_09_TEN_LAR
MIA,2021-10-24,28,Sun,7,7,,ATL,L 28-30,28,30,-2,58,2021,2021_07_MIA_ATL
LAR,2021-10-24,28,Sun,7,7,,DET,W 28-19,28,19,9,47,2021,2021_07_LAR_DET
CAR,2021-10-17,28,Sun,6,6,,MIN,L 28-34 (OT),28,34,-6,62,2021,2021_06_CAR_MIN
TAM,2021-10-14,28,Thu,6,6,@,PHI,W 28-22,28,22,6,50,2021,2021_06_TAM_PHI
LAC,2021-10-04,28,Mon,4,4,,LVR,W 28-14,28,14,14,42,2021,2021_04_LAC_LVR
CAR,2021-10-03,28,Sun,4,4,@,DAL,L 28-36,28,36,-8,64,2021,2021_04_CAR_DAL
SEA,2021-10-03,28,Sun,4,4,@,SFO,W 28-21,28,21,7,49,2021,2021_04_SEA_SFO
SFO,2021-09-26,28,Sun,3,3,,GNB,L 28-30,28,30,-2,58,2021,2021_03_SFO_GNB
NOR,2021-09-26,28,Sun,3,3,@,NWE,W 28-13,28,13,15,41,2021,2021_03_NOR_NWE
MIA,2021-09-26,28,Sun,3,3,@,LVR,L 28-31 (OT),28,31,-3,59,2021,2021_03_MIA_LVR
SEA,2021-09-12,28,Sun,1,1,@,IND,W 28-16,28,16,12,44,2021,2021_01_SEA_IND
IND,2021-01-03,28,Sun,16,17,,JAX,W 28-14,28,14,14,42,2020,2020_17_IND_JAX
NWE,2021-01-03,28,Sun,16,17,,NYJ,W 28-14,28,14,14,42,2020,2020_17_NWE_NYJ
PIT,2020-12-27,28,Sun,15,16,,IND,W 28-24,28,24,4,52,2020,2020_16_PIT_IND
NYJ,2020-12-06,28,Sun,12,13,,LVR,L 28-31,28,31,-3,59,2020,2020_13_NYJ_LVR
ARI,2020-12-06,28,Sun,12,13,,LAR,L 28-38,28,38,-10,66,2020,2020_13_ARI_LAR
MIN,2020-11-29,28,Sun,11,12,,CAR,W 28-27,28,27,1,55,2020,2020_12_MIN_CAR
MIN,2020-11-22,28,Sun,10,11,,DAL,L 28-31,28,31,-3,59,2020,2020_11_MIN_DAL
NYJ,2020-11-22,28,Sun,10,11,@,LAC,L 28-34,28,34,-6,62,2020,2020_11_NYJ_LAC
SEA,2020-11-19,28,Thu,10,11,,ARI,W 28-21,28,21,7,49,2020,2020_11_SEA_ARI
MIN,2020-11-01,28,Sun,7,8,@,GNB,W 28-22,28,22,6,50,2020,2020_08_MIN_GNB
MIA,2020-11-01,28,Sun,7,8,,LAR,W 28-17,28,17,11,45,2020,2020_08_MIA_LAR
PIT,2020-11-01,28,Sun,7,8,@,BAL,W 28-24,28,24,4,52,2020,2020_08_PIT_BAL
PHI,2020-10-18,28,Sun,6,6,,BAL,L 28-30,28,30,-2,58,2020,2020_06_PHI_BAL
NYJ,2020-10-01,28,Thu,4,4,,DEN,L 28-37,28,37,-9,65,2020,2020_04_NYJ_DEN
TAM,2020-09-27,28,Sun,3,3,@,DEN,W 28-10,28,10,18,38,2020,2020_03_TAM_DEN
PIT,2020-09-27,28,Sun,3,3,,HOU,W 28-21,28,21,7,49,2020,2020_03_PIT_HOU
IND,2020-09-20,28,Sun,2,2,,MIN,W 28-11,28,11,17,39,2020,2020_02_IND_MIN
MIA,2020-09-20,28,Sun,2,2,,BUF,L 28-31,28,31,-3,59,2020,2020_02_MIA_BUF
BAL,2019-12-29,28,Sun,16,17,,PIT,W 28-10,28,10,18,38,2019,2019_17_BAL_PIT
ATL,2019-12-29,28,Sun,16,17,@,TAM,W 28-22 (OT),28,22,6,50,2019,2019_17_ATL_TAM
TEN,2019-12-22,28,Sun,15,16,,NOR,L 28-38,28,38,-10,66,2019,2019_16_TEN_NOR
LAR,2019-12-08,28,Sun,13,14,,SEA,W 28-12,28,12,16,40,2019,2019_14_LAR_SEA
TAM,2019-12-01,28,Sun,12,13,@,JAX,W 28-11,28,11,17,39,2019,2019_13_TAM_JAX
HOU,2019-12-01,28,Sun,12,13,,NWE,W 28-22,28,22,6,50,2019,2019_13_HOU_NWE
MIN,2019-11-10,28,Sun,10,10,@,DAL,W 28-24,28,24,4,52,2019,2019_10_MIN_DAL
SFO,2019-10-31,28,Thu,8,9,@,ARI,W 28-25,28,25,3,53,2019,2019_09_SFO_ARI
CLE,2019-10-13,28,Sun,6,6,,SEA,L 28-32,28,32,-4,60,2019,2019_06_CLE_SEA
MIN,2019-10-06,28,Sun,5,5,@,NYG,W 28-10,28,10,18,38,2019,2019_05_MIN_NYG
BAL,2019-09-22,28,Sun,3,3,@,KAN,L 28-33,28,33,-5,61,2019,2019_03_BAL_KAN
BUF,2019-09-15,28,Sun,2,2,@,NYG,W 28-14,28,14,14,42,2019,2019_02_BUF_NYG
SEA,2019-09-15,28,Sun,2,2,@,PIT,W 28-26,28,26,2,54,2019,2019_02_SEA_PIT
KAN,2019-09-15,28,Sun,2,2,@,OAK,W 28-10,28,10,18,38,2019,2019_02_KAN_OAK
HOU,2019-09-09,28,Mon,1,1,@,NOR,L 28-30,28,30,-2,58,2019,2019_01_HOU_NOR
MIN,2019-09-08,28,Sun,1,1,,ATL,W 28-12,28,12,16,40,2019,2019_01_MIN_ATL
PIT,2018-12-23,28,Sun,15,16,@,NOR,L 28-31,28,31,-3,59,2018,2018_16_PIT_NOR
IND,2018-12-23,28,Sun,15,16,,NYG,W 28-27,28,27,1,55,2018,2018_16_IND_NYG
KAN,2018-12-13,28,Thu,14,15,,LAC,L 28-29,28,29,-1,57,2018,2018_15_KAN_LAC
NOR,2018-12-09,28,Sun,13,14,@,TAM,W 28-14,28,14,14,42,2018,2018_14_NOR_TAM
PHI,2018-12-03,28,Mon,12,13,,WAS,W 28-13,28,13,15,41,2018,2018_13_PHI_WAS
CLE,2018-11-11,28,Sun,10,10,,ATL,W 28-16,28,16,12,44,2018,2018_10_CLE_ATL
TEN,2018-11-05,28,Mon,8,9,@,DAL,W 28-14,28,14,14,42,2018,2018_09_TEN_DAL
TAM,2018-11-04,28,Sun,8,9,@,CAR,L 28-42,28,42,-14,70,2018,2018_09_TAM_CAR
OAK,2018-10-28,28,Sun,7,8,,IND,L 28-42,28,42,-14,70,2018,2018_08_OAK_IND
SEA,2018-10-28,28,Sun,7,8,@,DET,W 28-14,28,14,14,42,2018,2018_08_SEA_DET
PIT,2018-10-14,28,Sun,6,6,@,CIN,W 28-21,28,21,7,49,2018,2018_06_PIT_CIN
CHI,2018-10-14,28,Sun,5,6,@,MIA,L 28-31 (OT),28,31,-3,59,2018,2018_06_CHI_MIA
ARI,2018-10-07,28,Sun,5,5,@,SFO,W 28-18,28,18,10,46,2018,2018_05_ARI_SFO
MIA,2018-09-23,28,Sun,3,3,,OAK,W 28-20,28,20,8,48,2018,2018_03_MIA_OAK
LAC,2018-09-09,28,Sun,1,1,,KAN,L 28-38,28,38,-10,66,2018,2018_01_LAC_KAN
PIT,2017-12-31,28,Sun,16,17,,CLE,W 28-24,28,24,4,52,2017,2017_17_PIT_CLE
GNB,2017-11-26,28,Sun,11,12,@,PIT,L 28-31,28,31,-3,59,2017,2017_12_GNB_PIT
LAC,2017-11-23,28,Thu,11,12,@,DAL,W 28-6,28,6,22,34,2017,2017_12_LAC_DAL
DAL,2017-11-05,28,Sun,8,9,,KAN,W 28-17,28,17,11,45,2017,2017_09_DAL_KAN
NYJ,2017-10-22,28,Sun,7,7,@,MIA,L 28-31,28,31,-3,59,2017,2017_07_NYJ_MIA
PHI,2017-10-12,28,Thu,6,6,@,CAR,W 28-23,28,23,5,51,2017,2017_06_PHI_CAR
DAL,2017-09-25,28,Mon,3,3,@,ARI,W 28-17,28,17,11,45,2017,2017_03_DAL_ARI
CLE,2017-09-24,28,Sun,3,3,@,IND,L 28-31,28,31,-3,59,2017,2017_03_CLE_IND
CIN,2023-01-08,27,Sun,16,18,,BAL,W 27-16,27,16,11,43,2022,2022_18_CIN_BAL
KAN,2023-01-01,27,Sun,16,17,,DEN,W 27-24,27,24,3,51,2022,2022_17_KAN_DEN
DAL,2022-12-29,27,Thu,16,17,@,TEN,W 27-13,27,13,14,40,2022,2022_17_DAL_TEN
MIN,2022-12-24,27,Sat,15,16,,NYG,W 27-24,27,24,3,51,2022,2022_16_MIN_NYG
NWE,2022-12-12,27,Mon,13,14,@,ARI,W 27-13,27,13,14,40,2022,2022_14_NWE_ARI
DAL,2022-12-11,27,Sun,13,14,,HOU,W 27-23,27,23,4,50,2022,2022_14_DAL_HOU
CLE,2022-12-04,27,Sun,12,13,@,HOU,W 27-14,27,14,13,41,2022,2022_13_CLE_HOU
CIN,2022-12-04,27,Sun,12,13,,KAN,W 27-24,27,24,3,51,2022,2022_13_CIN_KAN
MIN,2022-12-04,27,Sun,12,13,,NYJ,W 27-22,27,22,5,49,2022,2022_13_MIN_NYJ
SEA,2022-12-04,27,Sun,12,13,@,LAR,W 27-23,27,23,4,50,2022,2022_13_SEA_LAR
LVR,2022-12-04,27,Sun,12,13,,LAC,W 27-20,27,20,7,47,2022,2022_13_LVR_LAC
BAL,2022-11-27,27,Sun,11,12,@,JAX,L 27-28,27,28,-1,55,2022,2022_12_BAL_JAX
ATL,2022-11-20,27,Sun,11,11,,CHI,W 27-24,27,24,3,51,2022,2022_11_ATL_CHI
LAC,2022-11-20,27,Sun,10,11,,KAN,L 27-30,27,30,-3,57,2022,2022_11_LAC_KAN
NOR,2022-11-20,27,Sun,11,11,,LAR,W 27-20,27,20,7,47,2022,2022_11_NOR_LAR
TEN,2022-11-17,27,Thu,10,11,@,GNB,W 27-17,27,17,10,44,2022,2022_11_TEN_GNB
KAN,2022-11-13,27,Sun,9,10,,JAX,W 27-17,27,17,10,44,2022,2022_10_KAN_JAX
ARI,2022-11-13,27,Sun,10,10,@,LAR,W 27-17,27,17,10,44,2022,2022_10_ARI_LAR
BAL,2022-11-07,27,Mon,9,9,@,NOR,W 27-13,27,13,14,40,2022,2022_09_BAL_NOR
JAX,2022-11-06,27,Sun,9,9,,LVR,W 27-20,27,20,7,47,2022,2022_09_JAX_LVR
BUF,2022-10-30,27,Sun,7,8,,GNB,W 27-17,27,17,10,44,2022,2022_08_BUF_GNB
DET,2022-10-30,27,Sun,7,8,,MIA,L 27-31,27,31,-4,58,2022,2022_08_DET_MIA
SEA,2022-10-30,27,Sun,8,8,,NYG,W 27-13,27,13,14,40,2022,2022_08_SEA_NYG
BAL,2022-10-27,27,Thu,8,8,@,TAM,W 27-22,27,22,5,49,2022,2022_08_BAL_TAM
JAX,2022-10-16,27,Sun,6,6,@,IND,L 27-34,27,34,-7,61,2022,2022_06_JAX_IND
NYJ,2022-10-16,27,Sun,6,6,@,GNB,W 27-10,27,10,17,37,2022,2022_06_NYJ_GNB
NYG,2022-10-09,27,Sun,5,5,@,GNB,W 27-22,27,22,5,49,2022,2022_05_NYG_GNB
GNB,2022-10-02,27,Sun,4,4,,NWE,W 27-24 (OT),27,24,3,51,2022,2022_04_GNB_NWE
CIN,2022-09-29,27,Thu,4,4,,MIA,W 27-15,27,15,12,42,2022,2022_04_CIN_MIA
CIN,2022-09-25,27,Sun,3,3,@,NYJ,W 27-12,27,12,15,39,2022,2022_03_CIN_NYJ
ATL,2022-09-25,27,Sun,3,3,@,SEA,W 27-23,27,23,4,50,2022,2022_03_ATL_SEA
GNB,2022-09-18,27,Sun,2,2,,CHI,W 27-10,27,10,17,37,2022,2022_02_GNB_CHI
WAS,2022-09-18,27,Sun,2,2,@,DET,L 27-36,27,36,-9,63,2022,2022_02_WAS_DET
ATL,2022-09-18,27,Sun,2,2,@,LAR,L 27-31,27,31,-4,58,2022,2022_02_ATL_LAR
SFO,2022-09-18,27,Sun,2,2,,SEA,W 27-7,27,7,20,34,2022,2022_02_SFO_SEA
KAN,2022-09-15,27,Thu,2,2,,LAC,W 27-24,27,24,3,51,2022,2022_02_KAN_LAC
NOR,2022-09-11,27,Sun,1,1,@,ATL,W 27-26,27,26,1,53,2022,2022_01_NOR_ATL
BUF,2022-01-09,27,Sun,17,18,,NYJ,W 27-10,27,10,17,37,2021,2021_18_BUF_NYJ
SFO,2022-01-09,27,Sun,17,18,@,LAR,W 27-24 (OT),27,24,3,51,2021,2021_18_SFO_LAR
PHI,2021-12-21,27,Tue,14,15,,WAS,W 27-17,27,17,10,44,2021,2021_15_PHI_WAS
IND,2021-12-18,27,Sat,14,15,,NWE,W 27-17,27,17,10,44,2021,2021_15_IND_NWE
BUF,2021-12-12,27,Sun,13,14,@,TAM,L 27-33 (OT),27,33,-6,60,2021,2021_14_BUF_TAM
DAL,2021-12-12,27,Sun,13,14,@,WAS,W 27-20,27,20,7,47,2021,2021_14_DAL_WAS
MIN,2021-12-05,27,Sun,12,13,@,DET,L 27-29,27,29,-2,56,2021,2021_13_MIN_DET
DAL,2021-12-02,27,Thu,12,13,@,NOR,W 27-17,27,17,10,44,2021,2021_13_DAL_NOR
WAS,2021-11-21,27,Sun,10,11,@,CAR,W 27-21,27,21,6,48,2021,2021_11_WAS_CAR
MIN,2021-11-14,27,Sun,9,10,@,LAC,W 27-20,27,20,7,47,2021,2021_10_MIN_LAC
CHI,2021-11-08,27,Mon,9,9,@,PIT,L 27-29,27,29,-2,56,2021,2021_09_CHI_PIT
ATL,2021-11-07,27,Sun,8,9,@,NOR,W 27-25,27,25,2,52,2021,2021_09_ATL_NOR
LAC,2021-11-07,27,Sun,8,9,@,PHI,W 27-24,27,24,3,51,2021,2021_09_LAC_PHI
TAM,2021-10-31,27,Sun,8,8,@,NOR,L 27-36,27,36,-9,63,2021,2021_08_TAM_NOR
NWE,2021-10-31,27,Sun,8,8,@,LAC,W 27-24,27,24,3,51,2021,2021_08_NWE_LAC
TEN,2021-10-24,27,Sun,7,7,,KAN,W 27-3,27,3,24,30,2021,2021_07_TEN_KAN
PIT,2021-10-10,27,Sun,5,5,,DEN,W 27-19,27,19,8,46,2021,2021_05_PIT_DEN
ATL,2021-10-10,27,Sun,5,5,,NYJ,W 27-20,27,20,7,47,2021,2021_05_ATL_NYJ
IND,2021-10-03,27,Sun,4,4,@,MIA,W 27-17,27,17,10,44,2021,2021_04_IND_MIA
NYG,2021-10-03,27,Sun,4,4,@,NOR,W 27-21 (OT),27,21,6,48,2021,2021_04_NYG_NOR
NYJ,2021-10-03,27,Sun,4,4,,TEN,W 27-24 (OT),27,24,3,51,2021,2021_04_NYJ_TEN
GNB,2021-10-03,27,Sun,4,4,,PIT,W 27-17,27,17,10,44,2021,2021_04_GNB_PIT
LAR,2021-09-19,27,Sun,2,2,@,IND,W 27-24,27,24,3,51,2021,2021_02_LAR_IND
BAL,2021-09-13,27,Mon,1,1,@,LVR,L 27-33 (OT),27,33,-6,60,2021,2021_01_BAL_LVR
CIN,2021-09-12,27,Sun,1,1,,MIN,W 27-24 (OT),27,24,3,51,2021,2021_01_CIN_MIN
DEN,2021-09-12,27,Sun,1,1,@,NYG,W 27-13,27,13,14,40,2021,2021_01_DEN_NYG
ATL,2021-01-03,27,Sun,16,17,@,TAM,L 27-44,27,44,-17,71,2020,2020_17_ATL_TAM
BAL,2020-12-27,27,Sun,15,16,,NYG,W 27-13,27,13,14,40,2020,2020_16_BAL_NYG
CIN,2020-12-21,27,Mon,14,15,,PIT,W 27-17,27,17,10,44,2020,2020_15_CIN_PIT
IND,2020-12-20,27,Sun,14,15,,HOU,W 27-20,27,20,7,47,2020,2020_15_IND_HOU
ATL,2020-12-20,27,Sun,14,15,,TAM,L 27-31,27,31,-4,58,2020,2020_15_ATL_TAM
MIN,2020-12-20,27,Sun,14,15,,CHI,L 27-33,27,33,-6,60,2020,2020_15_MIN_CHI
LVR,2020-12-17,27,Thu,14,15,,LAC,L 27-30 (OT),27,30,-3,57,2020,2020_15_LVR_LAC
LVR,2020-12-13,27,Sun,13,14,,IND,L 27-44,27,44,-17,71,2020,2020_14_LVR_IND
CAR,2020-12-13,27,Sun,13,14,,DEN,L 27-32,27,32,-5,59,2020,2020_14_CAR_DEN
MIA,2020-12-13,27,Sun,13,14,,KAN,L 27-33,27,33,-6,60,2020,2020_14_MIA_KAN
MIN,2020-12-06,27,Sun,12,13,,JAX,W 27-24 (OT),27,24,3,51,2020,2020_13_MIN_JAX
CLE,2020-11-29,27,Sun,11,12,@,JAX,W 27-25,27,25,2,52,2020,2020_12_CLE_JAX
CAR,2020-11-29,27,Sun,12,12,@,MIN,L 27-28,27,28,-1,55,2020,2020_12_CAR_MIN
BUF,2020-11-29,27,Sun,11,12,,LAC,W 27-17,27,17,10,44,2020,2020_12_BUF_LAC
KAN,2020-11-29,27,Sun,11,12,@,TAM,W 27-24,27,24,3,51,2020,2020_12_KAN_TAM
LAR,2020-11-23,27,Mon,10,11,@,TAM,W 27-24,27,24,3,51,2020,2020_11_LAR_TAM
PIT,2020-11-22,27,Sun,10,11,@,JAX,W 27-3,27,3,24,30,2020,2020_11_PIT_JAX
HOU,2020-11-22,27,Sun,10,11,,NWE,W 27-20,27,20,7,47,2020,2020_11_HOU_NWE
WAS,2020-11-15,27,Sun,9,10,@,DET,L 27-30,27,30,-3,57,2020,2020_10_WAS_DET
NYG,2020-11-15,27,Sun,10,10,,PHI,W 27-17,27,17,10,44,2020,2020_10_NYG_PHI
NOR,2020-11-15,27,Sun,9,10,,SFO,W 27-13,27,13,14,40,2020,2020_10_NOR_SFO
NYJ,2020-11-09,27,Mon,9,9,,NWE,L 27-30,27,30,-3,57,2020,2020_09_NYJ_NWE
HOU,2020-11-08,27,Sun,8,9,@,JAX,W 27-25,27,25,2,52,2020,2020_09_HOU_JAX
DEN,2020-11-08,27,Sun,8,9,@,ATL,L 27-34,27,34,-7,61,2020,2020_09_DEN_ATL
SFO,2020-11-01,27,Sun,8,8,@,SEA,L 27-37,27,37,-10,64,2020,2020_08_SFO_SEA
PIT,2020-10-25,27,Sun,6,7,@,TEN,W 27-24,27,24,3,51,2020,2020_07_PIT_TEN
NOR,2020-10-25,27,Sun,6,7,,CAR,W 27-24,27,24,3,51,2020,2020_07_NOR_CAR
CIN,2020-10-18,27,Sun,6,6,@,IND,L 27-31,27,31,-4,58,2020,2020_06_CIN_IND
LAC,2020-10-12,27,Mon,5,5,@,NOR,L 27-30 (OT),27,30,-3,57,2020,2020_05_LAC_NOR
SEA,2020-10-11,27,Sun,5,5,,MIN,W 27-26,27,26,1,53,2020,2020_05_SEA_MIN
BAL,2020-10-11,27,Sun,5,5,,CIN,W 27-3,27,3,24,30,2020,2020_05_BAL_CIN
JAX,2020-09-13,27,Sun,1,1,,IND,W 27-20,27,20,7,47,2020,2020_01_JAX_IND
CHI,2020-09-13,27,Sun,1,1,@,DET,W 27-23,27,23,4,50,2020,2020_01_CHI_DET
BUF,2020-09-13,27,Sun,1,1,,NYJ,W 27-17,27,17,10,44,2020,2020_01_BUF_NYJ
WAS,2020-09-13,27,Sun,1,1,,PHI,W 27-17,27,17,10,44,2020,2020_01_WAS_PHI
MIA,2019-12-29,27,Sun,16,17,@,NWE,W 27-24,27,24,3,51,2019,2019_17_MIA_NWE
DEN,2019-12-22,27,Sun,15,16,,DET,W 27-17,27,17,10,44,2019,2019_16_DEN_DET
ARI,2019-12-22,27,Sun,15,16,@,SEA,W 27-13,27,13,14,40,2019,2019_16_ARI_SEA
WAS,2019-12-15,27,Sun,14,15,,PHI,L 27-37,27,37,-10,64,2019,2019_15_WAS_PHI
CLE,2019-12-08,27,Sun,13,14,,CIN,W 27-19,27,19,8,46,2019,2019_14_CLE_CIN
DET,2019-11-17,27,Sun,10,11,,DAL,L 27-35,27,35,-8,62,2019,2019_11_DET_DAL
MIN,2019-11-17,27,Sun,11,11,,DEN,W 27-23,27,23,4,50,2019,2019_11_MIN_DEN
SEA,2019-11-11,27,Mon,10,10,@,SFO,W 27-24 (OT),27,24,3,51,2019,2019_10_SEA_SFO
NYG,2019-11-10,27,Sun,10,10,@,NYJ,L 27-34,27,34,-7,61,2019,2019_10_NYG_NYJ
ARI,2019-11-10,27,Sun,10,10,@,TAM,L 27-30,27,30,-3,57,2019,2019_10_ARI_TAM
PIT,2019-10-28,27,Mon,7,8,,MIA,W 27-14,27,14,13,41,2019,2019_08_PIT_MIA
SEA,2019-10-27,27,Sun,8,8,@,ATL,W 27-20,27,20,7,47,2019,2019_08_SEA_ATL
NWE,2019-10-27,27,Sun,8,8,,CLE,W 27-13,27,13,14,40,2019,2019_08_NWE_CLE
HOU,2019-10-27,27,Sun,8,8,,OAK,W 27-24,27,24,3,51,2019,2019_08_HOU_OAK
TEN,2019-10-27,27,Sun,8,8,,TAM,W 27-23,27,23,4,50,2019,2019_08_TEN_TAM
JAX,2019-10-20,27,Sun,7,7,@,CIN,W 27-17,27,17,10,44,2019,2019_07_JAX_CIN
ARI,2019-10-20,27,Sun,7,7,@,NYG,W 27-21,27,21,6,48,2019,2019_07_ARI_NYG
JAX,2019-10-06,27,Sun,5,5,@,CAR,L 27-34,27,34,-7,61,2019,2019_05_JAX_CAR
PIT,2019-09-30,27,Mon,4,4,,CIN,W 27-3,27,3,24,30,2019,2019_04_PIT_CIN
SEA,2019-09-29,27,Sun,4,4,@,ARI,W 27-10,27,10,17,37,2019,2019_04_SEA_ARI
GNB,2019-09-26,27,Thu,4,4,,PHI,L 27-34,27,34,-7,61,2019,2019_04_GNB_PHI
IND,2019-09-22,27,Sun,3,3,,ATL,W 27-24,27,24,3,51,2019,2019_03_IND_ATL
GNB,2019-09-22,27,Sun,3,3,,DEN,W 27-16,27,16,11,43,2019,2019_03_GNB_DEN
SEA,2019-09-22,27,Sun,3,3,,NOR,L 27-33,27,33,-6,60,2019,2019_03_SEA_NOR
DET,2019-09-22,27,Sun,3,3,@,PHI,W 27-24,27,24,3,51,2019,2019_03_DET_PHI
HOU,2019-09-22,27,Sun,3,3,@,LAC,W 27-20,27,20,7,47,2019,2019_03_HOU_LAC
LAR,2019-09-15,27,Sun,2,2,,NOR,W 27-9,27,9,18,36,2019,2019_02_LAR_NOR
DET,2019-09-08,27,Sun,1,1,@,ARI,T 27-27 (OT),27,27,0,54,2019,2019_01_DET_ARI
ARI,2019-09-08,27,Sun,1,1,,DET,T 27-27 (OT),27,27,0,54,2019,2019_01_ARI_DET
WAS,2019-09-08,27,Sun,1,1,@,PHI,L 27-32,27,32,-5,59,2019,2019_01_WAS_PHI
CAR,2019-09-08,27,Sun,1,1,,LAR,L 27-30,27,30,-3,57,2019,2019_01_CAR_LAR
SEA,2018-12-30,27,Sun,16,17,,ARI,W 27-24,27,24,3,51,2018,2018_17_SEA_ARI
OAK,2018-12-24,27,Mon,15,16,,DEN,W 27-14,27,14,13,41,2018,2018_16_OAK_DEN
NYG,2018-12-23,27,Sun,15,16,@,IND,L 27-28,27,28,-1,55,2018,2018_16_NYG_IND
MIN,2018-12-23,27,Sun,15,16,@,DET,W 27-9,27,9,18,36,2018,2018_16_MIN_DET
DAL,2018-12-23,27,Sun,15,16,,TAM,W 27-20,27,20,7,47,2018,2018_16_DAL_TAM
NYJ,2018-12-09,27,Sun,13,14,@,BUF,W 27-23,27,23,4,50,2018,2018_14_NYJ_BUF
KAN,2018-12-09,27,Sun,13,14,,BAL,W 27-24 (OT),27,24,3,51,2018,2018_14_KAN_BAL
CHI,2018-12-02,27,Sun,12,13,@,NYG,L 27-30 (OT),27,30,-3,57,2018,2018_13_CHI_NYG
IND,2018-11-25,27,Sun,11,12,,MIA,W 27-24,27,24,3,51,2018,2018_12_IND_MIA
NWE,2018-11-25,27,Sun,11,12,@,NYJ,W 27-13,27,13,14,40,2018,2018_12_NWE_NYJ
CAR,2018-11-25,27,Sun,11,12,,SEA,L 27-30,27,30,-3,57,2018,2018_12_CAR_SEA
TAM,2018-11-25,27,Sun,11,12,,SFO,W 27-9,27,9,18,36,2018,2018_12_TAM_SFO
SEA,2018-11-15,27,Thu,10,11,,GNB,W 27-24,27,24,3,51,2018,2018_11_SEA_GNB
NYG,2018-11-12,27,Mon,9,10,@,SFO,W 27-23,27,23,4,50,2018,2018_10_NYG_SFO
DAL,2018-11-11,27,Sun,9,10,@,PHI,W 27-20,27,20,7,47,2018,2018_10_DAL_PHI
GNB,2018-10-28,27,Sun,7,8,@,LAR,L 27-29,27,29,-2,56,2018,2018_08_GNB_LAR
MIN,2018-10-14,27,Sun,6,6,,ARI,W 27-17,27,17,10,44,2018,2018_06_MIN_ARI
SEA,2018-10-14,27,Sun,6,6,@,OAK,W 27-3,27,3,24,30,2018,2018_06_SEA_OAK
CIN,2018-10-07,27,Sun,5,5,,MIA,W 27-17,27,17,10,44,2018,2018_05_CIN_MIA
KAN,2018-10-01,27,Mon,4,4,@,DEN,W 27-23,27,23,4,50,2018,2018_04_KAN_DEN
SFO,2018-09-30,27,Sun,4,4,@,LAC,L 27-29,27,29,-2,56,2018,2018_04_SFO_LAC
TAM,2018-09-24,27,Mon,3,3,,PIT,L 27-30,27,30,-3,57,2018,2018_03_TAM_PIT
BAL,2018-09-23,27,Sun,3,3,,DEN,W 27-14,27,14,13,41,2018,2018_03_BAL_DEN
NYG,2018-09-23,27,Sun,3,3,@,HOU,W 27-22,27,22,5,49,2018,2018_03_NYG_HOU
SFO,2018-09-23,27,Sun,3,3,@,KAN,L 27-38,27,38,-11,65,2018,2018_03_SFO_KAN
BUF,2018-09-23,27,Sun,3,3,@,MIN,W 27-6,27,6,21,33,2018,2018_03_BUF_MIN
TAM,2018-09-16,27,Sun,2,2,,PHI,W 27-21,27,21,6,48,2018,2018_02_TAM_PHI
DET,2018-09-16,27,Sun,2,2,@,SFO,L 27-30,27,30,-3,57,2018,2018_02_DET_SFO
NWE,2018-09-09,27,Sun,1,1,,HOU,W 27-20,27,20,7,47,2018,2018_01_NWE_HOU
MIA,2018-09-09,27,Sun,1,1,,TEN,W 27-20,27,20,7,47,2018,2018_01_MIA_TEN
DEN,2018-09-09,27,Sun,1,1,,SEA,W 27-24,27,24,3,51,2018,2018_01_DEN_SEA
BAL,2017-12-31,27,Sun,16,17,,CIN,L 27-31,27,31,-4,58,2017,2017_17_BAL_CIN
KAN,2017-12-31,27,Sun,16,17,@,DEN,W 27-24,27,24,3,51,2017,2017_17_KAN_DEN
WAS,2017-12-24,27,Sun,15,16,,DEN,W 27-11,27,11,16,38,2017,2017_16_WAS_DEN
LAR,2017-12-24,27,Sun,15,16,@,TEN,W 27-23,27,23,4,50,2017,2017_16_LAR_TEN
BAL,2017-12-17,27,Sun,14,15,@,CLE,W 27-10,27,10,17,37,2017,2017_15_BAL_CLE
NWE,2017-12-17,27,Sun,14,15,@,PIT,W 27-24,27,24,3,51,2017,2017_15_NWE_PIT
MIA,2017-12-11,27,Mon,13,14,,NWE,W 27-20,27,20,7,47,2017,2017_14_MIA_NWE
GNB,2017-12-10,27,Sun,13,14,@,CLE,W 27-21 (OT),27,21,6,48,2017,2017_14_GNB_CLE
NYJ,2017-11-26,27,Sun,11,12,,CAR,L 27-35,27,35,-8,62,2017,2017_12_NYJ_CAR
ARI,2017-11-26,27,Sun,11,12,,JAX,W 27-24,27,24,3,51,2017,2017_12_ARI_JAX
DET,2017-11-19,27,Sun,10,11,@,CHI,W 27-24,27,24,3,51,2017,2017_11_DET_CHI
ATL,2017-11-12,27,Sun,9,10,,DAL,W 27-7,27,7,20,34,2017,2017_10_ATL_DAL
OAK,2017-11-05,27,Sun,9,9,@,MIA,W 27-24,27,24,3,51,2017,2017_09_OAK_MIA
TAM,2017-10-22,27,Sun,6,7,@,BUF,L 27-30,27,30,-3,57,2017,2017_07_TAM_BUF
JAX,2017-10-22,27,Sun,7,7,@,IND,W 27-0,27,0,27,27,2017,2017_07_JAX_IND
LAR,2017-10-15,27,Sun,6,6,@,JAX,W 27-17,27,17,10,44,2017,2017_06_LAR_JAX
CHI,2017-10-15,27,Sun,6,6,@,BAL,W 27-24 (OT),27,24,3,51,2017,2017_06_CHI_BAL
CAR,2017-10-08,27,Sun,5,5,@,DET,W 27-24,27,24,3,51,2017,2017_05_CAR_DET
LAC,2017-10-08,27,Sun,5,5,@,NYG,W 27-22,27,22,5,49,2017,2017_05_LAC_NYG
GNB,2017-09-24,27,Sun,3,3,,CIN,W 27-24 (OT),27,24,3,51,2017,2017_03_GNB_CIN
PHI,2017-09-24,27,Sun,3,3,,NYG,W 27-24,27,24,3,51,2017,2017_03_PHI_NYG
SEA,2017-09-24,27,Sun,3,3,@,TEN,L 27-33,27,33,-6,60,2017,2017_03_SEA_TEN
WAS,2017-09-24,27,Sun,3,3,,OAK,W 27-10,27,10,17,37,2017,2017_03_WAS_OAK
KAN,2017-09-17,27,Sun,2,2,,PHI,W 27-20,27,20,7,47,2017,2017_02_KAN_PHI
WAS,2017-09-17,27,Sun,2,2,@,LAR,W 27-20,27,20,7,47,2017,2017_02_WAS_LAR
NWE,2017-09-07,27,Thu,1,1,,KAN,L 27-42,27,42,-15,69,2017,2017_01_NWE_KAN
WAS,2023-01-08,26,Sun,17,18,,DAL,W 26-6,26,6,20,32,2022,2022_18_WAS_DAL
GNB,2022-12-25,26,Sun,15,16,@,MIA,W 26-20,26,20,6,46,2022,2022_16_GNB_MIA
KAN,2022-11-27,26,Sun,11,12,,LAR,W 26-10,26,10,16,36,2022,2022_12_KAN_LAR
NWE,2022-11-24,26,Thu,11,12,@,MIN,L 26-33,26,33,-7,59,2022,2022_12_NWE_MIN
NWE,2022-11-06,26,Sun,9,9,,IND,W 26-3,26,3,23,29,2022,2022_09_NWE_IND
ARI,2022-10-30,26,Sun,8,8,@,MIN,L 26-34,26,34,-8,60,2022,2022_08_ARI_MIN
NOR,2022-10-16,26,Sun,6,6,,CIN,L 26-30,26,30,-4,56,2022,2022_06_NOR_CIN
PHI,2022-10-16,26,Sun,6,6,,DAL,W 26-17,26,17,9,43,2022,2022_06_PHI_DAL
ARI,2022-10-02,26,Sun,4,4,@,CAR,W 26-16,26,16,10,42,2022,2022_04_ARI_CAR
NWE,2022-09-25,26,Sun,3,3,,BAL,L 26-37,26,37,-11,63,2022,2022_03_NWE_BAL
CLE,2022-09-11,26,Sun,1,1,@,CAR,W 26-24,26,24,2,50,2022,2022_01_CLE_CAR
ATL,2022-09-11,26,Sun,1,1,,NOR,L 26-27,26,27,-1,53,2022,2022_01_ATL_NOR
JAX,2022-01-09,26,Sun,17,18,,IND,W 26-11,26,11,15,37,2021,2021_18_JAX_IND
PHI,2022-01-08,26,Sat,17,18,,DAL,L 26-51,26,51,-25,77,2021,2021_18_PHI_DAL
PIT,2022-01-03,26,Mon,16,17,,CLE,W 26-14,26,14,12,40,2021,2021_17_PIT_CLE
NYJ,2021-12-26,26,Sun,15,16,,JAX,W 26-21,26,21,5,47,2021,2021_16_NYJ_JAX
SFO,2021-12-12,26,Sun,13,14,@,CIN,W 26-23 (OT),26,23,3,49,2021,2021_14_SFO_CIN
MIN,2021-11-28,26,Sun,11,12,@,SFO,L 26-34,26,34,-8,60,2021,2021_12_MIN_SFO
BUF,2021-10-31,26,Sun,7,8,,MIA,W 26-11,26,11,15,37,2021,2021_08_BUF_MIA
LAR,2021-10-07,26,Thu,5,5,@,SEA,W 26-17,26,17,9,43,2021,2021_05_LAR_SEA
CLE,2021-09-26,26,Sun,3,3,,CHI,W 26-6,26,6,20,32,2021,2021_03_CLE_CHI
DEN,2021-09-26,26,Sun,3,3,,NYJ,W 26-0,26,0,26,26,2021,2021_03_DEN_NYJ
CAR,2021-09-19,26,Sun,2,2,,NOR,W 26-7,26,7,19,33,2021,2021_02_CAR_NOR
LVR,2021-09-19,26,Sun,2,2,@,PIT,W 26-17,26,17,9,43,2021,2021_02_LVR_PIT
SEA,2021-01-03,26,Sun,16,17,@,SFO,W 26-23,26,23,3,49,2020,2020_17_SEA_SFO
MIA,2021-01-03,26,Sun,16,17,@,BUF,L 26-56,26,56,-30,82,2020,2020_17_MIA_BUF
MIA,2020-12-26,26,Sat,15,16,@,LVR,W 26-25,26,25,1,51,2020,2020_16_MIA_LVR
PHI,2020-12-20,26,Sun,14,15,@,ARI,L 26-33,26,33,-7,59,2020,2020_15_PHI_ARI
TAM,2020-12-13,26,Sun,13,14,,MIN,W 26-14,26,14,12,40,2020,2020_14_TAM_MIN
ARI,2020-12-13,26,Sun,13,14,@,NYG,W 26-7,26,7,19,33,2020,2020_14_ARI_NYG
BUF,2020-12-13,26,Sun,13,14,,PIT,W 26-15,26,15,11,41,2020,2020_14_BUF_PIT
IND,2020-12-06,26,Sun,12,13,@,HOU,W 26-20,26,20,6,46,2020,2020_13_IND_HOU
IND,2020-11-29,26,Sun,11,12,,TEN,L 26-45,26,45,-19,71,2020,2020_12_IND_TEN
LAC,2020-11-08,26,Sun,8,9,,LVR,L 26-31,26,31,-5,57,2020,2020_09_LAC_LVR
NOR,2020-11-01,26,Sun,7,8,@,CHI,W 26-23 (OT),26,23,3,49,2020,2020_08_NOR_CHI
KAN,2020-10-19,26,Mon,6,6,@,BUF,W 26-17,26,17,9,43,2020,2020_06_KAN_BUF
MIN,2020-10-11,26,Sun,5,5,@,SEA,L 26-27,26,27,-1,53,2020,2020_05_MIN_SEA
KAN,2020-10-05,26,Mon,4,4,,NWE,W 26-10,26,10,16,36,2020,2020_04_KAN_NWE
DET,2020-09-27,26,Sun,3,3,@,ARI,W 26-23,26,23,3,49,2020,2020_03_DET_ARI
ATL,2020-09-27,26,Sun,3,3,,CHI,L 26-30,26,30,-4,56,2020,2020_03_ATL_CHI
PIT,2020-09-20,26,Sun,2,2,,DEN,W 26-21,26,21,5,47,2020,2020_02_PIT_DEN
PIT,2020-09-14,26,Mon,1,1,@,NYG,W 26-16,26,16,10,42,2020,2020_01_PIT_NYG
SFO,2019-12-29,26,Sun,16,17,@,SEA,W 26-21,26,21,5,47,2019,2019_17_SFO_SEA
KAN,2019-12-22,26,Sun,15,16,@,CHI,W 26-3,26,3,23,29,2019,2019_16_KAN_CHI
NOR,2019-11-28,26,Thu,12,13,@,ATL,W 26-18,26,18,8,44,2019,2019_13_NOR_ATL
BUF,2019-11-28,26,Thu,12,13,@,DAL,W 26-15,26,15,11,41,2019,2019_13_BUF_DAL
ARI,2019-11-17,26,Sun,11,11,@,SFO,L 26-36,26,36,-10,62,2019,2019_11_ARI_SFO
ATL,2019-11-10,26,Sun,9,10,@,NOR,W 26-9,26,9,17,35,2019,2019_10_ATL_NOR
OAK,2019-11-07,26,Thu,9,10,,LAC,W 26-24,26,24,2,50,2019,2019_10_OAK_LAC
PIT,2019-11-03,26,Sun,8,9,,IND,W 26-24,26,24,2,50,2019,2019_09_PIT_IND
LAC,2019-11-03,26,Sun,9,9,,GNB,W 26-11,26,11,15,37,2019,2019_09_LAC_GNB
HOU,2019-11-03,26,Sun,9,9,@,JAX,W 26-3,26,3,23,29,2019,2019_09_HOU_JAX
KAN,2019-11-03,26,Sun,9,9,,MIN,W 26-23,26,23,3,49,2019,2019_09_KAN_MIN
MIA,2019-11-03,26,Sun,8,9,,NYJ,W 26-18,26,18,8,44,2019,2019_09_MIA_NYJ
NYG,2019-10-27,26,Sun,8,8,@,DET,L 26-31,26,31,-5,57,2019,2019_08_NYG_DET
TAM,2019-10-13,26,Sun,6,6,,CAR,L 26-37,26,37,-11,63,2019,2019_06_TAM_CAR
ARI,2019-10-06,26,Sun,5,5,@,CIN,W 26-23,26,23,3,49,2019,2019_05_ARI_CIN
BAL,2019-10-06,26,Sun,5,5,@,PIT,W 26-23 (OT),26,23,3,49,2019,2019_05_BAL_PIT
JAX,2019-09-29,26,Sun,4,4,@,DEN,W 26-24,26,24,2,50,2019,2019_04_JAX_DEN
PIT,2019-09-15,26,Sun,2,2,,SEA,L 26-28,26,28,-2,54,2019,2019_02_PIT_SEA
JAX,2019-09-08,26,Sun,1,1,,KAN,L 26-40,26,40,-14,66,2019,2019_01_JAX_KAN
BAL,2018-12-30,26,Sun,16,17,,CLE,W 26-24,26,24,2,50,2018,2018_17_BAL_CLE
CLE,2018-12-23,26,Sun,15,16,,CIN,W 26-18,26,18,8,44,2018,2018_16_CLE_CIN
SFO,2018-12-16,26,Sun,14,15,,SEA,W 26-23 (OT),26,23,3,49,2018,2018_15_SFO_SEA
LAC,2018-12-09,26,Sun,13,14,,CIN,W 26-21,26,21,5,47,2018,2018_14_LAC_CIN
CLE,2018-12-09,26,Sun,13,14,,CAR,W 26-20,26,20,6,46,2018,2018_14_CLE_CAR
TEN,2018-12-02,26,Sun,12,13,,NYJ,W 26-22,26,22,4,48,2018,2018_13_TEN_NYJ
BAL,2018-12-02,26,Sun,12,13,@,ATL,W 26-16,26,16,10,42,2018,2018_13_BAL_ATL
JAX,2018-11-11,26,Sun,9,10,@,IND,L 26-29,26,29,-3,55,2018,2018_10_JAX_IND
KAN,2018-11-11,26,Sun,10,10,,ARI,W 26-14,26,14,12,40,2018,2018_10_KAN_ARI
TAM,2018-10-21,26,Sun,6,7,,CLE,W 26-23 (OT),26,23,3,49,2018,2018_07_TAM_CLE
LAC,2018-10-07,26,Sun,5,5,,OAK,W 26-10,26,10,16,36,2018,2018_05_LAC_OAK
DAL,2018-09-30,26,Sun,4,4,,DET,W 26-24,26,24,2,50,2018,2018_04_DAL_DET
TEN,2018-09-30,26,Sun,4,4,,PHI,W 26-23 (OT),26,23,3,49,2018,2018_04_TEN_PHI
BAL,2018-09-30,26,Sun,4,4,@,PIT,W 26-14,26,14,12,40,2018,2018_04_BAL_PIT
DET,2018-09-23,26,Sun,3,3,,NWE,W 26-10,26,10,16,36,2018,2018_03_DET_NWE
ARI,2017-12-31,26,Sun,16,17,@,SEA,W 26-24,26,24,2,50,2017,2017_17_ARI_SEA
NWE,2017-12-31,26,Sun,16,17,,NYJ,W 26-6,26,6,20,32,2017,2017_17_NWE_NYJ
CIN,2017-12-24,26,Sun,15,16,,DET,W 26-17,26,17,9,43,2017,2017_16_CIN_DET
SFO,2017-12-10,26,Sun,13,14,@,HOU,W 26-16,26,16,10,42,2017,2017_14_SFO_HOU
KAN,2017-12-10,26,Sun,13,14,,OAK,W 26-15,26,15,11,41,2017,2017_14_KAN_OAK
GNB,2017-12-03,26,Sun,12,13,,TAM,W 26-20 (OT),26,20,6,46,2017,2017_13_GNB_TAM
LAR,2017-11-26,26,Sun,11,12,,NOR,W 26-20,26,20,6,46,2017,2017_12_LAR_NOR
NOR,2017-10-22,26,Sun,6,7,@,GNB,W 26-17,26,17,9,43,2017,2017_07_NOR_GNB
WAS,2017-10-15,26,Sun,5,6,,SFO,W 26-24,26,24,2,50,2017,2017_06_WAS_SFO
IND,2017-10-08,26,Sun,5,5,,SFO,W 26-23 (OT),26,23,3,49,2017,2017_05_IND_SFO
PIT,2017-10-01,26,Sun,4,4,@,BAL,W 26-9,26,9,17,35,2017,2017_04_PIT_BAL
PHI,2017-10-01,26,Sun,4,4,@,LAC,W 26-24,26,24,2,50,2017,2017_04_PHI_LAC
DET,2017-09-24,26,Sun,3,3,,ATL,L 26-30,26,30,-4,56,2017,2017_03_DET_ATL
BUF,2017-09-24,26,Sun,3,3,,DEN,W 26-16,26,16,10,42,2017,2017_03_BUF_DEN
PIT,2017-09-17,26,Sun,2,2,,MIN,W 26-9,26,9,17,35,2017,2017_02_PIT_MIN
OAK,2017-09-10,26,Sun,1,1,@,TEN,W 26-16,26,16,10,42,2017,2017_01_OAK_TEN
PHI,2022-12-18,25,Sun,14,15,@,CHI,W 25-20,25,20,5,45,2022,2022_15_PHI_CHI
LAC,2022-11-27,25,Sun,11,12,@,ARI,W 25-24,25,24,1,49,2022,2022_12_LAC_ARI
DET,2022-11-24,25,Thu,11,12,,BUF,L 25-28,25,28,-3,53,2022,2022_12_DET_BUF
IND,2022-11-13,25,Sun,10,10,@,LVR,W 25-20,25,20,5,45,2022,2022_10_IND_LVR
CAR,2022-11-10,25,Thu,10,10,,ATL,W 25-15,25,15,10,40,2022,2022_10_CAR_ATL
DAL,2022-10-02,25,Sun,4,4,,WAS,W 25-10,25,10,15,35,2022,2022_04_DAL_WAS
NOR,2022-10-02,25,Sun,4,4,,MIN,L 25-28,25,28,-3,53,2022,2022_04_NOR_MIN
HOU,2022-01-09,25,Sun,17,18,,TEN,L 25-28,25,28,-3,53,2021,2021_18_HOU_TEN
ARI,2022-01-02,25,Sun,16,17,@,DAL,W 25-22,25,22,3,47,2021,2021_17_ARI_DAL
CHI,2021-12-26,25,Sun,15,16,@,SEA,W 25-24,25,24,1,49,2021,2021_16_CHI_SEA
NWE,2021-11-18,25,Thu,11,11,@,ATL,W 25-0,25,0,25,25,2021,2021_11_NWE_ATL
NOR,2021-11-07,25,Sun,8,9,,ATL,L 25-27,25,27,-2,52,2021,2021_09_NOR_ATL
NYG,2021-10-24,25,Sun,7,7,,CAR,W 25-3,25,3,22,28,2021,2021_07_NYG_CAR
IND,2021-10-11,25,Mon,5,5,@,BAL,L 25-31 (OT),25,31,-6,56,2021,2021_05_IND_BAL
GNB,2021-10-10,25,Sun,5,5,@,CIN,W 25-22 (OT),25,22,3,47,2021,2021_05_GNB_CIN
NWE,2021-10-10,25,Sun,5,5,@,HOU,W 25-22,25,22,3,47,2021,2021_05_NWE_HOU
TEN,2021-09-26,25,Sun,3,3,,IND,W 25-16,25,16,9,41,2021,2021_03_TEN_IND
NWE,2021-09-19,25,Sun,2,2,@,NYJ,W 25-6,25,6,19,31,2021,2021_02_NWE_NYJ
ATL,2021-09-19,25,Sun,2,2,@,TAM,L 25-48,25,48,-23,73,2021,2021_02_ATL_TAM
LVR,2020-12-26,25,Sat,15,16,,MIA,L 25-26,25,26,-1,51,2020,2020_16_LVR_MIA
DET,2020-12-20,25,Sun,14,15,@,TEN,L 25-46,25,46,-21,71,2020,2020_15_DET_TEN
JAX,2020-11-29,25,Sun,11,12,,CLE,L 25-27,25,27,-2,52,2020,2020_12_JAX_CLE
CHI,2020-11-29,25,Sun,11,12,@,GNB,L 25-41,25,41,-16,66,2020,2020_12_CHI_GNB
DET,2020-11-26,25,Thu,11,12,,HOU,L 25-41,25,41,-16,66,2020,2020_12_DET_HOU
JAX,2020-11-08,25,Sun,8,9,,HOU,L 25-27,25,27,-2,52,2020,2020_09_JAX_HOU
TAM,2020-11-02,25,Mon,8,8,@,NYG,W 25-23,25,23,2,48,2020,2020_08_TAM_NYG
ATL,2020-10-29,25,Thu,8,8,@,CAR,W 25-17,25,17,8,42,2020,2020_08_ATL_CAR
WAS,2020-10-25,25,Sun,7,7,,DAL,W 25-3,25,3,22,28,2020,2020_07_WAS_DAL
PHI,2020-10-04,25,Sun,4,4,@,SFO,W 25-20,25,20,5,45,2020,2020_04_PHI_SFO
JAX,2020-10-04,25,Sun,4,4,@,CIN,L 25-33,25,33,-8,58,2020,2020_04_JAX_CIN
ATL,2020-09-13,25,Sun,1,1,,SEA,L 25-38,25,38,-13,63,2020,2020_01_ATL_SEA
ARI,2019-10-31,25,Thu,9,9,,SFO,L 25-28,25,28,-3,53,2019,2019_09_ARI_SFO
CHI,2019-10-20,25,Sun,6,7,,NOR,L 25-36,25,36,-11,61,2019,2019_07_CHI_NOR
BAL,2019-09-29,25,Sun,4,4,,CLE,L 25-40,25,40,-15,65,2019,2019_04_BAL_CLE
TEN,2018-12-22,25,Sat,15,16,,WAS,W 25-16,25,16,9,41,2018,2018_16_TEN_WAS
PHI,2018-11-25,25,Sun,11,12,,NYG,W 25-22,25,22,3,47,2018,2018_12_PHI_NYG
CHI,2018-11-18,25,Sun,10,11,,MIN,W 25-20,25,20,5,45,2018,2018_11_CHI_MIN
LAC,2018-11-04,25,Sun,8,9,@,SEA,W 25-17,25,17,8,42,2018,2018_09_LAC_SEA
NWE,2018-10-29,25,Mon,8,8,@,BUF,W 25-6,25,6,19,31,2018,2018_08_NWE_BUF
SFO,2017-12-17,25,Sun,14,15,,TEN,W 25-23,25,23,2,48,2017,2017_15_SFO_TEN
DEN,2017-12-14,25,Thu,14,15,@,IND,W 25-13,25,13,12,38,2017,2017_15_DEN_IND
ATL,2017-10-29,25,Sun,7,8,@,NYJ,W 25-20,25,20,5,45,2017,2017_08_ATL_NYJ
TAM,2017-10-01,25,Sun,3,4,,NYG,W 25-23,25,23,2,48,2017,2017_04_TAM_NYG
CAR,2023-01-01,24,Sun,16,17,@,TAM,L 24-30,24,30,-6,54,2022,2022_17_CAR_TAM
DEN,2023-01-01,24,Sun,16,17,@,KAN,L 24-27,24,27,-3,51,2022,2022_17_DEN_KAN
CLE,2023-01-01,24,Sun,16,17,@,WAS,W 24-10,24,10,14,34,2022,2022_17_CLE_WAS
KAN,2022-12-24,24,Sat,15,16,,SEA,W 24-10,24,10,14,34,2022,2022_16_KAN_SEA
NYG,2022-12-24,24,Sat,15,16,@,MIN,L 24-27,24,27,-3,51,2022,2022_16_NYG_MIN
GNB,2022-12-19,24,Mon,14,15,,LAR,W 24-12,24,12,12,36,2022,2022_15_GNB_LAR
DEN,2022-12-18,24,Sun,14,15,,ARI,W 24-15,24,15,9,39,2022,2022_15_DEN_ARI
PIT,2022-12-18,24,Sun,14,15,@,CAR,W 24-16,24,16,8,40,2022,2022_15_PIT_CAR
HOU,2022-12-18,24,Sun,14,15,,KAN,L 24-30 (OT),24,30,-6,54,2022,2022_15_HOU_KAN
NWE,2022-12-18,24,Sun,14,15,@,LVR,L 24-30,24,30,-6,54,2022,2022_15_NWE_LVR
SEA,2022-12-11,24,Sun,13,14,,CAR,L 24-30,24,30,-6,54,2022,2022_14_SEA_CAR
KAN,2022-12-04,24,Sun,12,13,@,CIN,L 24-27,24,27,-3,51,2022,2022_13_KAN_CIN
BUF,2022-12-01,24,Thu,12,13,@,NWE,W 24-10,24,10,14,34,2022,2022_13_BUF_NWE
PIT,2022-11-28,24,Mon,11,12,@,IND,W 24-17,24,17,7,41,2022,2022_12_PIT_IND
ARI,2022-11-27,24,Sun,12,12,,LAC,L 24-25,24,25,-1,49,2022,2022_12_ARI_LAC
CHI,2022-11-20,24,Sun,11,11,@,ATL,L 24-27,24,27,-3,51,2022,2022_11_CHI_ATL
NYG,2022-11-13,24,Sun,9,10,,HOU,W 24-16,24,16,8,40,2022,2022_10_NYG_HOU
NOR,2022-10-30,24,Sun,8,8,,LVR,W 24-0,24,0,24,24,2022,2022_08_NOR_LVR
DAL,2022-10-23,24,Sun,7,7,,DET,W 24-6,24,6,18,30,2022,2022_07_DAL_DET
MIN,2022-10-16,24,Sun,6,6,@,MIA,W 24-16,24,16,8,40,2022,2022_06_MIN_MIA
LAR,2022-10-16,24,Sun,6,6,,CAR,W 24-10,24,10,14,34,2022,2022_06_LAR_CAR
BUF,2022-10-16,24,Sun,6,6,@,KAN,W 24-20,24,20,4,44,2022,2022_06_BUF_KAN
NYG,2022-10-16,24,Sun,6,6,,BAL,W 24-20,24,20,4,44,2022,2022_06_NYG_BAL
SFO,2022-10-03,24,Mon,4,4,,LAR,W 24-9,24,9,15,33,2022,2022_04_SFO_LAR
NWE,2022-10-02,24,Sun,4,4,@,GNB,L 24-27 (OT),24,27,-3,51,2022,2022_04_NWE_GNB
NYJ,2022-10-02,24,Sun,4,4,@,PIT,W 24-20,24,20,4,44,2022,2022_04_NYJ_PIT
TEN,2022-10-02,24,Sun,4,4,@,IND,W 24-17,24,17,7,41,2022,2022_04_TEN_IND
HOU,2022-10-02,24,Sun,4,4,,LAC,L 24-34,24,34,-10,58,2022,2022_04_HOU_LAC
PHI,2022-09-25,24,Sun,3,3,@,WAS,W 24-8,24,8,16,32,2022,2022_03_PHI_WAS
DET,2022-09-25,24,Sun,3,3,@,MIN,L 24-28,24,28,-4,52,2022,2022_03_DET_MIN
TEN,2022-09-25,24,Sun,3,3,,LVR,W 24-22,24,22,2,46,2022,2022_03_TEN_LVR
PHI,2022-09-19,24,Mon,2,2,,MIN,W 24-7,24,7,17,31,2022,2022_02_PHI_MIN
JAX,2022-09-18,24,Sun,2,2,,IND,W 24-0,24,0,24,24,2022,2022_02_JAX_IND
LAC,2022-09-15,24,Thu,2,2,@,KAN,L 24-27,24,27,-3,51,2022,2022_02_LAC_KAN
CAR,2022-09-11,24,Sun,1,1,,CLE,L 24-26,24,26,-2,50,2022,2022_01_CAR_CLE
LAC,2022-09-11,24,Sun,1,1,,LVR,W 24-19,24,19,5,43,2022,2022_01_LAC_LVR
BAL,2022-09-11,24,Sun,1,1,@,NYJ,W 24-9,24,9,15,33,2022,2022_01_BAL_NYJ
NWE,2022-01-09,24,Sun,17,18,@,MIA,L 24-33,24,33,-9,57,2021,2021_18_NWE_MIA
LAR,2022-01-09,24,Sun,17,18,,SFO,L 24-27 (OT),24,27,-3,51,2021,2021_18_LAR_SFO
DEN,2022-01-08,24,Sat,17,18,,KAN,L 24-28,24,28,-4,52,2021,2021_18_DEN_KAN
NYJ,2022-01-02,24,Sun,16,17,,TAM,L 24-28,24,28,-4,52,2021,2021_17_NYJ_TAM
SEA,2021-12-26,24,Sun,15,16,,CHI,L 24-25,24,25,-1,49,2021,2021_16_SEA_CHI
GNB,2021-12-25,24,Sat,15,16,,CLE,W 24-22,24,22,2,46,2021,2021_16_GNB_CLE
NYJ,2021-12-19,24,Sun,14,15,@,MIA,L 24-31,24,31,-7,55,2021,2021_15_NYJ_MIA
CLE,2021-12-12,24,Sun,13,14,,BAL,W 24-22,24,22,2,46,2021,2021_14_CLE_BAL
MIA,2021-11-21,24,Sun,11,11,@,NYJ,W 24-17,24,17,7,41,2021,2021_11_MIA_NYJ
PHI,2021-11-07,24,Sun,9,9,,LAC,L 24-27,24,27,-3,51,2021,2021_09_PHI_LAC
NWE,2021-11-07,24,Sun,9,9,@,CAR,W 24-6,24,6,18,30,2021,2021_09_NWE_CAR
LAC,2021-10-31,24,Sun,7,8,,NWE,L 24-27,24,27,-3,51,2021,2021_08_LAC_NWE
GNB,2021-10-28,24,Thu,8,8,@,ARI,W 24-21,24,21,3,45,2021,2021_08_GNB_ARI
GNB,2021-10-24,24,Sun,7,7,,WAS,W 24-10,24,10,14,34,2021,2021_07_GNB_WAS
DEN,2021-10-17,24,Sun,6,6,,LVR,L 24-34,24,34,-10,58,2021,2021_06_DEN_LVR
GNB,2021-10-17,24,Sun,6,6,@,CHI,W 24-14,24,14,10,38,2021,2021_06_GNB_CHI
CHI,2021-10-03,24,Sun,4,4,,DET,W 24-14,24,14,10,38,2021,2021_04_CHI_DET
TEN,2021-10-03,24,Sun,4,4,@,NYJ,L 24-27 (OT),24,27,-3,51,2021,2021_04_TEN_NYJ
CIN,2021-09-30,24,Thu,4,4,,JAX,W 24-21,24,21,3,45,2021,2021_04_CIN_JAX
KAN,2021-09-26,24,Sun,3,3,,LAC,L 24-30,24,30,-6,54,2021,2021_03_KAN_LAC
TAM,2021-09-26,24,Sun,3,3,@,LAR,L 24-34,24,34,-10,58,2021,2021_03_TAM_LAR
CIN,2021-09-26,24,Sun,3,3,@,PIT,W 24-10,24,10,14,34,2021,2021_03_CIN_PIT
CAR,2021-09-23,24,Thu,3,3,@,HOU,W 24-9,24,9,15,33,2021,2021_03_CAR_HOU
IND,2021-09-19,24,Sun,2,2,,LAR,L 24-27,24,27,-3,51,2021,2021_02_IND_LAR
MIN,2021-09-12,24,Sun,1,1,@,CIN,L 24-27 (OT),24,27,-3,51,2021,2021_01_MIN_CIN
CLE,2021-01-03,24,Sun,16,17,,PIT,W 24-22,24,22,2,46,2020,2020_17_CLE_PIT
IND,2020-12-27,24,Sun,15,16,@,PIT,L 24-28,24,28,-4,52,2020,2020_16_IND_PIT
GNB,2020-12-19,24,Sat,14,15,,CAR,W 24-16,24,16,8,40,2020,2020_15_GNB_CAR
DET,2020-12-13,24,Sun,13,14,,GNB,L 24-31,24,31,-7,55,2020,2020_14_DET_GNB
PHI,2020-12-13,24,Sun,13,14,,NOR,W 24-21,24,21,3,45,2020,2020_14_PHI_NOR
LAR,2020-12-10,24,Thu,13,14,,NWE,W 24-3,24,3,21,27,2020,2020_14_LAR_NWE
SFO,2020-12-07,24,Mon,12,13,,BUF,L 24-34,24,34,-10,58,2020,2020_13_SFO_BUF
JAX,2020-12-06,24,Sun,12,13,@,MIN,L 24-27 (OT),24,27,-3,51,2020,2020_13_JAX_MIN
TAM,2020-11-29,24,Sun,12,12,,KAN,L 24-27,24,27,-3,51,2020,2020_12_TAM_KAN
TAM,2020-11-23,24,Mon,11,11,,LAR,L 24-27,24,27,-3,51,2020,2020_11_TAM_LAR
NOR,2020-11-22,24,Sun,10,11,,ATL,W 24-9,24,9,15,33,2020,2020_11_NOR_ATL
BAL,2020-11-22,24,Sun,10,11,,TEN,L 24-30 (OT),24,30,-6,54,2020,2020_11_BAL_TEN
GNB,2020-11-15,24,Sun,9,10,,JAX,W 24-20,24,20,4,44,2020,2020_10_GNB_JAX
PIT,2020-11-08,24,Sun,8,9,@,DAL,W 24-19,24,19,5,43,2020,2020_09_PIT_DAL
BAL,2020-11-08,24,Sun,8,9,@,IND,W 24-10,24,10,14,34,2020,2020_09_BAL_IND
TEN,2020-11-08,24,Sun,8,9,,CHI,W 24-17,24,17,7,41,2020,2020_09_TEN_CHI
BUF,2020-11-01,24,Sun,8,8,,NWE,W 24-21,24,21,3,45,2020,2020_08_BUF_NWE
BAL,2020-11-01,24,Sun,7,8,,PIT,L 24-28,24,28,-4,52,2020,2020_08_BAL_PIT
LAR,2020-10-26,24,Mon,7,7,,CHI,W 24-10,24,10,14,34,2020,2020_07_LAR_CHI
CAR,2020-10-25,24,Sun,7,7,@,NOR,L 24-27,24,27,-3,51,2020,2020_07_CAR_NOR
TEN,2020-10-25,24,Sun,6,7,,PIT,L 24-27,24,27,-3,51,2020,2020_07_TEN_PIT
SFO,2020-10-18,24,Sun,6,6,,LAR,W 24-16,24,16,8,40,2020,2020_06_SFO_LAR
MIA,2020-10-18,24,Sun,6,6,,NYJ,W 24-0,24,0,24,24,2020,2020_06_MIA_NYJ
NOR,2020-09-21,24,Mon,2,2,@,LVR,L 24-34,24,34,-10,58,2020,2020_02_NOR_LVR
ARI,2020-09-13,24,Sun,1,1,@,SFO,W 24-20,24,20,4,44,2020,2020_01_ARI_SFO
NWE,2019-12-29,24,Sun,16,17,,MIA,L 24-27,24,27,-3,51,2019,2019_17_NWE_MIA
ARI,2019-12-29,24,Sun,16,17,@,LAR,L 24-31,24,31,-7,55,2019,2019_17_ARI_LAR
ATL,2019-12-22,24,Sun,15,16,,JAX,W 24-12,24,12,12,36,2019,2019_16_ATL_JAX
OAK,2019-12-22,24,Sun,15,16,@,LAC,W 24-17,24,17,7,41,2019,2019_16_OAK_LAC
NWE,2019-12-21,24,Sat,15,16,,BUF,W 24-17,24,17,7,41,2019,2019_16_NWE_BUF
CLE,2019-12-15,24,Sun,14,15,@,ARI,L 24-38,24,38,-14,62,2019,2019_15_CLE_ARI
HOU,2019-12-15,24,Sun,14,15,@,TEN,W 24-21,24,21,3,45,2019,2019_15_HOU_TEN
CAR,2019-12-15,24,Sun,14,15,,SEA,L 24-30,24,30,-6,54,2019,2019_15_CAR_SEA
HOU,2019-12-08,24,Sun,13,14,,DEN,L 24-38,24,38,-14,62,2019,2019_14_HOU_DEN
BAL,2019-12-08,24,Sun,13,14,@,BUF,W 24-17,24,17,7,41,2019,2019_14_BAL_BUF
DAL,2019-12-05,24,Thu,13,14,@,CHI,L 24-31,24,31,-7,55,2019,2019_14_DAL_CHI
CHI,2019-11-28,24,Thu,12,13,@,DET,W 24-20,24,20,4,44,2019,2019_13_CHI_DET
MIA,2019-11-24,24,Sun,11,12,@,CLE,L 24-41,24,41,-17,65,2019,2019_12_MIA_CLE
KAN,2019-11-18,24,Mon,11,11,@,LAC,W 24-17,24,17,7,41,2019,2019_11_KAN_LAC
SFO,2019-11-11,24,Mon,9,10,,SEA,L 24-27 (OT),24,27,-3,51,2019,2019_10_SFO_SEA
GNB,2019-11-10,24,Sun,10,10,,CAR,W 24-16,24,16,8,40,2019,2019_10_GNB_CAR
DAL,2019-11-10,24,Sun,9,10,,MIN,L 24-28,24,28,-4,52,2019,2019_10_DAL_MIN
LAC,2019-11-07,24,Thu,10,10,@,OAK,L 24-26,24,26,-2,50,2019,2019_10_LAC_OAK
IND,2019-11-03,24,Sun,8,9,@,PIT,L 24-26,24,26,-2,50,2019,2019_09_IND_PIT
DEN,2019-11-03,24,Sun,9,9,,CLE,W 24-19,24,19,5,43,2019,2019_09_DEN_CLE
BUF,2019-11-03,24,Sun,8,9,,WAS,W 24-9,24,9,15,33,2019,2019_09_BUF_WAS
DET,2019-11-03,24,Sun,8,9,@,OAK,L 24-31,24,31,-7,55,2019,2019_09_DET_OAK
KAN,2019-10-27,24,Sun,8,8,,GNB,L 24-31,24,31,-7,55,2019,2019_08_KAN_GNB
LAR,2019-10-27,24,Sun,8,8,,CIN,W 24-10,24,10,14,34,2019,2019_08_LAR_CIN
OAK,2019-10-27,24,Sun,7,8,@,HOU,L 24-27,24,27,-3,51,2019,2019_08_OAK_HOU
OAK,2019-10-20,24,Sun,6,7,@,GNB,L 24-42,24,42,-18,66,2019,2019_07_OAK_GNB
KAN,2019-10-13,24,Sun,6,6,,HOU,L 24-31,24,31,-7,55,2019,2019_06_KAN_HOU
NYJ,2019-10-13,24,Sun,5,6,,DAL,W 24-22,24,22,2,46,2019,2019_06_NYJ_DAL
PIT,2019-10-13,24,Sun,6,6,@,LAC,W 24-17,24,17,7,41,2019,2019_06_PIT_LAC
DAL,2019-10-06,24,Sun,5,5,,GNB,L 24-34,24,34,-10,58,2019,2019_05_DAL_GNB
OAK,2019-10-06,24,Sun,5,5,,CHI,W 24-21,24,21,3,45,2019,2019_05_OAK_CHI
TAM,2019-10-06,24,Sun,5,5,@,NOR,L 24-31,24,31,-7,55,2019,2019_05_TAM_NOR
TEN,2019-09-29,24,Sun,4,4,@,ATL,W 24-10,24,10,14,34,2019,2019_04_TEN_ATL
DEN,2019-09-29,24,Sun,4,4,,JAX,L 24-26,24,26,-2,50,2019,2019_04_DEN_JAX
IND,2019-09-29,24,Sun,4,4,,OAK,L 24-31,24,31,-7,55,2019,2019_04_IND_OAK
NYG,2019-09-29,24,Sun,4,4,,WAS,W 24-3,24,3,21,27,2019,2019_04_NYG_WAS
ATL,2019-09-22,24,Sun,3,3,@,IND,L 24-27,24,27,-3,51,2019,2019_03_ATL_IND
PHI,2019-09-22,24,Sun,3,3,,DET,L 24-27,24,27,-3,51,2019,2019_03_PHI_DET
SFO,2019-09-22,24,Sun,3,3,,PIT,W 24-20,24,20,4,44,2019,2019_03_SFO_PIT
ATL,2019-09-15,24,Sun,2,2,,PHI,W 24-20,24,20,4,44,2019,2019_02_ATL_PHI
OAK,2019-09-09,24,Mon,1,1,,DEN,W 24-16,24,16,8,40,2019,2019_01_OAK_DEN
IND,2019-09-08,24,Sun,1,1,@,LAC,L 24-30 (OT),24,30,-6,54,2019,2019_01_IND_LAC
CHI,2018-12-30,24,Sun,16,17,@,MIN,W 24-10,24,10,14,34,2018,2018_17_CHI_MIN
CLE,2018-12-30,24,Sun,16,17,@,BAL,L 24-26,24,26,-2,50,2018,2018_17_CLE_BAL
ARI,2018-12-30,24,Sun,16,17,@,SEA,L 24-27,24,27,-3,51,2018,2018_17_ARI_SEA
PHI,2018-12-30,24,Sun,16,17,@,WAS,W 24-0,24,0,24,24,2018,2018_17_PHI_WAS
NWE,2018-12-23,24,Sun,15,16,,BUF,W 24-12,24,12,12,36,2018,2018_16_NWE_BUF
ATL,2018-12-23,24,Sun,15,16,@,CAR,W 24-10,24,10,14,34,2018,2018_16_ATL_CAR
CHI,2018-12-16,24,Sun,14,15,,GNB,W 24-17,24,17,7,41,2018,2018_15_CHI_GNB
IND,2018-12-09,24,Sun,13,14,@,HOU,W 24-21,24,21,3,45,2018,2018_14_IND_HOU
BAL,2018-12-09,24,Sun,13,14,@,KAN,L 24-27 (OT),24,27,-3,51,2018,2018_14_BAL_KAN
OAK,2018-12-09,24,Sun,13,14,,PIT,W 24-21,24,21,3,45,2018,2018_14_OAK_PIT
TAM,2018-12-02,24,Sun,12,13,,CAR,W 24-17,24,17,7,41,2018,2018_13_TAM_CAR
DEN,2018-12-02,24,Sun,12,13,@,CIN,W 24-10,24,10,14,34,2018,2018_13_DEN_CIN
NWE,2018-12-02,24,Sun,12,13,,MIN,W 24-10,24,10,14,34,2018,2018_13_NWE_MIN
MIA,2018-11-25,24,Sun,11,12,@,IND,L 24-27,24,27,-3,51,2018,2018_12_MIA_IND
MIN,2018-11-25,24,Sun,11,12,,GNB,W 24-17,24,17,7,41,2018,2018_12_MIN_GNB
BUF,2018-11-25,24,Sun,11,12,,JAX,W 24-21,24,21,3,45,2018,2018_12_BUF_JAX
DEN,2018-11-25,24,Sun,11,12,,PIT,W 24-17,24,17,7,41,2018,2018_12_DEN_PIT
BAL,2018-11-18,24,Sun,10,11,,CIN,W 24-21,24,21,3,45,2018,2018_11_BAL_CIN
GNB,2018-11-15,24,Thu,10,11,@,SEA,L 24-27,24,27,-3,51,2018,2018_11_GNB_SEA
MIN,2018-11-04,24,Sun,9,9,,DET,W 24-9,24,9,15,33,2018,2018_09_MIN_DET
PHI,2018-10-28,24,Sun,8,8,@,JAX,W 24-18,24,18,6,42,2018,2018_08_PHI_JAX
CHI,2018-10-28,24,Sun,7,8,,NYJ,W 24-10,24,10,14,34,2018,2018_08_CHI_NYJ
NOR,2018-10-21,24,Sun,6,7,@,BAL,W 24-23,24,23,1,47,2018,2018_07_NOR_BAL
IND,2018-10-04,24,Thu,5,5,@,NWE,L 24-38,24,38,-14,62,2018,2018_05_IND_NWE
DET,2018-09-30,24,Sun,4,4,@,DAL,L 24-26,24,26,-2,50,2018,2018_04_DET_DAL
SEA,2018-09-23,24,Sun,3,3,,DAL,W 24-13,24,13,11,37,2018,2018_03_SEA_DAL
CHI,2018-09-17,24,Mon,2,2,,SEA,W 24-17,24,17,7,41,2018,2018_02_CHI_SEA
CAR,2018-09-16,24,Sun,2,2,@,ATL,L 24-31,24,31,-7,55,2018,2018_02_CAR_ATL
GNB,2018-09-09,24,Sun,1,1,,CHI,W 24-23,24,23,1,47,2018,2018_01_GNB_CHI
WAS,2018-09-09,24,Sun,1,1,@,ARI,W 24-6,24,6,18,30,2018,2018_01_WAS_ARI
SEA,2018-09-09,24,Sun,1,1,@,DEN,L 24-27,24,27,-3,51,2018,2018_01_SEA_DEN
MIN,2018-09-09,24,Sun,1,1,,SFO,W 24-16,24,16,8,40,2018,2018_01_MIN_SFO
SEA,2017-12-31,24,Sun,16,17,,ARI,L 24-26,24,26,-2,50,2017,2017_17_SEA_ARI
DEN,2017-12-31,24,Sun,16,17,,KAN,L 24-27,24,27,-3,51,2017,2017_17_DEN_KAN
CLE,2017-12-31,24,Sun,16,17,@,PIT,L 24-28,24,28,-4,52,2017,2017_17_CLE_PIT
NOR,2017-12-31,24,Sun,16,17,@,TAM,L 24-31,24,31,-7,55,2017,2017_17_NOR_TAM
ATL,2017-12-18,24,Mon,14,15,@,TAM,W 24-21,24,21,3,45,2017,2017_15_ATL_TAM
GNB,2017-12-17,24,Sun,14,15,@,CAR,L 24-31,24,31,-7,55,2017,2017_15_GNB_CAR
BUF,2017-12-17,24,Sun,14,15,,MIA,W 24-16,24,16,8,40,2017,2017_15_BUF_MIA
PIT,2017-12-17,24,Sun,14,15,,NWE,L 24-27,24,27,-3,51,2017,2017_15_PIT_NWE
MIN,2017-12-10,24,Sun,13,14,@,CAR,L 24-31,24,31,-7,55,2017,2017_14_MIN_CAR
SEA,2017-12-10,24,Sun,13,14,@,JAX,L 24-30,24,30,-6,54,2017,2017_14_SEA_JAX
DET,2017-12-10,24,Sun,13,14,@,TAM,W 24-21,24,21,3,45,2017,2017_14_DET_TAM
TEN,2017-12-03,24,Sun,12,13,,HOU,W 24-13,24,13,11,37,2017,2017_13_TEN_HOU
OAK,2017-12-03,24,Sun,12,13,,NYG,W 24-17,24,17,7,41,2017,2017_13_OAK_NYG
SEA,2017-12-03,24,Sun,12,13,,PHI,W 24-10,24,10,14,34,2017,2017_13_SEA_PHI
JAX,2017-11-26,24,Sun,11,12,@,ARI,L 24-27,24,27,-3,51,2017,2017_12_JAX_ARI
SEA,2017-11-26,24,Sun,11,12,@,SFO,W 24-13,24,13,11,37,2017,2017_12_SEA_SFO
CHI,2017-11-19,24,Sun,10,11,,DET,L 24-27,24,27,-3,51,2017,2017_11_CHI_DET
MIN,2017-11-19,24,Sun,10,11,,LAR,W 24-7,24,7,17,31,2017,2017_11_MIN_LAR
BUF,2017-11-19,24,Sun,10,11,@,LAC,L 24-54,24,54,-30,78,2017,2017_11_BUF_LAC
TEN,2017-11-12,24,Sun,9,10,,CIN,W 24-20,24,20,4,44,2017,2017_10_TEN_CIN
CLE,2017-11-12,24,Sun,9,10,@,DET,L 24-38,24,38,-14,62,2017,2017_10_CLE_DET
MIA,2017-11-05,24,Sun,8,9,,OAK,L 24-27,24,27,-3,51,2017,2017_09_MIA_OAK
CIN,2017-10-29,24,Sun,7,8,,IND,W 24-23,24,23,1,47,2017,2017_08_CIN_IND
WAS,2017-10-23,24,Mon,6,7,@,PHI,L 24-34,24,34,-10,58,2017,2017_07_WAS_PHI
SEA,2017-10-22,24,Sun,6,7,@,NYG,W 24-7,24,7,17,31,2017,2017_07_SEA_NYG
MIN,2017-10-22,24,Sun,7,7,,BAL,W 24-16,24,16,8,40,2017,2017_07_MIN_BAL
BAL,2017-10-15,24,Sun,6,6,,CHI,L 24-27 (OT),24,27,-3,51,2017,2017_06_BAL_CHI
NWE,2017-10-15,24,Sun,6,6,@,NYJ,W 24-17,24,17,7,41,2017,2017_06_NWE_NYJ
SFO,2017-10-15,24,Sun,6,6,@,WAS,L 24-26,24,26,-2,50,2017,2017_06_SFO_WAS
DET,2017-10-08,24,Sun,5,5,,CAR,L 24-27,24,27,-3,51,2017,2017_05_DET_CAR
LAC,2017-10-01,24,Sun,4,4,,PHI,L 24-26,24,26,-2,50,2017,2017_04_LAC_PHI
CIN,2017-09-24,24,Sun,3,3,@,GNB,L 24-27 (OT),24,27,-3,51,2017,2017_03_CIN_GNB
NYG,2017-09-24,24,Sun,3,3,@,PHI,L 24-27,24,27,-3,51,2017,2017_03_NYG_PHI
KAN,2017-09-24,24,Sun,3,3,@,LAC,W 24-10,24,10,14,34,2017,2017_03_KAN_LAC
DET,2017-09-18,24,Mon,2,2,@,NYG,W 24-10,24,10,14,34,2017,2017_02_DET_NYG
BAL,2017-09-17,24,Sun,2,2,,CLE,W 24-10,24,10,14,34,2017,2017_02_BAL_CLE
DEN,2017-09-11,24,Mon,1,1,,LAC,W 24-21,24,21,3,45,2017,2017_01_DEN_LAC
NWE,2023-01-08,23,Sun,17,18,@,BUF,L 23-35,23,35,-12,58,2022,2022_18_NWE_BUF
NWE,2023-01-01,23,Sun,16,17,,MIA,W 23-21,23,21,2,44,2022,2022_17_NWE_MIA
SEA,2023-01-01,23,Sun,16,17,,NYJ,W 23-6,23,6,17,29,2022,2022_17_SEA_NYJ
DET,2022-12-24,23,Sat,15,16,@,CAR,L 23-37,23,37,-14,60,2022,2022_16_DET_CAR
TAM,2022-12-18,23,Sun,14,15,,CIN,L 23-34,23,34,-11,57,2022,2022_15_TAM_CIN
CIN,2022-12-11,23,Sun,13,14,,CLE,W 23-10,23,10,13,33,2022,2022_14_CIN_CLE
HOU,2022-12-11,23,Sun,13,14,@,DAL,L 23-27,23,27,-4,50,2022,2022_14_HOU_DAL
MIN,2022-12-11,23,Sun,13,14,@,DET,L 23-34,23,34,-11,57,2022,2022_14_MIN_DET
LAC,2022-12-11,23,Sun,13,14,,MIA,W 23-17,23,17,6,40,2022,2022_14_LAC_MIA
LAR,2022-12-04,23,Sun,12,13,,SEA,L 23-27,23,27,-4,50,2022,2022_13_LAR_SEA
CAR,2022-11-27,23,Sun,12,12,,DEN,W 23-10,23,10,13,33,2022,2022_12_CAR_DEN
CLE,2022-11-27,23,Sun,11,12,,TAM,W 23-17 (OT),23,17,6,40,2022,2022_12_CLE_TAM
CLE,2022-11-20,23,Sun,10,11,@,BUF,L 23-31,23,31,-8,54,2022,2022_11_CLE_BUF
WAS,2022-11-20,23,Sun,11,11,@,HOU,W 23-10,23,10,13,33,2022,2022_11_WAS_HOU
BAL,2022-10-23,23,Sun,7,7,,CLE,W 23-20,23,20,3,43,2022,2022_07_BAL_CLE
WAS,2022-10-23,23,Sun,7,7,,GNB,W 23-21,23,21,2,44,2022,2022_07_WAS_GNB
NYG,2022-10-23,23,Sun,7,7,@,JAX,W 23-17,23,17,6,40,2022,2022_07_NYG_JAX
SFO,2022-10-23,23,Sun,7,7,,KAN,L 23-44,23,44,-21,67,2022,2022_07_SFO_KAN
LAC,2022-10-23,23,Sun,7,7,,SEA,L 23-37,23,37,-14,60,2022,2022_07_LAC_SEA
ATL,2022-10-02,23,Sun,4,4,,CLE,W 23-20,23,20,3,43,2022,2022_04_ATL_CLE
DEN,2022-10-02,23,Sun,4,4,@,LVR,L 23-32,23,32,-9,55,2022,2022_04_DEN_LVR
BUF,2022-10-02,23,Sun,4,4,@,BAL,W 23-20,23,20,3,43,2022,2022_04_BUF_BAL
DAL,2022-09-26,23,Mon,3,3,@,NYG,W 23-16,23,16,7,39,2022,2022_03_DAL_NYG
SEA,2022-09-25,23,Sun,3,3,,ATL,L 23-27,23,27,-4,50,2022,2022_03_SEA_ATL
CHI,2022-09-25,23,Sun,3,3,,HOU,W 23-20,23,20,3,43,2022,2022_03_CHI_HOU
LVR,2022-09-18,23,Sun,2,2,,ARI,L 23-29 (OT),23,29,-6,52,2022,2022_02_LVR_ARI
PIT,2022-09-11,23,Sun,1,1,@,CIN,W 23-20 (OT),23,20,3,43,2022,2022_01_PIT_CIN
MIN,2022-09-11,23,Sun,1,1,,GNB,W 23-7,23,7,16,30,2022,2022_01_MIN_GNB
LVR,2022-01-02,23,Sun,16,17,@,IND,W 23-20,23,20,3,43,2021,2021_17_LVR_IND
SFO,2022-01-02,23,Sun,16,17,,HOU,W 23-7,23,7,16,30,2021,2021_17_SFO_HOU
MIN,2021-12-26,23,Sun,15,16,,LAR,L 23-30,23,30,-7,53,2021,2021_16_MIN_LAR
ARI,2021-12-13,23,Mon,13,14,,LAR,L 23-30,23,30,-7,53,2021,2021_14_ARI_LAR
CIN,2021-12-12,23,Sun,13,14,,SFO,L 23-26 (OT),23,26,-3,49,2021,2021_14_CIN_SFO
SFO,2021-12-05,23,Sun,12,13,@,SEA,L 23-30,23,30,-7,53,2021,2021_13_SFO_SEA
ARI,2021-11-21,23,Sun,11,11,@,SEA,W 23-13,23,13,10,36,2021,2021_11_ARI_SEA
IND,2021-11-14,23,Sun,10,10,,JAX,W 23-17,23,17,6,40,2021,2021_10_IND_JAX
TEN,2021-11-14,23,Sun,10,10,,NOR,W 23-21,23,21,2,44,2021,2021_10_TEN_NOR
NYG,2021-11-07,23,Sun,9,9,,LVR,W 23-16,23,16,7,39,2021,2021_09_NYG_LVR
JAX,2021-10-17,23,Sun,6,6,,MIA,W 23-20,23,20,3,43,2021,2021_06_JAX_MIA
PIT,2021-10-17,23,Sun,6,6,,SEA,W 23-20 (OT),23,20,3,43,2021,2021_06_PIT_SEA
BAL,2021-10-03,23,Sun,4,4,@,DEN,W 23-7,23,7,16,30,2021,2021_04_BAL_DEN
DEN,2021-09-19,23,Sun,2,2,@,JAX,W 23-13,23,13,10,36,2021,2021_02_DEN_JAX
PIT,2021-09-12,23,Sun,1,1,@,BUF,W 23-16,23,16,7,39,2021,2021_01_PIT_BUF
NYG,2021-01-03,23,Sun,16,17,,DAL,W 23-19,23,19,4,42,2020,2020_17_NYG_DAL
SFO,2021-01-03,23,Sun,16,17,,SEA,L 23-26,23,26,-3,49,2020,2020_17_SFO_SEA
NYJ,2020-12-27,23,Sun,15,16,,CLE,W 23-16,23,16,7,39,2020,2020_16_NYJ_CLE
NYJ,2020-12-20,23,Sun,14,15,@,LAR,W 23-20,23,20,3,43,2020,2020_15_NYJ_LAR
WAS,2020-12-13,23,Sun,13,14,@,SFO,W 23-15,23,15,8,38,2020,2020_14_WAS_SFO
WAS,2020-12-07,23,Mon,12,13,@,PIT,W 23-17,23,17,6,40,2020,2020_13_WAS_PIT
SEA,2020-11-30,23,Mon,11,12,@,PHI,W 23-17,23,17,6,40,2020,2020_12_SEA_PHI
SFO,2020-11-29,23,Sun,11,12,@,LAR,W 23-20,23,20,3,43,2020,2020_12_SFO_LAR
NWE,2020-11-15,23,Sun,9,10,,BAL,W 23-17,23,17,6,40,2020,2020_10_NWE_BAL
LAR,2020-11-15,23,Sun,9,10,,SEA,W 23-16,23,16,7,39,2020,2020_10_LAR_SEA
CAR,2020-11-15,23,Sun,10,10,,TAM,L 23-46,23,46,-23,69,2020,2020_10_CAR_TAM
NYG,2020-11-08,23,Sun,9,9,@,WAS,W 23-20,23,20,3,43,2020,2020_09_NYG_WAS
NYG,2020-11-02,23,Mon,8,8,,TAM,L 23-25,23,25,-2,48,2020,2020_08_NYG_TAM
PHI,2020-11-01,23,Sun,8,8,,DAL,W 23-9,23,9,14,32,2020,2020_08_PHI_DAL
CHI,2020-11-01,23,Sun,8,8,,NOR,L 23-26 (OT),23,26,-3,49,2020,2020_08_CHI_NOR
DET,2020-10-25,23,Sun,6,7,@,ATL,W 23-22,23,22,1,45,2020,2020_07_DET_ATL
MIN,2020-10-18,23,Sun,6,6,,ATL,L 23-40,23,40,-17,63,2020,2020_06_MIN_ATL
CHI,2020-10-18,23,Sun,6,6,@,CAR,W 23-16,23,16,7,39,2020,2020_06_CHI_CAR
CAR,2020-10-11,23,Sun,5,5,@,ATL,W 23-16,23,16,7,39,2020,2020_05_CAR_ATL
IND,2020-10-11,23,Sun,5,5,@,CLE,L 23-32,23,32,-9,55,2020,2020_05_IND_CLE
LVR,2020-10-04,23,Sun,4,4,,BUF,L 23-30,23,30,-7,53,2020,2020_04_LVR_BUF
HOU,2020-10-04,23,Sun,4,4,,MIN,L 23-31,23,31,-8,54,2020,2020_04_HOU_MIN
MIA,2020-10-04,23,Sun,4,4,,SEA,L 23-31,23,31,-8,54,2020,2020_04_MIA_SEA
ARI,2020-09-27,23,Sun,3,3,,DET,L 23-26,23,26,-3,49,2020,2020_03_ARI_DET
CIN,2020-09-27,23,Sun,3,3,@,PHI,T 23-23 (OT),23,23,0,46,2020,2020_03_CIN_PHI
PHI,2020-09-27,23,Sun,3,3,,CIN,T 23-23 (OT),23,23,0,46,2020,2020_03_PHI_CIN
KAN,2020-09-20,23,Sun,2,2,@,LAC,W 23-20 (OT),23,20,3,43,2020,2020_02_KAN_LAC
TAM,2020-09-13,23,Sun,1,1,@,NOR,L 23-34,23,34,-11,57,2020,2020_01_TAM_NOR
DET,2020-09-13,23,Sun,1,1,,CHI,L 23-27,23,27,-4,50,2020,2020_01_DET_CHI
CLE,2019-12-29,23,Sun,16,17,@,CIN,L 23-33,23,33,-10,56,2019,2019_17_CLE_CIN
GNB,2019-12-29,23,Sun,16,17,@,DET,W 23-20,23,20,3,43,2019,2019_17_GNB_DET
GNB,2019-12-23,23,Mon,15,16,@,MIN,W 23-10,23,10,13,33,2019,2019_16_GNB_MIN
HOU,2019-12-21,23,Sat,15,16,@,TAM,W 23-20,23,20,3,43,2019,2019_16_HOU_TAM
KAN,2019-12-15,23,Sun,14,15,,DEN,W 23-3,23,3,20,26,2019,2019_15_KAN_DEN
PHI,2019-12-09,23,Mon,13,14,,NYG,W 23-17 (OT),23,17,6,40,2019,2019_14_PHI_NYG
PIT,2019-12-08,23,Sun,13,14,@,ARI,W 23-17,23,17,6,40,2019,2019_14_PIT_ARI
KAN,2019-12-08,23,Sun,13,14,@,NWE,W 23-16,23,16,7,39,2019,2019_14_KAN_NWE
DEN,2019-12-01,23,Sun,12,13,,LAC,W 23-20,23,20,3,43,2019,2019_13_DEN_LAC
DEN,2019-11-17,23,Sun,10,11,@,MIN,L 23-27,23,27,-4,50,2019,2019_11_DEN_MIN
MIN,2019-11-03,23,Sun,9,9,@,KAN,L 23-26,23,26,-3,49,2019,2019_09_MIN_KAN
TAM,2019-10-27,23,Sun,7,8,@,TEN,L 23-27,23,27,-4,50,2019,2019_08_TAM_TEN
HOU,2019-10-20,23,Sun,7,7,@,IND,L 23-30,23,30,-7,53,2019,2019_07_HOU_IND
TEN,2019-10-20,23,Sun,7,7,,LAC,W 23-20,23,20,3,43,2019,2019_07_TEN_LAC
GNB,2019-10-14,23,Mon,6,6,,DET,W 23-22,23,22,1,45,2019,2019_06_GNB_DET
BAL,2019-10-13,23,Sun,6,6,,CIN,W 23-17,23,17,6,40,2019,2019_06_BAL_CIN
CIN,2019-10-06,23,Sun,5,5,,ARI,L 23-26,23,26,-3,49,2019,2019_05_CIN_ARI
PIT,2019-10-06,23,Sun,5,5,,BAL,L 23-26 (OT),23,26,-3,49,2019,2019_05_PIT_BAL
CLE,2019-09-16,23,Mon,2,2,@,NYJ,W 23-3,23,3,20,26,2019,2019_02_CLE_NYJ
BAL,2019-09-15,23,Sun,2,2,,ARI,W 23-17,23,17,6,40,2019,2019_02_BAL_ARI
LAC,2018-12-30,23,Sun,16,17,@,DEN,W 23-9,23,9,14,32,2018,2018_17_LAC_DEN
IND,2018-12-16,23,Sun,14,15,,DAL,W 23-0,23,0,23,23,2018,2018_15_IND_DAL
LAR,2018-12-16,23,Sun,14,15,,PHI,L 23-30,23,30,-7,53,2018,2018_15_LAR_PHI
SEA,2018-12-16,23,Sun,14,15,@,SFO,L 23-26 (OT),23,26,-3,49,2018,2018_15_SEA_SFO
PHI,2018-12-09,23,Sun,13,14,@,DAL,L 23-29 (OT),23,29,-6,52,2018,2018_14_PHI_DAL
BUF,2018-12-09,23,Sun,13,14,,NYJ,L 23-27,23,27,-4,50,2018,2018_14_BUF_NYJ
WAS,2018-11-22,23,Thu,11,12,@,DAL,L 23-31,23,31,-8,54,2018,2018_12_WAS_DAL
CHI,2018-11-22,23,Thu,11,12,@,DET,W 23-16,23,16,7,39,2018,2018_12_CHI_DET
OAK,2018-11-18,23,Sun,10,11,@,ARI,W 23-21,23,21,2,44,2018,2018_11_OAK_ARI
DEN,2018-11-18,23,Sun,10,11,@,LAC,W 23-22,23,22,1,45,2018,2018_11_DEN_LAC
HOU,2018-11-18,23,Sun,10,11,@,WAS,W 23-21,23,21,2,44,2018,2018_11_HOU_WAS
SFO,2018-11-12,23,Mon,10,10,,NYG,L 23-27,23,27,-4,50,2018,2018_10_SFO_NYG
PIT,2018-11-04,23,Sun,8,9,@,BAL,W 23-16,23,16,7,39,2018,2018_09_PIT_BAL
DEN,2018-10-28,23,Sun,8,8,@,KAN,L 23-30,23,30,-7,53,2018,2018_08_DEN_KAN
MIA,2018-10-25,23,Thu,8,8,@,HOU,L 23-42,23,42,-19,65,2018,2018_08_MIA_HOU
ATL,2018-10-22,23,Mon,7,7,,NYG,W 23-20,23,20,3,43,2018,2018_07_ATL_NYG
BAL,2018-10-21,23,Sun,7,7,,NOR,L 23-24,23,24,-1,47,2018,2018_07_BAL_NOR
CLE,2018-10-21,23,Sun,7,7,@,TAM,L 23-26 (OT),23,26,-3,49,2018,2018_07_CLE_TAM
WAS,2018-10-14,23,Sun,5,6,,CAR,W 23-17,23,17,6,40,2018,2018_06_WAS_CAR
LAR,2018-10-14,23,Sun,6,6,@,DEN,W 23-20,23,20,3,43,2018,2018_06_LAR_DEN
GNB,2018-10-07,23,Sun,5,5,@,DET,L 23-31,23,31,-8,54,2018,2018_05_GNB_DET
MIN,2018-10-07,23,Sun,5,5,@,PHI,W 23-21,23,21,2,44,2018,2018_05_MIN_PHI
DEN,2018-10-01,23,Mon,4,4,,KAN,L 23-27,23,27,-4,50,2018,2018_04_DEN_KAN
PHI,2018-09-30,23,Sun,4,4,@,TEN,L 23-26 (OT),23,26,-3,49,2018,2018_04_PHI_TEN
LAC,2018-09-23,23,Sun,3,3,@,LAR,L 23-35,23,35,-12,58,2018,2018_03_LAC_LAR
BAL,2018-09-13,23,Thu,2,2,@,CIN,L 23-34,23,34,-11,57,2018,2018_02_BAL_CIN
IND,2018-09-09,23,Sun,1,1,,CIN,L 23-34,23,34,-11,57,2018,2018_01_IND_CIN
CHI,2018-09-09,23,Sun,1,1,@,GNB,L 23-24,23,24,-1,47,2018,2018_01_CHI_GNB
MIN,2017-12-31,23,Sun,16,17,,CHI,W 23-10,23,10,13,33,2017,2017_17_MIN_CHI
NOR,2017-12-24,23,Sun,15,16,,ATL,W 23-13,23,13,10,36,2017,2017_16_NOR_ATL
NOR,2017-12-24,23,Sun,15,16,,ATL,W 23-13,23,13,10,36,2017,2017_16_NOR_ATL
ARI,2017-12-24,23,Sun,15,16,,NYG,W 23-0,23,0,23,23,2017,2017_16_ARI_NYG
BAL,2017-12-23,23,Sat,15,16,,IND,W 23-16,23,16,7,39,2017,2017_16_BAL_IND
TEN,2017-12-17,23,Sun,14,15,@,SFO,L 23-25,23,25,-2,48,2017,2017_15_TEN_SFO
DEN,2017-12-10,23,Sun,13,14,,NYJ,W 23-0,23,0,23,23,2017,2017_14_DEN_NYJ
PIT,2017-12-04,23,Mon,12,13,@,CIN,W 23-20,23,20,3,43,2017,2017_13_PIT_CIN
NWE,2017-12-03,23,Sun,12,13,@,BUF,W 23-3,23,3,20,26,2017,2017_13_NWE_BUF
BAL,2017-11-27,23,Mon,11,12,,HOU,W 23-16,23,16,7,39,2017,2017_12_BAL_HOU
DET,2017-11-23,23,Thu,11,12,,MIN,L 23-30,23,30,-7,53,2017,2017_12_DET_MIN
BAL,2017-11-19,23,Sun,10,11,@,GNB,W 23-0,23,0,23,23,2017,2017_11_BAL_GNB
GNB,2017-11-12,23,Sun,9,10,@,CHI,W 23-16,23,16,7,39,2017,2017_10_GNB_CHI
JAX,2017-11-05,23,Sun,8,9,,CIN,W 23-7,23,7,16,30,2017,2017_09_JAX_CIN
TEN,2017-11-05,23,Sun,8,9,,BAL,W 23-20,23,20,3,43,2017,2017_09_TEN_BAL
DEN,2017-11-05,23,Sun,8,9,@,PHI,L 23-51,23,51,-28,74,2017,2017_09_DEN_PHI
IND,2017-10-29,23,Sun,8,8,@,CIN,L 23-24,23,24,-1,47,2017,2017_08_IND_CIN
NWE,2017-10-22,23,Sun,7,7,,ATL,W 23-7,23,7,16,30,2017,2017_07_NWE_ATL
NYG,2017-10-15,23,Sun,6,6,@,DEN,W 23-10,23,10,13,33,2017,2017_06_NYG_DEN
MIN,2017-10-15,23,Sun,6,6,,GNB,W 23-10,23,10,13,33,2017,2017_06_MIN_GNB
CAR,2017-10-12,23,Thu,6,6,,PHI,L 23-28,23,28,-5,51,2017,2017_06_CAR_PHI
SFO,2017-10-08,23,Sun,5,5,@,IND,L 23-26 (OT),23,26,-3,49,2017,2017_05_SFO_IND
BUF,2017-10-01,23,Sun,4,4,@,ATL,W 23-17,23,17,6,40,2017,2017_04_BUF_ATL
NYJ,2017-10-01,23,Sun,4,4,,JAX,W 23-20 (OT),23,20,3,43,2017,2017_04_NYJ_JAX
NYG,2017-10-01,23,Sun,4,4,@,TAM,L 23-25,23,25,-2,48,2017,2017_04_NYG_TAM
CHI,2017-09-24,23,Sun,3,3,,PIT,W 23-17 (OT),23,17,6,40,2017,2017_03_CHI_PIT
GNB,2017-09-17,23,Sun,2,2,@,ATL,L 23-34,23,34,-11,57,2017,2017_02_GNB_ATL
ARI,2017-09-10,23,Sun,1,1,@,DET,L 23-35,23,35,-12,58,2017,2017_01_ARI_DET
CAR,2017-09-10,23,Sun,1,1,@,SFO,W 23-3,23,3,20,26,2017,2017_01_CAR_SFO
ATL,2017-09-10,23,Sun,1,1,@,CHI,W 23-17,23,17,6,40,2017,2017_01_ATL_CHI
PHI,2023-01-08,22,Sun,17,18,,NYG,W 22-16,22,16,6,38,2022,2022_18_PHI_NYG
CIN,2022-12-24,22,Sat,15,16,@,NWE,W 22-18,22,18,4,40,2022,2022_16_CIN_NWE
TEN,2022-12-11,22,Sun,13,14,,JAX,L 22-36,22,36,-14,58,2022,2022_14_TEN_JAX
NYG,2022-12-11,22,Sun,13,14,,PHI,L 22-48,22,48,-26,70,2022,2022_14_NYG_PHI
NYJ,2022-12-04,22,Sun,12,13,@,MIN,L 22-27,22,27,-5,49,2022,2022_13_NYJ_MIN
LVR,2022-11-20,22,Sun,10,11,@,DEN,W 22-16 (OT),22,16,6,38,2022,2022_11_LVR_DEN
SFO,2022-11-13,22,Sun,9,10,,LAC,W 22-16,22,16,6,38,2022,2022_10_SFO_LAC
NWE,2022-10-30,22,Sun,8,8,@,NYJ,W 22-17,22,17,5,39,2022,2022_08_NWE_NYJ
TAM,2022-10-27,22,Thu,8,8,,BAL,L 22-27,22,27,-5,49,2022,2022_08_TAM_BAL
DAL,2022-10-09,22,Sun,5,5,@,LAR,W 22-10,22,10,12,32,2022,2022_05_DAL_LAR
GNB,2022-10-09,22,Sun,5,5,,NYG,L 22-27,22,27,-5,49,2022,2022_05_GNB_NYG
CHI,2022-10-09,22,Sun,5,5,@,MIN,L 22-29,22,29,-7,51,2022,2022_05_CHI_MIN
LVR,2022-09-25,22,Sun,3,3,@,TEN,L 22-24,22,24,-2,46,2022,2022_03_LVR_TEN
CAR,2022-09-25,22,Sun,3,3,,NOR,W 22-14,22,14,8,36,2022,2022_03_CAR_NOR
JAX,2022-09-11,22,Sun,1,1,@,WAS,L 22-28,22,28,-6,50,2022,2022_01_JAX_WAS
WAS,2022-01-09,22,Sun,17,18,@,NYG,W 22-7,22,7,15,29,2021,2021_18_WAS_NYG
DAL,2022-01-02,22,Sun,16,17,,ARI,L 22-25,22,25,-3,47,2021,2021_17_DAL_ARI
CLE,2021-12-25,22,Sat,15,16,@,GNB,L 22-24,22,24,-2,46,2021,2021_16_CLE_GNB
IND,2021-12-25,22,Sat,15,16,@,ARI,W 22-16,22,16,6,38,2021,2021_16_IND_ARI
BAL,2021-12-12,22,Sun,13,14,@,CLE,L 22-24,22,24,-2,46,2021,2021_14_BAL_CLE
CIN,2021-12-05,22,Sun,12,13,,LAC,L 22-41,22,41,-19,63,2021,2021_13_CIN_LAC
KAN,2021-12-05,22,Sun,12,13,,DEN,W 22-9,22,9,13,31,2021,2021_13_KAN_DEN
CHI,2021-12-05,22,Sun,12,13,,ARI,L 22-33,22,33,-11,55,2021,2021_13_CHI_ARI
HOU,2021-11-21,22,Sun,10,11,@,TEN,W 22-13,22,13,9,35,2021,2021_11_HOU_TEN
MIA,2021-11-11,22,Thu,10,10,,BAL,W 22-10,22,10,12,32,2021,2021_10_MIA_BAL
CHI,2021-10-31,22,Sun,8,8,,SFO,L 22-33,22,33,-11,55,2021,2021_08_CHI_SFO
HOU,2021-10-31,22,Sun,8,8,,LAR,L 22-38,22,38,-16,60,2021,2021_08_HOU_LAR
PHI,2021-10-24,22,Sun,7,7,@,LVR,L 22-33,22,33,-11,55,2021,2021_07_PHI_LVR
PHI,2021-10-14,22,Thu,6,6,,TAM,L 22-28,22,28,-6,50,2021,2021_06_PHI_TAM
CIN,2021-10-10,22,Sun,5,5,,GNB,L 22-25 (OT),22,25,-3,47,2021,2021_05_CIN_GNB
WAS,2021-10-10,22,Sun,5,5,,NOR,L 22-33,22,33,-11,55,2021,2021_05_WAS_NOR
HOU,2021-10-10,22,Sun,5,5,,NWE,L 22-25,22,25,-3,47,2021,2021_05_HOU_NWE
PIT,2021-01-03,22,Sun,16,17,@,CLE,L 22-24,22,24,-2,46,2020,2020_17_PIT_CLE
MIA,2020-12-20,22,Sun,14,15,,NWE,W 22-12,22,12,10,34,2020,2020_15_MIA_NWE
KAN,2020-12-06,22,Sun,12,13,,DEN,W 22-16,22,16,6,38,2020,2020_13_KAN_DEN
CLE,2020-11-22,22,Sun,10,11,,PHI,W 22-17,22,17,5,39,2020,2020_11_CLE_PHI
GNB,2020-11-01,22,Sun,7,8,,MIN,L 22-28,22,28,-6,50,2020,2020_08_GNB_MIN
ATL,2020-10-25,22,Sun,7,7,,DET,L 22-23,22,23,-1,45,2020,2020_07_ATL_DET
PHI,2020-10-22,22,Thu,7,7,,NYG,W 22-21,22,21,1,43,2020,2020_07_PHI_NYG
TAM,2019-12-29,22,Sun,16,17,,ATL,L 22-28 (OT),22,28,-6,50,2019,2019_17_TAM_ATL
SFO,2019-12-15,22,Sun,14,15,,ATL,L 22-29,22,29,-7,51,2019,2019_15_SFO_ATL
NYJ,2019-12-08,22,Sun,13,14,,MIA,W 22-21,22,21,1,43,2019,2019_14_NYJ_MIA
CIN,2019-12-01,22,Sun,12,13,,NYJ,W 22-6,22,6,16,28,2019,2019_13_CIN_NYJ
NWE,2019-12-01,22,Sun,12,13,@,HOU,L 22-28,22,28,-6,50,2019,2019_13_NWE_HOU
ATL,2019-11-24,22,Sun,11,12,,TAM,L 22-35,22,35,-13,57,2019,2019_12_ATL_TAM
PHI,2019-11-03,22,Sun,9,9,,CHI,W 22-14,22,14,8,36,2019,2019_09_PHI_CHI
DET,2019-10-14,22,Mon,5,6,@,GNB,L 22-23,22,23,-1,45,2019,2019_06_DET_GNB
DAL,2019-10-13,22,Sun,6,6,@,NYJ,L 22-24,22,24,-2,46,2019,2019_06_DAL_NYJ
BAL,2018-12-22,22,Sat,15,16,@,LAC,W 22-10,22,10,12,32,2018,2018_16_BAL_LAC
NYJ,2018-12-15,22,Sat,14,15,,HOU,L 22-29,22,29,-7,51,2018,2018_15_NYJ_HOU
NYJ,2018-12-02,22,Sun,12,13,@,TEN,L 22-26,22,26,-4,48,2018,2018_13_NYJ_TEN
NYG,2018-11-25,22,Sun,11,12,@,PHI,L 22-25,22,25,-3,47,2018,2018_12_NYG_PHI
LAC,2018-11-18,22,Sun,10,11,,DEN,L 22-23,22,23,-1,45,2018,2018_11_LAC_DEN
DAL,2018-11-18,22,Sun,10,11,@,ATL,W 22-19,22,19,3,41,2018,2018_11_DAL_ATL
DET,2018-11-11,22,Sun,9,10,@,CHI,L 22-34,22,34,-12,56,2018,2018_10_DET_CHI
GNB,2018-09-30,22,Sun,4,4,,BUF,W 22-0,22,0,22,22,2018,2018_04_GNB_BUF
HOU,2018-09-23,22,Sun,3,3,,NYG,L 22-27,22,27,-5,49,2018,2018_03_HOU_NYG
ATL,2017-12-31,22,Sun,16,17,,CAR,W 22-10,22,10,12,32,2017,2017_17_ATL_CAR
IND,2017-12-31,22,Sun,16,17,,HOU,W 22-13,22,13,9,35,2017,2017_17_IND_HOU
BUF,2017-12-31,22,Sun,16,17,@,MIA,W 22-16,22,16,6,38,2017,2017_17_BUF_MIA
CAR,2017-12-24,22,Sun,15,16,,TAM,W 22-19,22,19,3,41,2017,2017_16_CAR_TAM
SEA,2017-11-09,22,Thu,9,10,@,ARI,W 22-16,22,16,6,38,2017,2017_10_SEA_ARI
IND,2017-10-16,22,Mon,6,6,@,TEN,L 22-36,22,36,-14,58,2017,2017_06_IND_TEN
NYG,2017-10-08,22,Sun,5,5,,LAC,L 22-27,22,27,-5,49,2017,2017_05_NYG_LAC
MIA,2023-01-01,21,Sun,16,17,@,NWE,L 21-23,21,23,-2,44,2022,2022_17_MIA_NWE
NOR,2022-12-18,21,Sun,14,15,,ATL,W 21-18,21,18,3,39,2022,2022_15_NOR_ATL
SFO,2022-12-15,21,Thu,14,15,@,SEA,W 21-13,21,13,8,34,2022,2022_15_SFO_SEA
PHI,2022-11-14,21,Mon,9,10,,WAS,L 21-32,21,32,-11,53,2022,2022_10_PHI_WAS
TAM,2022-11-13,21,Sun,10,10,,SEA,W 21-16,21,16,5,37,2022,2022_10_TAM_SEA
CAR,2022-11-06,21,Sun,9,9,@,CIN,L 21-42,21,42,-21,63,2022,2022_09_CAR_CIN
ARI,2022-11-06,21,Sun,9,9,,SEA,L 21-31,21,31,-10,52,2022,2022_09_ARI_SEA
DEN,2022-10-30,21,Sun,8,8,@,JAX,W 21-17,21,17,4,38,2022,2022_08_DEN_JAX
CAR,2022-10-23,21,Sun,7,7,,TAM,W 21-3,21,3,18,24,2022,2022_07_CAR_TAM
GNB,2022-10-23,21,Sun,7,7,@,WAS,L 21-23,21,23,-2,44,2022,2022_07_GNB_WAS
TAM,2022-10-09,21,Sun,5,5,,ATL,W 21-15,21,15,6,36,2022,2022_05_TAM_ATL
TEN,2022-10-09,21,Sun,5,5,@,WAS,W 21-17,21,17,4,38,2022,2022_05_TEN_WAS
JAX,2022-10-02,21,Sun,4,4,@,PHI,L 21-29,21,29,-8,50,2022,2022_04_JAX_PHI
MIA,2022-09-25,21,Sun,3,3,,BUF,W 21-19,21,19,2,40,2022,2022_03_MIA_BUF
NYG,2022-09-11,21,Sun,1,1,@,TEN,W 21-20,21,20,1,41,2022,2022_01_NYG_TEN
ARI,2022-09-11,21,Sun,1,1,,KAN,L 21-44,21,44,-23,65,2022,2022_01_ARI_KAN
CLE,2022-01-09,21,Sun,17,18,,CIN,W 21-16,21,16,5,37,2021,2021_18_CLE_CIN
JAX,2021-12-26,21,Sun,15,16,@,NYJ,L 21-26,21,26,-5,47,2021,2021_16_JAX_NYJ
NWE,2021-12-26,21,Sun,15,16,,BUF,L 21-33,21,33,-12,54,2021,2021_16_NWE_BUF
BAL,2021-12-26,21,Sun,15,16,@,CIN,L 21-41,21,41,-20,62,2021,2021_16_BAL_CIN
DAL,2021-12-19,21,Sun,14,15,@,NYG,W 21-6,21,6,15,27,2021,2021_15_DAL_NYG
NYG,2021-12-12,21,Sun,13,14,@,LAC,L 21-37,21,37,-16,58,2021,2021_14_NYG_LAC
CAR,2021-12-12,21,Sun,13,14,,ATL,L 21-29,21,29,-8,50,2021,2021_14_CAR_ATL
NYJ,2021-11-28,21,Sun,11,12,@,HOU,W 21-14,21,14,7,35,2021,2021_12_NYJ_HOU
ATL,2021-11-28,21,Sun,11,12,@,JAX,W 21-14,21,14,7,35,2021,2021_12_ATL_JAX
CAR,2021-11-21,21,Sun,11,11,,WAS,L 21-27,21,27,-6,48,2021,2021_11_CAR_WAS
NOR,2021-11-14,21,Sun,9,10,@,TEN,L 21-23,21,23,-2,44,2021,2021_10_NOR_TEN
ARI,2021-10-28,21,Thu,8,8,,GNB,L 21-24,21,24,-3,45,2021,2021_08_ARI_GNB
PHI,2021-10-10,21,Sun,5,5,@,CAR,W 21-18,21,18,3,39,2021,2021_05_PHI_CAR
SFO,2021-10-03,21,Sun,4,4,,SEA,L 21-28,21,28,-7,49,2021,2021_04_SFO_SEA
NOR,2021-10-03,21,Sun,4,4,,NYG,L 21-27 (OT),21,27,-6,48,2021,2021_04_NOR_NYG
JAX,2021-09-30,21,Thu,4,4,@,CIN,L 21-24,21,24,-3,45,2021,2021_04_JAX_CIN
PHI,2021-09-27,21,Mon,3,3,@,DAL,L 21-41,21,41,-20,62,2021,2021_03_PHI_DAL
WAS,2021-09-26,21,Sun,3,3,@,BUF,L 21-43,21,43,-22,64,2021,2021_03_WAS_BUF
HOU,2021-09-19,21,Sun,2,2,@,CLE,L 21-31,21,31,-10,52,2021,2021_02_HOU_CLE
JAX,2021-09-12,21,Sun,1,1,@,HOU,L 21-37,21,37,-16,58,2021,2021_01_JAX_HOU
KAN,2021-01-03,21,Sun,16,17,,LAC,L 21-38,21,38,-17,59,2020,2020_17_KAN_LAC
NOR,2020-12-13,21,Sun,13,14,@,PHI,L 21-24,21,24,-3,45,2020,2020_14_NOR_PHI
NOR,2020-12-06,21,Sun,12,13,@,ATL,W 21-16,21,16,5,37,2020,2020_13_NOR_ATL
ARI,2020-11-19,21,Thu,10,11,@,SEA,L 21-28,21,28,-7,49,2020,2020_11_ARI_SEA
LAC,2020-11-15,21,Sun,9,10,@,MIA,L 21-29,21,29,-8,50,2020,2020_10_LAC_MIA
DET,2020-11-01,21,Sun,7,8,,IND,L 21-41,21,41,-20,62,2020,2020_08_DET_IND
NWE,2020-11-01,21,Sun,7,8,@,BUF,L 21-24,21,24,-3,45,2020,2020_08_NWE_BUF
NYG,2020-10-22,21,Thu,7,7,@,PHI,L 21-22,21,22,-1,43,2020,2020_07_NYG_PHI
ARI,2020-10-04,21,Sun,4,4,@,CAR,L 21-31,21,31,-10,52,2020,2020_04_ARI_CAR
HOU,2020-09-27,21,Sun,3,3,@,PIT,L 21-28,21,28,-7,49,2020,2020_03_HOU_PIT
CAR,2020-09-27,21,Sun,3,3,@,LAC,W 21-16,21,16,5,37,2020,2020_03_CAR_LAC
DET,2020-09-20,21,Sun,2,2,@,GNB,L 21-42,21,42,-21,63,2020,2020_02_DET_GNB
DEN,2020-09-20,21,Sun,2,2,@,PIT,L 21-26,21,26,-5,47,2020,2020_02_DEN_PIT
NWE,2020-09-13,21,Sun,1,1,,MIA,W 21-11,21,11,10,32,2020,2020_01_NWE_MIA
SEA,2019-12-29,21,Sun,16,17,,SFO,L 21-26,21,26,-5,47,2019,2019_17_SEA_SFO
LAC,2019-12-29,21,Sun,16,17,@,KAN,L 21-31,21,31,-10,52,2019,2019_17_LAC_KAN
CHI,2019-12-29,21,Sun,16,17,@,MIN,W 21-19,21,19,2,40,2019,2019_17_CHI_MIN
GNB,2019-12-15,21,Sun,14,15,,CHI,W 21-13,21,13,8,34,2019,2019_15_GNB_CHI
TEN,2019-12-15,21,Sun,14,15,,HOU,L 21-24,21,24,-3,45,2019,2019_15_TEN_HOU
LAR,2019-12-15,21,Sun,14,15,@,DAL,L 21-44,21,44,-23,65,2019,2019_15_LAR_DAL
NYJ,2019-12-12,21,Thu,14,15,@,BAL,L 21-42,21,42,-21,63,2019,2019_15_NYJ_BAL
MIA,2019-12-08,21,Sun,13,14,@,NYJ,L 21-22,21,22,-1,43,2019,2019_14_MIA_NYJ
OAK,2019-12-08,21,Sun,13,14,,TEN,L 21-42,21,42,-21,63,2019,2019_14_OAK_TEN
CAR,2019-12-01,21,Sun,12,13,,WAS,L 21-29,21,29,-8,50,2019,2019_13_CAR_WAS
CLE,2019-11-14,21,Thu,10,11,,PIT,W 21-7,21,7,14,28,2019,2019_11_CLE_PIT
MIA,2019-10-20,21,Sun,6,7,@,BUF,L 21-31,21,31,-10,52,2019,2019_07_MIA_BUF
NYG,2019-10-20,21,Sun,7,7,,ARI,L 21-27,21,27,-6,48,2019,2019_07_NYG_ARI
CHI,2019-10-06,21,Sun,5,5,@,OAK,L 21-24,21,24,-3,45,2019,2019_05_CHI_OAK
BUF,2019-09-22,21,Sun,3,3,,CIN,W 21-17,21,17,4,38,2019,2019_03_BUF_CIN
WAS,2019-09-15,21,Sun,2,2,,DAL,L 21-31,21,31,-10,52,2019,2019_02_WAS_DAL
GNB,2019-09-15,21,Sun,2,2,,MIN,W 21-16,21,16,5,37,2019,2019_02_GNB_MIN
SEA,2019-09-08,21,Sun,1,1,,CIN,W 21-20,21,20,1,41,2019,2019_01_SEA_CIN
SEA,2018-12-10,21,Mon,13,14,,MIN,W 21-7,21,7,14,28,2018,2018_14_SEA_MIN
HOU,2018-12-09,21,Sun,13,14,,IND,L 21-24,21,24,-3,45,2018,2018_14_HOU_IND
PIT,2018-12-09,21,Sun,13,14,@,OAK,L 21-24,21,24,-3,45,2018,2018_14_PIT_OAK
CIN,2018-12-09,21,Sun,13,14,@,LAC,L 21-26,21,26,-5,47,2018,2018_14_CIN_LAC
MIA,2018-12-02,21,Sun,12,13,,BUF,W 21-17,21,17,4,38,2018,2018_13_MIA_BUF
JAX,2018-11-25,21,Sun,11,12,@,BUF,L 21-24,21,24,-3,45,2018,2018_12_JAX_BUF
CIN,2018-11-18,21,Sun,10,11,@,BAL,L 21-24,21,24,-3,45,2018,2018_11_CIN_BAL
ARI,2018-11-18,21,Sun,10,11,,OAK,L 21-23,21,23,-2,44,2018,2018_11_ARI_OAK
WAS,2018-11-18,21,Sun,10,11,,HOU,L 21-23,21,23,-2,44,2018,2018_11_WAS_HOU
CAR,2018-11-08,21,Thu,9,10,@,PIT,L 21-52,21,52,-31,73,2018,2018_10_CAR_PIT
CLE,2018-11-04,21,Sun,9,9,,KAN,L 21-37,21,37,-16,58,2018,2018_09_CLE_KAN
BAL,2018-10-28,21,Sun,8,8,@,CAR,L 21-36,21,36,-15,57,2018,2018_08_BAL_CAR
MIA,2018-10-21,21,Sun,7,7,,DET,L 21-32,21,32,-11,53,2018,2018_07_MIA_DET
CAR,2018-10-21,21,Sun,6,7,@,PHI,W 21-17,21,17,4,38,2018,2018_07_CAR_PHI
BAL,2018-10-14,21,Sun,6,6,@,TEN,W 21-0,21,0,21,21,2018,2018_06_BAL_TEN
CIN,2018-10-14,21,Sun,6,6,,PIT,L 21-28,21,28,-7,49,2018,2018_06_CIN_PIT
PHI,2018-10-07,21,Sun,5,5,,MIN,L 21-23,21,23,-2,44,2018,2018_05_PHI_MIN
CIN,2018-09-23,21,Sun,3,3,@,CAR,L 21-31,21,31,-10,52,2018,2018_03_CIN_CAR
CLE,2018-09-20,21,Thu,3,3,,NYJ,W 21-17,21,17,4,38,2018,2018_03_CLE_NYJ
IND,2018-09-16,21,Sun,2,2,@,WAS,W 21-9,21,9,12,30,2018,2018_02_IND_WAS
PHI,2018-09-16,21,Sun,2,2,@,TAM,L 21-27,21,27,-6,48,2018,2018_02_PHI_TAM
NOR,2018-09-16,21,Sun,2,2,,CLE,W 21-18,21,18,3,39,2018,2018_02_NOR_CLE
CLE,2018-09-09,21,Sun,1,1,,PIT,T 21-21 (OT),21,21,0,42,2018,2018_01_CLE_PIT
PIT,2018-09-09,21,Sun,1,1,@,CLE,T 21-21 (OT),21,21,0,42,2018,2018_01_PIT_CLE
SEA,2017-12-24,21,Sun,15,16,@,DAL,W 21-12,21,12,9,33,2017,2017_16_SEA_DAL
TAM,2017-12-18,21,Mon,14,15,,ATL,L 21-24,21,24,-3,45,2017,2017_15_TAM_ATL
TAM,2017-12-10,21,Sun,13,14,,DET,L 21-24,21,24,-3,45,2017,2017_14_TAM_DET
CLE,2017-12-10,21,Sun,13,14,,GNB,L 21-27 (OT),21,27,-6,48,2017,2017_14_CLE_GNB
CAR,2017-12-03,21,Sun,12,13,@,NOR,L 21-31,21,31,-10,52,2017,2017_13_CAR_NOR
OAK,2017-11-26,21,Sun,11,12,,DEN,W 21-14,21,14,7,35,2017,2017_12_OAK_DEN
ARI,2017-11-19,21,Sun,10,11,@,HOU,L 21-31,21,31,-10,52,2017,2017_11_ARI_HOU
MIA,2017-11-13,21,Mon,9,10,@,CAR,L 21-45,21,45,-24,66,2017,2017_10_MIA_CAR
NYG,2017-11-12,21,Sun,9,10,@,SFO,L 21-31,21,31,-10,52,2017,2017_10_NYG_SFO
BUF,2017-11-02,21,Thu,8,9,@,NYJ,L 21-34,21,34,-13,55,2017,2017_09_BUF_NYJ
NWE,2017-10-29,21,Sun,8,8,,LAC,W 21-13,21,13,8,34,2017,2017_08_NWE_LAC
LAC,2017-10-22,21,Sun,7,7,,DEN,W 21-0,21,0,21,21,2017,2017_07_LAC_DEN
LAC,2017-09-11,21,Mon,1,1,@,DEN,L 21-24,21,24,-3,45,2017,2017_01_LAC_DEN
PIT,2017-09-10,21,Sun,1,1,@,CLE,W 21-18,21,18,3,39,2017,2017_01_PIT_CLE
BUF,2017-09-10,21,Sun,1,1,,NYJ,W 21-12,21,12,9,33,2017,2017_01_BUF_NYJ
DET,2023-01-08,20,Sun,17,18,@,GNB,W 20-16,20,16,4,36,2022,2022_18_DET_GNB
JAX,2023-01-07,20,Sat,17,18,,TEN,W 20-16,20,16,4,36,2022,2022_18_JAX_TEN
ATL,2023-01-01,20,Sun,16,17,,ARI,W 20-19,20,19,1,39,2022,2022_17_ATL_ARI
NOR,2023-01-01,20,Sun,16,17,@,PHI,W 20-10,20,10,10,30,2022,2022_17_NOR_PHI
LAC,2022-12-26,20,Mon,15,16,@,IND,W 20-3,20,3,17,23,2022,2022_16_LAC_IND
MIA,2022-12-25,20,Sun,15,16,,GNB,L 20-26,20,26,-6,46,2022,2022_16_MIA_GNB
WAS,2022-12-24,20,Sat,15,16,@,SFO,L 20-37,20,37,-17,57,2022,2022_16_WAS_SFO
DET,2022-12-18,20,Sun,14,15,@,NYJ,W 20-17,20,17,3,37,2022,2022_15_DET_NYJ
CHI,2022-12-18,20,Sun,14,15,,PHI,L 20-25,20,25,-5,45,2022,2022_15_CHI_PHI
NYG,2022-12-18,20,Sun,14,15,@,WAS,W 20-12,20,12,8,32,2022,2022_15_NYG_WAS
BUF,2022-12-11,20,Sun,13,14,,NYJ,W 20-12,20,12,8,32,2022,2022_14_BUF_NYJ
WAS,2022-12-04,20,Sun,13,13,@,NYG,T 20-20 (OT),20,20,0,40,2022,2022_13_WAS_NYG
LAC,2022-12-04,20,Sun,12,13,@,LVR,L 20-27,20,27,-7,47,2022,2022_13_LAC_LVR
NYG,2022-12-04,20,Sun,12,13,,WAS,T 20-20 (OT),20,20,0,40,2022,2022_13_NYG_WAS
CIN,2022-11-27,20,Sun,11,12,@,TEN,W 20-16,20,16,4,36,2022,2022_12_CIN_TEN
NYG,2022-11-24,20,Thu,11,12,@,DAL,L 20-28,20,28,-8,48,2022,2022_12_NYG_DAL
LAR,2022-11-20,20,Sun,10,11,@,NOR,L 20-27,20,27,-7,47,2022,2022_11_LAR_NOR
LVR,2022-11-13,20,Sun,9,10,,IND,L 20-25,20,25,-5,45,2022,2022_10_LVR_IND
PIT,2022-11-13,20,Sun,9,10,,NOR,W 20-10,20,10,10,30,2022,2022_10_PIT_NOR
LAC,2022-11-06,20,Sun,8,9,@,ATL,W 20-17,20,17,3,37,2022,2022_09_LAC_ATL
NYJ,2022-11-06,20,Sun,9,9,,BUF,W 20-17,20,17,3,37,2022,2022_09_NYJ_BUF
LVR,2022-11-06,20,Sun,8,9,@,JAX,L 20-27,20,27,-7,47,2022,2022_09_LVR_JAX
KAN,2022-11-06,20,Sun,8,9,,TEN,W 20-17 (OT),20,17,3,37,2022,2022_09_KAN_TEN
MIN,2022-11-06,20,Sun,8,9,@,WAS,W 20-17,20,17,3,37,2022,2022_09_MIN_WAS
HOU,2022-10-23,20,Sun,6,7,@,LVR,L 20-38,20,38,-18,58,2022,2022_07_HOU_LVR
CLE,2022-10-23,20,Sun,7,7,@,BAL,L 20-23,20,23,-3,43,2022,2022_07_CLE_BAL
KAN,2022-10-16,20,Sun,6,6,,BUF,L 20-24,20,24,-4,44,2022,2022_06_KAN_BUF
BAL,2022-10-16,20,Sun,6,6,@,NYG,L 20-24,20,24,-4,44,2022,2022_06_BAL_NYG
PIT,2022-10-16,20,Sun,6,6,,TAM,W 20-18,20,18,2,38,2022,2022_06_PIT_TAM
PHI,2022-10-09,20,Sun,5,5,@,ARI,W 20-17,20,17,3,37,2022,2022_05_PHI_ARI
CLE,2022-10-02,20,Sun,4,4,@,ATL,L 20-23,20,23,-3,43,2022,2022_04_CLE_ATL
BAL,2022-10-02,20,Sun,4,4,,BUF,L 20-23,20,23,-3,43,2022,2022_04_BAL_BUF
NYG,2022-10-02,20,Sun,4,4,,CHI,W 20-12,20,12,8,32,2022,2022_04_NYG_CHI
PIT,2022-10-02,20,Sun,4,4,,NYJ,L 20-24,20,24,-4,44,2022,2022_04_PIT_NYJ
HOU,2022-09-25,20,Sun,3,3,@,CHI,L 20-23,20,23,-3,43,2022,2022_03_HOU_CHI
LAR,2022-09-25,20,Sun,3,3,@,ARI,W 20-12,20,12,8,32,2022,2022_03_LAR_ARI
IND,2022-09-25,20,Sun,3,3,,KAN,W 20-17,20,17,3,37,2022,2022_03_IND_KAN
DAL,2022-09-18,20,Sun,2,2,,CIN,W 20-17,20,17,3,37,2022,2022_02_DAL_CIN
TAM,2022-09-18,20,Sun,2,2,@,NOR,W 20-10,20,10,10,30,2022,2022_02_TAM_NOR
HOU,2022-09-11,20,Sun,1,1,,IND,T 20-20 (OT),20,20,0,40,2022,2022_01_HOU_IND
IND,2022-09-11,20,Sun,1,1,@,HOU,T 20-20 (OT),20,20,0,40,2022,2022_01_IND_HOU
MIA,2022-09-11,20,Sun,1,1,,NWE,W 20-7,20,7,13,27,2022,2022_01_MIA_NWE
TEN,2022-09-11,20,Sun,1,1,,NYG,L 20-21,20,21,-1,41,2022,2022_01_TEN_NYG
CIN,2022-09-11,20,Sun,1,1,,PIT,L 20-23 (OT),20,23,-3,43,2022,2022_01_CIN_PIT
ATL,2022-01-09,20,Sun,17,18,,NOR,L 20-30,20,30,-10,50,2021,2021_18_ATL_NOR
IND,2022-01-02,20,Sun,16,17,,LVR,L 20-23,20,23,-3,43,2021,2021_17_IND_LVR
LAR,2022-01-02,20,Sun,16,17,@,BAL,W 20-19,20,19,1,39,2021,2021_17_LAR_BAL
PHI,2022-01-02,20,Sun,16,17,@,WAS,W 20-16,20,16,4,36,2021,2021_17_PHI_WAS
MIA,2021-12-27,20,Mon,15,16,@,NOR,W 20-3,20,3,17,23,2021,2021_16_MIA_NOR
ATL,2021-12-26,20,Sun,15,16,,DET,W 20-16,20,16,4,36,2021,2021_16_ATL_DET
TEN,2021-12-23,20,Thu,15,16,,SFO,W 20-17,20,17,3,37,2021,2021_16_TEN_SFO
LAR,2021-12-21,20,Tue,14,15,,SEA,W 20-10,20,10,10,30,2021,2021_15_LAR_SEA
WAS,2021-12-12,20,Sun,13,14,,DAL,L 20-27,20,27,-7,47,2021,2021_14_WAS_DAL
TEN,2021-12-12,20,Sun,13,14,,JAX,W 20-0,20,0,20,20,2021,2021_14_TEN_JAX
MIA,2021-12-05,20,Sun,13,13,,NYG,W 20-9,20,9,11,29,2021,2021_13_MIA_NYG
PIT,2021-12-05,20,Sun,12,13,,BAL,W 20-19,20,19,1,39,2021,2021_13_PIT_BAL
LAC,2021-11-14,20,Sun,9,10,,MIN,L 20-27,20,27,-7,47,2021,2021_10_LAC_MIN
KAN,2021-11-01,20,Mon,8,8,,NYG,W 20-17,20,17,3,37,2021,2021_08_KAN_NYG
DAL,2021-10-31,20,Sun,7,8,@,MIN,W 20-16,20,16,4,36,2021,2021_08_DAL_MIN
MIA,2021-10-17,20,Sun,6,6,@,JAX,L 20-23,20,23,-3,43,2021,2021_06_MIA_JAX
SEA,2021-10-17,20,Sun,6,6,@,PIT,L 20-23 (OT),20,23,-3,43,2021,2021_06_SEA_PIT
NYJ,2021-10-10,20,Sun,5,5,@,ATL,L 20-27,20,27,-7,47,2021,2021_05_NYJ_ATL
KAN,2021-10-10,20,Sun,5,5,,BUF,L 20-38,20,38,-18,58,2021,2021_05_KAN_BUF
NYG,2021-10-10,20,Sun,5,5,@,DAL,L 20-44,20,44,-24,64,2021,2021_05_NYG_DAL
CHI,2021-10-10,20,Sun,5,5,@,LVR,W 20-9,20,9,11,29,2021,2021_05_CHI_LVR
LAR,2021-10-03,20,Sun,4,4,,ARI,L 20-37,20,37,-17,57,2021,2021_04_LAR_ARI
CHI,2021-09-19,20,Sun,2,2,,CIN,W 20-17,20,17,3,37,2021,2021_02_CHI_CIN
DAL,2021-09-19,20,Sun,2,2,@,LAC,W 20-17,20,17,3,37,2021,2021_02_DAL_LAC
LAC,2021-09-12,20,Sun,1,1,@,WAS,W 20-16,20,16,4,36,2021,2021_01_LAC_WAS
WAS,2021-01-03,20,Sun,16,17,@,PHI,W 20-14,20,14,6,34,2020,2020_17_WAS_PHI
SEA,2020-12-27,20,Sun,15,16,,LAR,W 20-9,20,9,11,29,2020,2020_16_SEA_LAR
CAR,2020-12-27,20,Sun,15,16,@,WAS,W 20-13,20,13,7,33,2020,2020_16_CAR_WAS
SFO,2020-12-26,20,Sat,15,16,@,ARI,W 20-12,20,12,8,32,2020,2020_16_SFO_ARI
HOU,2020-12-20,20,Sun,14,15,@,IND,L 20-27,20,27,-7,47,2020,2020_15_HOU_IND
CLE,2020-12-20,20,Sun,14,15,@,NYG,W 20-6,20,6,14,26,2020,2020_15_CLE_NYG
LAR,2020-12-20,20,Sun,14,15,,NYJ,L 20-23,20,23,-3,43,2020,2020_15_LAR_NYJ
SEA,2020-12-20,20,Sun,14,15,@,WAS,W 20-15,20,15,5,35,2020,2020_15_SEA_WAS
LAC,2020-12-13,20,Sun,13,14,,ATL,W 20-17,20,17,3,37,2020,2020_14_LAC_ATL
HOU,2020-12-06,20,Sun,12,13,,IND,L 20-26,20,26,-6,46,2020,2020_13_HOU_IND
NWE,2020-11-29,20,Sun,11,12,,ARI,W 20-17,20,17,3,37,2020,2020_12_NWE_ARI
MIA,2020-11-29,20,Sun,11,12,@,NYJ,W 20-3,20,3,17,23,2020,2020_12_MIA_NYJ
LAR,2020-11-29,20,Sun,11,12,,SFO,L 20-23,20,23,-3,43,2020,2020_12_LAR_SFO
CAR,2020-11-22,20,Sun,11,11,,DET,W 20-0,20,0,20,20,2020,2020_11_CAR_DET
NWE,2020-11-22,20,Sun,10,11,@,HOU,L 20-27,20,27,-7,47,2020,2020_11_NWE_HOU
DEN,2020-11-22,20,Sun,10,11,,MIA,W 20-13,20,13,7,33,2020,2020_11_DEN_MIA
WAS,2020-11-22,20,Sun,10,11,,CIN,W 20-9,20,9,11,29,2020,2020_11_WAS_CIN
JAX,2020-11-15,20,Sun,9,10,@,GNB,L 20-24,20,24,-4,44,2020,2020_10_JAX_GNB
DET,2020-11-08,20,Sun,8,9,@,MIN,L 20-34,20,34,-14,54,2020,2020_09_DET_MIN
WAS,2020-11-08,20,Sun,8,9,,NYG,L 20-23,20,23,-3,43,2020,2020_09_WAS_NYG
TEN,2020-11-01,20,Sun,7,8,@,CIN,L 20-31,20,31,-11,51,2020,2020_08_TEN_CIN
HOU,2020-10-25,20,Sun,7,7,,GNB,L 20-35,20,35,-15,55,2020,2020_07_HOU_GNB
LVR,2020-10-25,20,Sun,6,7,,TAM,L 20-45,20,45,-25,65,2020,2020_07_LVR_TAM
NYG,2020-10-18,20,Sun,6,6,,WAS,W 20-19,20,19,1,39,2020,2020_06_NYG_WAS
CHI,2020-10-08,20,Thu,5,5,,TAM,W 20-19,20,19,1,39,2020,2020_05_CHI_TAM
SFO,2020-10-04,20,Sun,4,4,,PHI,L 20-25,20,25,-5,45,2020,2020_04_SFO_PHI
BAL,2020-09-28,20,Mon,3,3,,KAN,L 20-34,20,34,-14,54,2020,2020_03_BAL_KAN
LVR,2020-09-27,20,Sun,3,3,@,NWE,L 20-36,20,36,-16,56,2020,2020_03_LVR_NWE
WAS,2020-09-27,20,Sun,3,3,@,CLE,L 20-34,20,34,-14,54,2020,2020_03_WAS_CLE
LAC,2020-09-20,20,Sun,2,2,,KAN,L 20-23 (OT),20,23,-3,43,2020,2020_02_LAC_KAN
SFO,2020-09-13,20,Sun,1,1,,ARI,L 20-24,20,24,-4,44,2020,2020_01_SFO_ARI
LAR,2020-09-13,20,Sun,1,1,,DAL,W 20-17,20,17,3,37,2020,2020_01_LAR_DAL
IND,2020-09-13,20,Sun,1,1,@,JAX,L 20-27,20,27,-7,47,2020,2020_01_IND_JAX
HOU,2020-09-10,20,Thu,1,1,@,KAN,L 20-34,20,34,-14,54,2020,2020_01_HOU_KAN
DET,2019-12-29,20,Sun,16,17,,GNB,L 20-23,20,23,-3,43,2019,2019_17_DET_GNB
IND,2019-12-29,20,Sun,16,17,@,JAX,L 20-38,20,38,-18,58,2019,2019_17_IND_JAX
TAM,2019-12-21,20,Sat,15,16,,HOU,L 20-23,20,23,-3,43,2019,2019_16_TAM_HOU
MIA,2019-12-15,20,Sun,14,15,@,NYG,L 20-36,20,36,-16,56,2019,2019_15_MIA_NYG
JAX,2019-12-15,20,Sun,14,15,@,OAK,W 20-16,20,16,4,36,2019,2019_15_JAX_OAK
CAR,2019-12-08,20,Sun,13,14,@,ATL,L 20-40,20,40,-20,60,2019,2019_14_CAR_ATL
MIN,2019-12-08,20,Sun,13,14,,DET,W 20-7,20,7,13,27,2019,2019_14_MIN_DET
GNB,2019-12-08,20,Sun,13,14,,WAS,W 20-15,20,15,5,35,2019,2019_14_GNB_WAS
PIT,2019-12-01,20,Sun,12,13,,CLE,W 20-13,20,13,7,33,2019,2019_13_PIT_CLE
LAC,2019-12-01,20,Sun,12,13,@,DEN,L 20-23,20,23,-3,43,2019,2019_13_LAC_DEN
BAL,2019-12-01,20,Sun,12,13,,SFO,W 20-17,20,17,3,37,2019,2019_13_BAL_SFO
DET,2019-11-28,20,Thu,12,13,,CHI,L 20-24,20,24,-4,44,2019,2019_13_DET_CHI
BUF,2019-11-24,20,Sun,11,12,,DEN,W 20-3,20,3,17,23,2019,2019_12_BUF_DEN
JAX,2019-11-24,20,Sun,11,12,@,TEN,L 20-42,20,42,-22,62,2019,2019_12_JAX_TEN
HOU,2019-11-21,20,Thu,11,12,,IND,W 20-17,20,17,3,37,2019,2019_12_HOU_IND
MIA,2019-11-17,20,Sun,10,11,,BUF,L 20-37,20,37,-17,57,2019,2019_11_MIA_BUF
CHI,2019-11-10,20,Sun,9,10,,DET,W 20-13,20,13,7,33,2019,2019_10_CHI_DET
TEN,2019-11-03,20,Sun,9,9,@,CAR,L 20-30,20,30,-10,50,2019,2019_09_TEN_CAR
NWE,2019-11-03,20,Sun,9,9,@,BAL,L 20-37,20,37,-17,57,2019,2019_09_NWE_BAL
ATL,2019-10-27,20,Sun,8,8,,SEA,L 20-27,20,27,-7,47,2019,2019_08_ATL_SEA
LAC,2019-10-20,20,Sun,7,7,@,TEN,L 20-23,20,23,-3,43,2019,2019_07_LAC_TEN
PHI,2019-10-13,20,Sun,6,6,@,MIN,L 20-38,20,38,-18,58,2019,2019_06_PHI_MIN
SFO,2019-10-13,20,Sun,5,6,@,LAR,W 20-7,20,7,13,27,2019,2019_06_SFO_LAR
DEN,2019-10-06,20,Sun,5,5,@,LAC,W 20-13,20,13,7,33,2019,2019_05_DEN_LAC
ARI,2019-09-22,20,Sun,3,3,,CAR,L 20-38,20,38,-18,58,2019,2019_03_ARI_CAR
LAR,2019-09-22,20,Sun,3,3,@,CLE,W 20-13,20,13,7,33,2019,2019_03_LAR_CLE
LAC,2019-09-22,20,Sun,3,3,,HOU,L 20-27,20,27,-7,47,2019,2019_03_LAC_HOU
PIT,2019-09-22,20,Sun,3,3,@,SFO,L 20-24,20,24,-4,44,2019,2019_03_PIT_SFO
JAX,2019-09-19,20,Thu,3,3,,TEN,W 20-7,20,7,13,27,2019,2019_03_JAX_TEN
PHI,2019-09-15,20,Sun,2,2,@,ATL,L 20-24,20,24,-4,44,2019,2019_02_PHI_ATL
TAM,2019-09-12,20,Thu,2,2,@,CAR,W 20-14,20,14,6,34,2019,2019_02_TAM_CAR
CIN,2019-09-08,20,Sun,1,1,@,SEA,L 20-21,20,21,-1,41,2019,2019_01_CIN_SEA
HOU,2018-12-30,20,Sun,16,17,,JAX,W 20-3,20,3,17,23,2018,2018_17_HOU_JAX
TAM,2018-12-23,20,Sun,15,16,@,DAL,L 20-27,20,27,-7,47,2018,2018_16_TAM_DAL
BAL,2018-12-16,20,Sun,14,15,,TAM,W 20-12,20,12,8,32,2018,2018_15_BAL_TAM
CAR,2018-12-09,20,Sun,13,14,@,CLE,L 20-26,20,26,-6,46,2018,2018_14_CAR_CLE
SFO,2018-12-09,20,Sun,13,14,,DEN,W 20-14,20,14,6,34,2018,2018_14_SFO_DEN
ATL,2018-12-09,20,Sun,13,14,@,GNB,L 20-34,20,34,-14,54,2018,2018_14_ATL_GNB
ARI,2018-12-02,20,Sun,12,13,@,GNB,W 20-17,20,17,3,37,2018,2018_13_ARI_GNB
CIN,2018-11-25,20,Sun,11,12,,CLE,L 20-35,20,35,-15,55,2018,2018_12_CIN_CLE
DET,2018-11-18,20,Sun,10,11,,CAR,W 20-19,20,19,1,39,2018,2018_11_DET_CAR
MIN,2018-11-18,20,Sun,10,11,@,CHI,L 20-25,20,25,-5,45,2018,2018_11_MIN_CHI
PIT,2018-11-18,20,Sun,10,11,@,JAX,W 20-16,20,16,4,36,2018,2018_11_PIT_JAX
PHI,2018-11-11,20,Sun,9,10,,DAL,L 20-27,20,27,-7,47,2018,2018_10_PHI_DAL
LAC,2018-11-11,20,Sun,9,10,@,OAK,W 20-6,20,6,14,26,2018,2018_10_LAC_OAK
MIN,2018-10-28,20,Sun,8,8,,NOR,L 20-30,20,30,-10,50,2018,2018_08_MIN_NOR
WAS,2018-10-28,20,Sun,7,8,@,NYG,W 20-13,20,13,7,33,2018,2018_08_WAS_NYG
NYG,2018-10-22,20,Mon,7,7,@,ATL,L 20-23,20,23,-3,43,2018,2018_07_NYG_ATL
WAS,2018-10-21,20,Sun,6,7,,DAL,W 20-17,20,17,3,37,2018,2018_07_WAS_DAL
HOU,2018-10-21,20,Sun,7,7,@,JAX,W 20-7,20,7,13,27,2018,2018_07_HOU_JAX
LAC,2018-10-21,20,Sun,7,7,,TEN,W 20-19,20,19,1,39,2018,2018_07_LAC_TEN
HOU,2018-10-14,20,Sun,6,6,,BUF,W 20-13,20,13,7,33,2018,2018_06_HOU_BUF
DEN,2018-10-14,20,Sun,6,6,,LAR,L 20-23,20,23,-3,43,2018,2018_06_DEN_LAR
SEA,2018-09-30,20,Sun,4,4,@,ARI,W 20-17,20,17,3,37,2018,2018_04_SEA_ARI
PHI,2018-09-23,20,Sun,3,3,,IND,W 20-16,20,16,4,36,2018,2018_03_PHI_IND
OAK,2018-09-23,20,Sun,3,3,@,MIA,L 20-28,20,28,-8,48,2018,2018_03_OAK_MIA
TEN,2018-09-16,20,Sun,2,2,,HOU,W 20-17,20,17,3,37,2018,2018_02_TEN_HOU
NWE,2018-09-16,20,Sun,2,2,@,JAX,L 20-31,20,31,-11,51,2018,2018_02_NWE_JAX
DAL,2018-09-16,20,Sun,2,2,,NYG,W 20-13,20,13,7,33,2018,2018_02_DAL_NYG
MIA,2018-09-16,20,Sun,2,2,@,NYJ,W 20-12,20,12,8,32,2018,2018_02_MIA_NYJ
DEN,2018-09-16,20,Sun,2,2,,OAK,W 20-19,20,19,1,39,2018,2018_02_DEN_OAK
BUF,2018-09-16,20,Sun,2,2,,LAC,L 20-31,20,31,-11,51,2018,2018_02_BUF_LAC
TEN,2018-09-09,20,Sun,1,1,@,MIA,L 20-27,20,27,-7,47,2018,2018_01_TEN_MIA
HOU,2018-09-09,20,Sun,1,1,@,NWE,L 20-27,20,27,-7,47,2018,2018_01_HOU_NWE
JAX,2018-09-09,20,Sun,1,1,@,NYG,W 20-15,20,15,5,35,2018,2018_01_JAX_NYG
CHI,2017-12-24,20,Sun,15,16,,CLE,W 20-3,20,3,17,23,2017,2017_16_CHI_CLE
WAS,2017-12-17,20,Sun,14,15,,ARI,W 20-15,20,15,5,35,2017,2017_15_WAS_ARI
DAL,2017-12-17,20,Sun,14,15,@,OAK,W 20-17,20,17,3,37,2017,2017_15_DAL_OAK
DET,2017-12-16,20,Sat,14,15,,CHI,W 20-10,20,10,10,30,2017,2017_15_DET_CHI
NWE,2017-12-11,20,Mon,13,14,@,MIA,L 20-27,20,27,-7,47,2017,2017_14_NWE_MIA
ATL,2017-12-07,20,Thu,13,14,,NOR,W 20-17,20,17,3,37,2017,2017_14_ATL_NOR
CIN,2017-12-04,20,Mon,12,13,,PIT,L 20-23,20,23,-3,43,2017,2017_13_CIN_PIT
TAM,2017-12-03,20,Sun,12,13,@,GNB,L 20-26 (OT),20,26,-6,46,2017,2017_13_TAM_GNB
DET,2017-12-03,20,Sun,12,13,@,BAL,L 20-44,20,44,-24,64,2017,2017_13_DET_BAL
TAM,2017-11-26,20,Sun,11,12,@,ATL,L 20-34,20,34,-14,54,2017,2017_12_TAM_ATL
TEN,2017-11-26,20,Sun,11,12,@,IND,W 20-16,20,16,4,36,2017,2017_12_TEN_IND
NOR,2017-11-26,20,Sun,11,12,@,LAR,L 20-26,20,26,-6,46,2017,2017_12_NOR_LAR
WAS,2017-11-23,20,Thu,11,12,,NYG,W 20-10,20,10,10,30,2017,2017_12_WAS_NYG
CIN,2017-11-19,20,Sun,10,11,@,DEN,W 20-17,20,17,3,37,2017,2017_11_CIN_DEN
MIA,2017-11-19,20,Sun,10,11,,TAM,L 20-30,20,30,-10,50,2017,2017_11_MIA_TAM
PIT,2017-11-12,20,Sun,9,10,@,IND,W 20-17,20,17,3,37,2017,2017_10_PIT_IND
CIN,2017-11-12,20,Sun,9,10,@,TEN,L 20-24,20,24,-4,44,2017,2017_10_CIN_TEN
JAX,2017-11-12,20,Sun,9,10,,LAC,W 20-17 (OT),20,17,3,37,2017,2017_10_JAX_LAC
CAR,2017-11-05,20,Sun,9,9,,ATL,W 20-17,20,17,3,37,2017,2017_09_CAR_ATL
IND,2017-11-05,20,Sun,9,9,@,HOU,W 20-14,20,14,6,34,2017,2017_09_IND_HOU
BAL,2017-11-05,20,Sun,9,9,@,TEN,L 20-23,20,23,-3,43,2017,2017_09_BAL_TEN
ARI,2017-11-05,20,Sun,8,9,@,SFO,W 20-10,20,10,10,30,2017,2017_09_ARI_SFO
NYJ,2017-10-29,20,Sun,8,8,,ATL,L 20-25,20,25,-5,45,2017,2017_08_NYJ_ATL
NOR,2017-10-29,20,Sun,7,8,,CHI,W 20-12,20,12,8,32,2017,2017_08_NOR_CHI
PIT,2017-10-29,20,Sun,8,8,@,DET,W 20-15,20,15,5,35,2017,2017_08_PIT_DET
MIA,2017-10-15,20,Sun,5,6,@,ATL,W 20-17,20,17,3,37,2017,2017_06_MIA_ATL
MIN,2017-10-09,20,Mon,5,5,@,CHI,W 20-17,20,17,3,37,2017,2017_05_MIN_CHI
CIN,2017-10-08,20,Sun,5,5,,BUF,W 20-16,20,16,4,36,2017,2017_05_CIN_BUF
WAS,2017-10-02,20,Mon,4,4,@,KAN,L 20-29,20,29,-9,49,2017,2017_04_WAS_KAN
NOR,2017-10-01,20,Sun,4,4,@,MIA,W 20-0,20,0,20,20,2017,2017_04_NOR_MIA
JAX,2017-10-01,20,Sun,4,4,@,NYJ,L 20-23 (OT),20,23,-3,43,2017,2017_04_JAX_NYJ
NYJ,2017-09-24,20,Sun,3,3,,MIA,W 20-6,20,6,14,26,2017,2017_03_NYJ_MIA
PHI,2017-09-17,20,Sun,2,2,@,KAN,L 20-27,20,27,-7,47,2017,2017_02_PHI_KAN
NOR,2017-09-17,20,Sun,2,2,,NWE,L 20-36,20,36,-16,56,2017,2017_02_NOR_NWE
NYJ,2017-09-17,20,Sun,2,2,@,OAK,L 20-45,20,45,-25,65,2017,2017_02_NYJ_OAK
LAR,2017-09-17,20,Sun,2,2,,WAS,L 20-27,20,27,-7,47,2017,2017_02_LAR_WAS
BAL,2017-09-10,20,Sun,1,1,@,CIN,W 20-0,20,0,20,20,2017,2017_01_BAL_CIN
SEA,2023-01-08,19,Sun,17,18,,LAR,W 19-16 (OT),19,16,3,35,2022,2022_18_SEA_LAR
ARI,2023-01-01,19,Sun,16,17,@,ATL,L 19-20,19,20,-1,39,2022,2022_17_ARI_ATL
TAM,2022-12-25,19,Sun,15,16,@,ARI,W 19-16 (OT),19,16,3,35,2022,2022_16_TAM_ARI
HOU,2022-12-24,19,Sat,15,16,@,TEN,W 19-14,19,14,5,33,2022,2022_16_HOU_TEN
JAX,2022-12-22,19,Thu,15,16,@,NYJ,W 19-3,19,3,16,22,2022,2022_16_JAX_NYJ
PIT,2022-12-04,19,Sun,12,13,@,ATL,W 19-16,19,16,3,35,2022,2022_13_PIT_ATL
IND,2022-12-04,19,Sun,13,13,@,DAL,L 19-54,19,54,-35,73,2022,2022_13_IND_DAL
CHI,2022-12-04,19,Sun,13,13,,GNB,L 19-28,19,28,-9,47,2022,2022_13_CHI_GNB
WAS,2022-11-27,19,Sun,12,12,,ATL,W 19-13,19,13,6,32,2022,2022_12_WAS_ATL
TEN,2022-10-23,19,Sun,6,7,,IND,W 19-10,19,10,9,29,2022,2022_07_TEN_IND
LAC,2022-10-17,19,Mon,6,6,,DEN,W 19-16 (OT),19,16,3,35,2022,2022_06_LAC_DEN
SEA,2022-10-16,19,Sun,6,6,,ARI,W 19-9,19,9,10,28,2022,2022_06_SEA_ARI
BAL,2022-10-09,19,Sun,5,5,,CIN,W 19-17,19,17,2,36,2022,2022_05_BAL_CIN
BUF,2022-09-25,19,Sun,3,3,@,MIA,L 19-21,19,21,-2,40,2022,2022_03_BUF_MIA
NYG,2022-09-18,19,Sun,2,2,,CAR,W 19-16,19,16,3,35,2022,2022_02_NYG_CAR
TAM,2022-09-11,19,Sun,1,1,@,DAL,W 19-3,19,3,16,22,2022,2022_01_TAM_DAL
LVR,2022-09-11,19,Sun,1,1,@,LAC,L 19-24,19,24,-5,43,2022,2022_01_LVR_LAC
CHI,2022-09-11,19,Sun,1,1,,SFO,W 19-10,19,10,9,29,2022,2022_01_CHI_SFO
BAL,2022-01-02,19,Sun,16,17,,LAR,L 19-20,19,20,-1,39,2021,2021_17_BAL_LAR
PIT,2021-12-19,19,Sun,14,15,,TEN,W 19-13,19,13,6,32,2021,2021_15_PIT_TEN
BAL,2021-12-05,19,Sun,12,13,@,PIT,L 19-20,19,20,-1,39,2021,2021_13_BAL_PIT
KAN,2021-11-21,19,Sun,11,11,,DAL,W 19-9,19,9,10,28,2021,2021_11_KAN_DAL
TAM,2021-11-14,19,Sun,9,10,@,WAS,L 19-29,19,29,-10,48,2021,2021_10_TAM_WAS
CAR,2021-10-31,19,Sun,8,8,@,ATL,W 19-13,19,13,6,32,2021,2021_08_CAR_ATL
DET,2021-10-24,19,Sun,7,7,@,LAR,L 19-28,19,28,-9,47,2021,2021_07_DET_LAR
MIN,2021-10-10,19,Sun,5,5,,DET,W 19-17,19,17,2,36,2021,2021_05_MIN_DET
JAX,2021-10-10,19,Sun,5,5,,TEN,L 19-37,19,37,-18,56,2021,2021_05_JAX_TEN
DEN,2021-10-10,19,Sun,5,5,@,PIT,L 19-27,19,27,-8,46,2021,2021_05_DEN_PIT
TAM,2021-10-03,19,Sun,4,4,@,NWE,W 19-17,19,17,2,36,2021,2021_04_TAM_NWE
JAX,2021-09-26,19,Sun,3,3,,ARI,L 19-31,19,31,-12,50,2021,2021_03_JAX_ARI
BAL,2021-09-26,19,Sun,3,3,@,DET,W 19-17,19,17,2,36,2021,2021_03_BAL_DET
CAR,2021-09-12,19,Sun,1,1,,NYJ,W 19-14,19,14,5,33,2021,2021_01_CAR_NYJ
DAL,2021-01-03,19,Sun,16,17,@,NYG,L 19-23,19,23,-4,42,2020,2020_17_DAL_NYG
LAC,2020-12-27,19,Sun,15,16,,DEN,W 19-16,19,16,3,35,2020,2020_16_LAC_DEN
DEN,2020-12-19,19,Sat,14,15,,BUF,L 19-48,19,48,-29,67,2020,2020_15_DEN_BUF
MIA,2020-12-06,19,Sun,12,13,,CIN,W 19-7,19,7,12,26,2020,2020_13_MIA_CIN
PIT,2020-12-02,19,Wed,11,12,,BAL,W 19-14,19,14,5,33,2020,2020_12_PIT_BAL
NYG,2020-11-29,19,Sun,11,12,@,CIN,W 19-17,19,17,2,36,2020,2020_12_NYG_CIN
MIN,2020-11-16,19,Mon,9,10,@,CHI,W 19-13,19,13,6,32,2020,2020_10_MIN_CHI
DAL,2020-11-08,19,Sun,9,9,,PIT,L 19-24,19,24,-5,43,2020,2020_09_DAL_PIT
WAS,2020-10-18,19,Sun,6,6,@,NYG,L 19-20,19,20,-1,39,2020,2020_06_WAS_NYG
TAM,2020-10-08,19,Thu,5,5,@,CHI,L 19-20,19,20,-1,39,2020,2020_05_TAM_CHI
IND,2020-10-04,19,Sun,4,4,@,CHI,W 19-11,19,11,8,30,2020,2020_04_IND_CHI
PHI,2020-09-20,19,Sun,2,2,,LAR,L 19-37,19,37,-18,56,2020,2020_02_PHI_LAR
MIN,2019-12-29,19,Sun,16,17,,CHI,L 19-21,19,21,-2,40,2019,2019_17_MIN_CHI
CIN,2019-12-08,19,Sun,13,14,@,CLE,L 19-27,19,27,-8,46,2019,2019_14_CIN_CLE
WAS,2019-11-24,19,Sun,11,12,,DET,W 19-16,19,16,3,35,2019,2019_12_WAS_DET
CHI,2019-11-24,19,Sun,11,12,,NYG,W 19-14,19,14,5,33,2019,2019_12_CHI_NYG
CLE,2019-11-10,19,Sun,9,10,,BUF,W 19-16,19,16,3,35,2019,2019_10_CLE_BUF
CLE,2019-11-03,19,Sun,8,9,@,DEN,L 19-24,19,24,-5,43,2019,2019_09_CLE_DEN
MIN,2019-10-24,19,Thu,8,8,,WAS,W 19-9,19,9,10,28,2019,2019_08_MIN_WAS
IND,2019-10-06,19,Sun,5,5,@,KAN,W 19-13,19,13,6,32,2019,2019_05_IND_KAN
IND,2019-09-15,19,Sun,2,2,@,TEN,W 19-17,19,17,2,36,2019,2019_02_IND_TEN
ATL,2018-11-18,19,Sun,10,11,,DAL,L 19-22,19,22,-3,41,2018,2018_11_ATL_DAL
CAR,2018-11-18,19,Sun,10,11,@,DET,L 19-20,19,20,-1,39,2018,2018_11_CAR_DET
HOU,2018-11-04,19,Sun,9,9,@,DEN,W 19-17,19,17,2,36,2018,2018_09_HOU_DEN
TEN,2018-10-21,19,Sun,7,7,@,LAC,L 19-20,19,20,-1,39,2018,2018_07_TEN_LAC
WAS,2018-10-08,19,Mon,4,5,@,NOR,L 19-43,19,43,-24,62,2018,2018_05_WAS_NOR
HOU,2018-10-07,19,Sun,5,5,,DAL,W 19-16 (OT),19,16,3,35,2018,2018_05_HOU_DAL
OAK,2018-09-16,19,Sun,2,2,@,DEN,L 19-20,19,20,-1,39,2018,2018_02_OAK_DEN
PHI,2017-12-25,19,Mon,15,16,,OAK,W 19-10,19,10,9,29,2017,2017_16_PHI_OAK
TAM,2017-12-24,19,Sun,15,16,@,CAR,L 19-22,19,22,-3,41,2017,2017_16_TAM_CAR
NYJ,2017-12-17,19,Sun,14,15,@,NOR,L 19-31,19,31,-12,50,2017,2017_15_NYJ_NOR
LAC,2017-12-03,19,Sun,12,13,,CLE,W 19-10,19,10,9,29,2017,2017_13_LAC_CLE
JAX,2017-11-19,19,Sun,10,11,@,CLE,W 19-7,19,7,12,26,2017,2017_11_JAX_CLE
DEN,2017-10-30,19,Mon,7,8,@,KAN,L 19-29,19,29,-10,48,2017,2017_08_DEN_KAN
WAS,2017-10-29,19,Sun,7,8,,DAL,L 19-33,19,33,-14,52,2017,2017_08_WAS_DAL
PIT,2017-10-15,19,Sun,6,6,@,KAN,W 19-13,19,13,6,32,2017,2017_06_PIT_KAN
NWE,2017-10-05,19,Thu,5,5,@,TAM,W 19-14,19,14,5,33,2017,2017_05_NWE_TAM
MIA,2017-09-17,19,Sun,1,2,@,LAC,W 19-17,19,17,2,36,2017,2017_02_MIA_LAC
NOR,2017-09-11,19,Mon,1,1,@,MIN,L 19-29,19,29,-10,48,2017,2017_01_NOR_MIN
DAL,2017-09-10,19,Sun,1,1,,NYG,W 19-3,19,3,16,22,2017,2017_01_DAL_NYG
NWE,2022-12-24,18,Sat,15,16,,CIN,L 18-22,18,22,-4,40,2022,2022_16_NWE_CIN
ATL,2022-12-18,18,Sun,14,15,@,NOR,L 18-21,18,21,-3,39,2022,2022_15_ATL_NOR
NYG,2022-11-20,18,Sun,10,11,,DET,L 18-31,18,31,-13,49,2022,2022_11_NYG_DET
TAM,2022-10-16,18,Sun,6,6,@,PIT,L 18-20,18,20,-2,38,2022,2022_06_TAM_PIT
NOR,2022-01-02,18,Sun,16,17,,CAR,W 18-10,18,10,8,28,2021,2021_17_NOR_CAR
NYJ,2021-12-05,18,Sun,12,13,,PHI,L 18-33,18,33,-15,51,2021,2021_13_NYJ_PHI
SFO,2021-10-24,18,Sun,6,7,,IND,L 18-30,18,30,-12,48,2021,2021_07_SFO_IND
CAR,2021-10-10,18,Sun,5,5,,PHI,L 18-21,18,21,-3,39,2021,2021_05_CAR_PHI
LAR,2021-01-03,18,Sun,16,17,,ARI,W 18-7,18,7,11,25,2020,2020_17_LAR_ARI
BUF,2020-10-25,18,Sun,7,7,@,NYJ,W 18-10,18,10,8,28,2020,2020_07_BUF_NYJ
DEN,2020-10-18,18,Sun,5,6,@,NWE,W 18-12,18,12,6,30,2020,2020_06_DEN_NWE
ATL,2019-11-28,18,Thu,12,13,,NOR,L 18-26,18,26,-8,44,2019,2019_13_ATL_NOR
NYG,2019-11-04,18,Mon,9,9,,DAL,L 18-37,18,37,-19,55,2019,2019_09_NYG_DAL
NYJ,2019-11-03,18,Sun,8,9,@,MIA,L 18-26,18,26,-8,44,2019,2019_09_NYJ_MIA
CIN,2018-12-23,18,Sun,15,16,@,CLE,L 18-26,18,26,-8,44,2018,2018_16_CIN_CLE
JAX,2018-10-28,18,Sun,8,8,,PHI,L 18-24,18,24,-6,42,2018,2018_08_JAX_PHI
CLE,2018-10-28,18,Sun,8,8,@,PIT,L 18-33,18,33,-15,51,2018,2018_08_CLE_PIT
ARI,2018-10-28,18,Sun,8,8,,SFO,W 18-15,18,15,3,33,2018,2018_08_ARI_SFO
SFO,2018-10-07,18,Sun,5,5,,ARI,L 18-28,18,28,-10,46,2018,2018_05_SFO_ARI
NYG,2018-09-30,18,Sun,4,4,,NOR,L 18-33,18,33,-15,51,2018,2018_04_NYG_NOR
CLE,2018-09-16,18,Sun,2,2,@,NOR,L 18-21,18,21,-3,39,2018,2018_02_CLE_NOR
PHI,2018-09-06,18,Thu,1,1,,ATL,W 18-12,18,12,6,30,2018,2018_01_PHI_ATL
NYG,2017-12-31,18,Sun,16,17,,WAS,W 18-10,18,10,8,28,2017,2017_17_NYG_WAS
IND,2017-10-01,18,Sun,4,4,@,SEA,L 18-46,18,46,-28,64,2017,2017_04_IND_SEA
ARI,2017-10-01,18,Sun,4,4,,SFO,W 18-15 (OT),18,15,3,33,2017,2017_04_ARI_SFO
CLE,2017-09-10,18,Sun,1,1,,PIT,L 18-21,18,21,-3,39,2017,2017_01_CLE_PIT
TAM,2023-01-08,17,Sun,17,18,@,ATL,L 17-30,17,30,-13,47,2022,2022_18_TAM_ATL
MIN,2023-01-01,17,Sun,16,17,@,GNB,L 17-41,17,41,-24,58,2022,2022_17_MIN_GNB
BAL,2022-12-24,17,Sat,15,16,,ATL,W 17-9,17,9,8,26,2022,2022_16_BAL_ATL
NOR,2022-12-24,17,Sat,15,16,@,CLE,W 17-10,17,10,7,27,2022,2022_16_NOR_CLE
NYJ,2022-12-18,17,Sun,14,15,,DET,L 17-20,17,20,-3,37,2022,2022_15_NYJ_DET
LAC,2022-12-18,17,Sun,14,15,,TEN,W 17-14,17,14,3,31,2022,2022_15_LAC_TEN
MIA,2022-12-11,17,Sun,13,14,@,LAC,L 17-23,17,23,-6,40,2022,2022_14_MIA_LAC
LAR,2022-12-08,17,Thu,13,14,,LVR,W 17-16,17,16,1,33,2022,2022_14_LAR_LVR
TAM,2022-12-05,17,Mon,12,13,,NOR,W 17-16,17,16,1,33,2022,2022_13_TAM_NOR
MIA,2022-12-04,17,Sun,12,13,@,SFO,L 17-33,17,33,-16,50,2022,2022_13_MIA_SFO
IND,2022-11-28,17,Mon,12,12,,PIT,L 17-24,17,24,-7,41,2022,2022_12_IND_PIT
TAM,2022-11-27,17,Sun,11,12,@,CLE,L 17-23 (OT),17,23,-6,40,2022,2022_12_TAM_CLE
PHI,2022-11-20,17,Sun,10,11,@,IND,W 17-16,17,16,1,33,2022,2022_11_PHI_IND
GNB,2022-11-17,17,Thu,11,11,,TEN,L 17-27,17,27,-10,44,2022,2022_11_GNB_TEN
LAR,2022-11-13,17,Sun,9,10,,ARI,L 17-27,17,27,-10,44,2022,2022_10_LAR_ARI
TEN,2022-11-13,17,Sun,9,10,,DEN,W 17-10,17,10,7,27,2022,2022_10_TEN_DEN
JAX,2022-11-13,17,Sun,10,10,@,KAN,L 17-27,17,27,-10,44,2022,2022_10_JAX_KAN
CLE,2022-11-13,17,Sun,9,10,@,MIA,L 17-39,17,39,-22,56,2022,2022_10_CLE_MIA
TEN,2022-11-06,17,Sun,8,9,@,KAN,L 17-20 (OT),17,20,-3,37,2022,2022_09_TEN_KAN
WAS,2022-11-06,17,Sun,9,9,,MIN,L 17-20,17,20,-3,37,2022,2022_09_WAS_MIN
BUF,2022-11-06,17,Sun,8,9,@,NYJ,L 17-20,17,20,-3,37,2022,2022_09_BUF_NYJ
ATL,2022-11-06,17,Sun,9,9,,LAC,L 17-20,17,20,-3,37,2022,2022_09_ATL_LAC
HOU,2022-11-03,17,Thu,8,9,,PHI,L 17-29,17,29,-12,46,2022,2022_09_HOU_PHI
GNB,2022-10-30,17,Sun,8,8,@,BUF,L 17-27,17,27,-10,44,2022,2022_08_GNB_BUF
WAS,2022-10-30,17,Sun,8,8,@,IND,W 17-16,17,16,1,33,2022,2022_08_WAS_IND
JAX,2022-10-30,17,Sun,8,8,,DEN,L 17-21,17,21,-4,38,2022,2022_08_JAX_DEN
TEN,2022-10-30,17,Sun,7,8,@,HOU,W 17-10,17,10,7,27,2022,2022_08_TEN_HOU
NYJ,2022-10-30,17,Sun,8,8,,NWE,L 17-22,17,22,-5,39,2022,2022_08_NYJ_NWE
ATL,2022-10-23,17,Sun,7,7,@,CIN,L 17-35,17,35,-18,52,2022,2022_07_ATL_CIN
JAX,2022-10-23,17,Sun,7,7,,NYG,L 17-23,17,23,-6,40,2022,2022_07_JAX_NYG
DAL,2022-10-16,17,Sun,6,6,@,PHI,L 17-26,17,26,-9,43,2022,2022_06_DAL_PHI
MIA,2022-10-09,17,Sun,5,5,@,NYJ,L 17-40,17,40,-23,57,2022,2022_05_MIA_NYJ
WAS,2022-10-09,17,Sun,5,5,,TEN,L 17-21,17,21,-4,38,2022,2022_05_WAS_TEN
ARI,2022-10-09,17,Sun,5,5,,PHI,L 17-20,17,20,-3,37,2022,2022_05_ARI_PHI
CIN,2022-10-09,17,Sun,5,5,@,BAL,L 17-19,17,19,-2,36,2022,2022_05_CIN_BAL
IND,2022-10-02,17,Sun,4,4,,TEN,L 17-24,17,24,-7,41,2022,2022_04_IND_TEN
KAN,2022-09-25,17,Sun,3,3,@,IND,L 17-20,17,20,-3,37,2022,2022_03_KAN_IND
PIT,2022-09-22,17,Thu,3,3,@,CLE,L 17-29,17,29,-12,46,2022,2022_03_PIT_CLE
CIN,2022-09-18,17,Sun,2,2,@,DAL,L 17-20,17,20,-3,37,2022,2022_02_CIN_DAL
NWE,2022-09-18,17,Sun,2,2,@,PIT,W 17-14,17,14,3,31,2022,2022_02_NWE_PIT
SEA,2022-09-12,17,Mon,1,1,,DEN,W 17-16,17,16,1,33,2022,2022_01_SEA_DEN
CHI,2022-01-09,17,Sun,17,18,@,MIN,L 17-31,17,31,-14,48,2021,2021_18_CHI_MIN
CAR,2022-01-09,17,Sun,17,18,@,TAM,L 17-41,17,41,-24,58,2021,2021_18_CAR_TAM
LVR,2021-12-26,17,Sun,15,16,,DEN,W 17-13,17,13,4,30,2021,2021_16_LVR_DEN
SFO,2021-12-23,17,Thu,15,16,@,TEN,L 17-20,17,20,-3,37,2021,2021_16_SFO_TEN
WAS,2021-12-21,17,Tue,14,15,@,PHI,L 17-27,17,27,-10,44,2021,2021_15_WAS_PHI
MIN,2021-12-20,17,Mon,14,15,@,CHI,W 17-9,17,9,8,26,2021,2021_15_MIN_CHI
NWE,2021-12-18,17,Sat,14,15,@,IND,L 17-27,17,27,-10,44,2021,2021_15_NWE_IND
WAS,2021-12-05,17,Sun,12,13,@,LVR,W 17-15,17,15,2,32,2021,2021_13_WAS_LVR
ATL,2021-12-05,17,Sun,12,13,,TAM,L 17-30,17,30,-13,47,2021,2021_13_ATL_TAM
NOR,2021-12-02,17,Thu,12,13,,DAL,L 17-27,17,27,-10,44,2021,2021_13_NOR_DAL
WAS,2021-11-29,17,Mon,11,12,,SEA,W 17-15,17,15,2,32,2021,2021_12_WAS_SEA
NYJ,2021-11-21,17,Sun,10,11,,MIA,L 17-24,17,24,-7,41,2021,2021_11_NYJ_MIA
NYJ,2021-11-14,17,Sun,9,10,,BUF,L 17-45,17,45,-28,62,2021,2021_10_NYJ_BUF
JAX,2021-11-14,17,Sun,9,10,@,IND,L 17-23,17,23,-6,40,2021,2021_10_JAX_IND
GNB,2021-11-14,17,Sun,10,10,,SEA,W 17-0,17,0,17,17,2021,2021_10_GNB_SEA
SFO,2021-11-07,17,Sun,8,9,,ARI,L 17-31,17,31,-14,48,2021,2021_09_SFO_ARI
MIA,2021-11-07,17,Sun,9,9,,HOU,W 17-9,17,9,8,26,2021,2021_09_MIA_HOU
NYG,2021-11-01,17,Mon,8,8,@,KAN,L 17-20,17,20,-3,37,2021,2021_08_NYG_KAN
DEN,2021-10-31,17,Sun,8,8,,WAS,W 17-10,17,10,7,27,2021,2021_08_DEN_WAS
BAL,2021-10-24,17,Sun,7,7,,CIN,L 17-41,17,41,-24,58,2021,2021_07_BAL_CIN
CLE,2021-10-21,17,Thu,7,7,,DEN,W 17-14,17,14,3,31,2021,2021_07_CLE_DEN
DET,2021-10-10,17,Sun,5,5,@,MIN,L 17-19,17,19,-2,36,2021,2021_05_DET_MIN
ARI,2021-10-10,17,Sun,5,5,,SFO,W 17-10,17,10,7,27,2021,2021_05_ARI_SFO
MIA,2021-10-10,17,Sun,5,5,@,TAM,L 17-45,17,45,-28,62,2021,2021_05_MIA_TAM
SEA,2021-10-07,17,Thu,5,5,,LAR,L 17-26,17,26,-9,43,2021,2021_05_SEA_LAR
MIA,2021-10-03,17,Sun,4,4,,IND,L 17-27,17,27,-10,44,2021,2021_04_MIA_IND
PIT,2021-10-03,17,Sun,4,4,@,GNB,L 17-27,17,27,-10,44,2021,2021_04_PIT_GNB
NWE,2021-10-03,17,Sun,4,4,,TAM,L 17-19,17,19,-2,36,2021,2021_04_NWE_TAM
SEA,2021-09-26,17,Sun,3,3,@,MIN,L 17-30,17,30,-13,47,2021,2021_03_SEA_MIN
ATL,2021-09-26,17,Sun,3,3,@,NYG,W 17-14,17,14,3,31,2021,2021_03_ATL_NYG
DET,2021-09-26,17,Sun,3,3,,BAL,L 17-19,17,19,-2,36,2021,2021_03_DET_BAL
DET,2021-09-20,17,Mon,2,2,@,GNB,L 17-35,17,35,-18,52,2021,2021_02_DET_GNB
CIN,2021-09-19,17,Sun,2,2,@,CHI,L 17-20,17,20,-3,37,2021,2021_02_CIN_CHI
LAC,2021-09-19,17,Sun,2,2,,DAL,L 17-20,17,20,-3,37,2021,2021_02_LAC_DAL
SFO,2021-09-19,17,Sun,2,2,@,PHI,W 17-11,17,11,6,28,2021,2021_02_SFO_PHI
PIT,2021-09-19,17,Sun,2,2,,LVR,L 17-26,17,26,-9,43,2021,2021_02_PIT_LVR
MIA,2021-09-12,17,Sun,1,1,@,NWE,W 17-16,17,16,1,33,2021,2021_01_MIA_NWE
PHI,2020-12-27,17,Sun,15,16,@,DAL,L 17-37,17,37,-20,54,2020,2020_16_PHI_DAL
KAN,2020-12-27,17,Sun,15,16,,ATL,W 17-14,17,14,3,31,2020,2020_16_KAN_ATL
JAX,2020-12-27,17,Sun,15,16,,CHI,L 17-41,17,41,-24,58,2020,2020_16_JAX_CHI
PIT,2020-12-21,17,Mon,14,15,@,CIN,L 17-27,17,27,-10,44,2020,2020_15_PIT_CIN
ATL,2020-12-13,17,Sun,13,14,@,LAC,L 17-20,17,20,-3,37,2020,2020_14_ATL_LAC
DAL,2020-12-08,17,Tue,12,13,@,BAL,L 17-34,17,34,-17,51,2020,2020_13_DAL_BAL
PIT,2020-12-07,17,Mon,12,13,,WAS,L 17-23,17,23,-6,40,2020,2020_13_PIT_WAS
NYG,2020-12-06,17,Sun,12,13,@,SEA,W 17-12,17,12,5,29,2020,2020_13_NYG_SEA
PHI,2020-11-30,17,Mon,11,12,,SEA,L 17-23,17,23,-6,40,2020,2020_12_PHI_SEA
ARI,2020-11-29,17,Sun,11,12,@,NWE,L 17-20,17,20,-3,37,2020,2020_12_ARI_NWE
CIN,2020-11-29,17,Sun,11,12,,NYG,L 17-19,17,19,-2,36,2020,2020_12_CIN_NYG
LAC,2020-11-29,17,Sun,11,12,@,BUF,L 17-27,17,27,-10,44,2020,2020_12_LAC_BUF
PHI,2020-11-22,17,Sun,10,11,@,CLE,L 17-22,17,22,-5,39,2020,2020_11_PHI_CLE
BAL,2020-11-15,17,Sun,9,10,@,NWE,L 17-23,17,23,-6,40,2020,2020_10_BAL_NWE
PHI,2020-11-15,17,Sun,9,10,@,NYG,L 17-27,17,27,-10,44,2020,2020_10_PHI_NYG
TEN,2020-11-12,17,Thu,9,10,,IND,L 17-34,17,34,-17,51,2020,2020_10_TEN_IND
CHI,2020-11-08,17,Sun,9,9,@,TEN,L 17-24,17,24,-7,41,2020,2020_09_CHI_TEN
SFO,2020-11-05,17,Thu,9,9,,GNB,L 17-34,17,34,-17,51,2020,2020_09_SFO_GNB
LAR,2020-11-01,17,Sun,8,8,@,MIA,L 17-28,17,28,-11,45,2020,2020_08_LAR_MIA
CAR,2020-10-29,17,Thu,8,8,,ATL,L 17-25,17,25,-8,42,2020,2020_08_CAR_ATL
BUF,2020-10-19,17,Mon,6,6,,KAN,L 17-26,17,26,-9,43,2020,2020_06_BUF_KAN
SFO,2020-10-11,17,Sun,5,5,,MIA,L 17-43,17,43,-26,60,2020,2020_05_SFO_MIA
LAR,2020-10-04,17,Sun,4,4,,NYG,W 17-9,17,9,8,26,2020,2020_04_LAR_NYG
WAS,2020-10-04,17,Sun,4,4,,BAL,L 17-31,17,31,-14,48,2020,2020_04_WAS_BAL
CHI,2020-09-20,17,Sun,2,2,,NYG,W 17-13,17,13,4,30,2020,2020_02_CHI_NYG
CAR,2020-09-20,17,Sun,2,2,@,TAM,L 17-31,17,31,-14,48,2020,2020_02_CAR_TAM
PHI,2020-09-13,17,Sun,1,1,@,WAS,L 17-27,17,27,-10,44,2020,2020_01_PHI_WAS
NYJ,2020-09-13,17,Sun,1,1,@,BUF,L 17-27,17,27,-10,44,2020,2020_01_NYJ_BUF
DAL,2020-09-13,17,Sun,1,1,@,LAR,L 17-20,17,20,-3,37,2020,2020_01_DAL_LAR
NYG,2019-12-29,17,Sun,16,17,,PHI,L 17-34,17,34,-17,51,2019,2019_17_NYG_PHI
DET,2019-12-22,17,Sun,15,16,@,DEN,L 17-27,17,27,-10,44,2019,2019_16_DET_DEN
PHI,2019-12-22,17,Sun,15,16,,DAL,W 17-9,17,9,8,26,2019,2019_16_PHI_DAL
LAC,2019-12-22,17,Sun,15,16,,OAK,L 17-24,17,24,-7,41,2019,2019_16_LAC_OAK
BUF,2019-12-21,17,Sat,15,16,@,NWE,L 17-24,17,24,-7,41,2019,2019_16_BUF_NWE
DET,2019-12-15,17,Sun,14,15,,TAM,L 17-38,17,38,-21,55,2019,2019_15_DET_TAM
BUF,2019-12-15,17,Sun,14,15,@,PIT,W 17-10,17,10,7,27,2019,2019_15_BUF_PIT
NYG,2019-12-09,17,Mon,13,14,@,PHI,L 17-23 (OT),17,23,-6,40,2019,2019_14_NYG_PHI
ARI,2019-12-08,17,Sun,13,14,,PIT,L 17-23,17,23,-6,40,2019,2019_14_ARI_PIT
BUF,2019-12-08,17,Sun,13,14,,BAL,L 17-24,17,24,-7,41,2019,2019_14_BUF_BAL
IND,2019-12-01,17,Sun,12,13,,TEN,L 17-31,17,31,-14,48,2019,2019_13_IND_TEN
SFO,2019-12-01,17,Sun,12,13,@,BAL,L 17-20,17,20,-3,37,2019,2019_13_SFO_BAL
SEA,2019-11-24,17,Sun,11,12,@,PHI,W 17-9,17,9,8,26,2019,2019_12_SEA_PHI
IND,2019-11-21,17,Thu,11,12,@,HOU,L 17-20,17,20,-3,37,2019,2019_12_IND_HOU
LAC,2019-11-18,17,Mon,11,11,,KAN,L 17-24,17,24,-7,41,2019,2019_11_LAC_KAN
WAS,2019-11-17,17,Sun,10,11,,NYJ,L 17-34,17,34,-17,51,2019,2019_11_WAS_NYJ
NWE,2019-11-17,17,Sun,10,11,@,PHI,W 17-10,17,10,7,27,2019,2019_11_NWE_PHI
LAR,2019-11-17,17,Sun,10,11,,CHI,W 17-7,17,7,10,24,2019,2019_11_LAR_CHI
OAK,2019-11-17,17,Sun,10,11,,CIN,W 17-10,17,10,7,27,2019,2019_11_OAK_CIN
TAM,2019-11-17,17,Sun,10,11,,NOR,L 17-34,17,34,-17,51,2019,2019_11_TAM_NOR
PIT,2019-11-10,17,Sun,9,10,,LAR,W 17-12,17,12,5,29,2019,2019_10_PIT_LAR
LAC,2019-10-27,17,Sun,8,8,@,CHI,W 17-16,17,16,1,33,2019,2019_08_LAC_CHI
CIN,2019-10-20,17,Sun,7,7,,JAX,L 17-27,17,27,-10,44,2019,2019_07_CIN_JAX
WAS,2019-10-13,17,Sun,6,6,@,MIA,W 17-16,17,16,1,33,2019,2019_06_WAS_MIA
LAC,2019-10-13,17,Sun,6,6,,PIT,L 17-24,17,24,-7,41,2019,2019_06_LAC_PIT
CIN,2019-10-13,17,Sun,6,6,@,BAL,L 17-23,17,23,-6,40,2019,2019_06_CIN_BAL
CIN,2019-09-22,17,Sun,3,3,@,BUF,L 17-21,17,21,-4,38,2019,2019_03_CIN_BUF
CIN,2019-09-15,17,Sun,2,2,,SFO,L 17-41,17,41,-24,58,2019,2019_02_CIN_SFO
ARI,2019-09-15,17,Sun,2,2,@,BAL,L 17-23,17,23,-6,40,2019,2019_02_ARI_BAL
TEN,2019-09-15,17,Sun,2,2,,IND,L 17-19,17,19,-2,36,2019,2019_02_TEN_IND
BUF,2019-09-08,17,Sun,1,1,@,NYJ,W 17-16,17,16,1,33,2019,2019_01_BUF_NYJ
TAM,2019-09-08,17,Sun,1,1,,SFO,L 17-31,17,31,-14,48,2019,2019_01_TAM_SFO
NYG,2019-09-08,17,Sun,1,1,@,DAL,L 17-35,17,35,-18,52,2019,2019_01_NYG_DAL
TEN,2018-12-30,17,Sun,16,17,,IND,L 17-33,17,33,-16,50,2018,2018_17_TEN_IND
MIA,2018-12-30,17,Sun,16,17,@,BUF,L 17-42,17,42,-25,59,2018,2018_17_MIA_BUF
JAX,2018-12-23,17,Sun,15,16,@,MIA,W 17-7,17,7,10,24,2018,2018_16_JAX_MIA
TEN,2018-12-16,17,Sun,14,15,@,NYG,W 17-0,17,0,17,17,2018,2018_15_TEN_NYG
MIA,2018-12-16,17,Sun,14,15,@,MIN,L 17-41,17,41,-24,58,2018,2018_15_MIA_MIN
GNB,2018-12-16,17,Sun,14,15,@,CHI,L 17-24,17,24,-7,41,2018,2018_15_GNB_CHI
PIT,2018-12-16,17,Sun,14,15,,NWE,W 17-10,17,10,7,27,2018,2018_15_PIT_NWE
CLE,2018-12-15,17,Sat,14,15,@,DEN,W 17-16,17,16,1,33,2018,2018_15_CLE_DEN
DET,2018-12-09,17,Sun,13,14,@,ARI,W 17-3,17,3,14,20,2018,2018_14_DET_ARI
CAR,2018-12-02,17,Sun,12,13,@,TAM,L 17-24,17,24,-7,41,2018,2018_13_CAR_TAM
BUF,2018-12-02,17,Sun,12,13,@,MIA,L 17-21,17,21,-4,38,2018,2018_13_BUF_MIA
GNB,2018-12-02,17,Sun,12,13,,ARI,L 17-20,17,20,-3,37,2018,2018_13_GNB_ARI
TEN,2018-11-26,17,Mon,11,12,@,HOU,L 17-34,17,34,-17,51,2018,2018_12_TEN_HOU
OAK,2018-11-25,17,Sun,11,12,@,BAL,L 17-34,17,34,-17,51,2018,2018_12_OAK_BAL
GNB,2018-11-25,17,Sun,11,12,@,MIN,L 17-24,17,24,-7,41,2018,2018_12_GNB_MIN
PIT,2018-11-25,17,Sun,11,12,@,DEN,L 17-24,17,24,-7,41,2018,2018_12_PIT_DEN
ATL,2018-11-22,17,Thu,11,12,@,NOR,L 17-31,17,31,-14,48,2018,2018_12_ATL_NOR
SEA,2018-11-04,17,Sun,8,9,,LAC,L 17-25,17,25,-8,42,2018,2018_09_SEA_LAC
GNB,2018-11-04,17,Sun,8,9,@,NWE,L 17-31,17,31,-14,48,2018,2018_09_GNB_NWE
DEN,2018-11-04,17,Sun,9,9,,HOU,L 17-19,17,19,-2,36,2018,2018_09_DEN_HOU
DAL,2018-10-21,17,Sun,7,7,@,WAS,L 17-20,17,20,-3,37,2018,2018_07_DAL_WAS
NYJ,2018-10-21,17,Sun,7,7,,MIN,L 17-37,17,37,-20,54,2018,2018_07_NYJ_MIN
PHI,2018-10-21,17,Sun,7,7,,CAR,L 17-21,17,21,-4,38,2018,2018_07_PHI_CAR
CAR,2018-10-14,17,Sun,5,6,@,WAS,L 17-23,17,23,-6,40,2018,2018_06_CAR_WAS
ARI,2018-10-14,17,Sun,6,6,@,MIN,L 17-27,17,27,-10,44,2018,2018_06_ARI_MIN
MIA,2018-10-07,17,Sun,5,5,@,CIN,L 17-27,17,27,-10,44,2018,2018_05_MIA_CIN
ATL,2018-10-07,17,Sun,5,5,@,PIT,L 17-41,17,41,-24,58,2018,2018_05_ATL_PIT
ARI,2018-09-30,17,Sun,4,4,,SEA,L 17-20,17,20,-3,37,2018,2018_04_ARI_SEA
GNB,2018-09-23,17,Sun,3,3,@,WAS,L 17-31,17,31,-14,48,2018,2018_03_GNB_WAS
NYJ,2018-09-20,17,Thu,3,3,@,CLE,L 17-21,17,21,-4,38,2018,2018_03_NYJ_CLE
SEA,2018-09-17,17,Mon,2,2,@,CHI,L 17-24,17,24,-7,41,2018,2018_02_SEA_CHI
HOU,2018-09-16,17,Sun,2,2,@,TEN,L 17-20,17,20,-3,37,2018,2018_02_HOU_TEN
DET,2018-09-10,17,Mon,1,1,,NYJ,L 17-48,17,48,-31,65,2018,2018_01_DET_NYJ
DET,2017-12-24,17,Sun,15,16,@,CIN,L 17-26,17,26,-9,43,2017,2017_16_DET_CIN
OAK,2017-12-17,17,Sun,14,15,,DAL,L 17-20,17,20,-3,37,2017,2017_15_OAK_DAL
NOR,2017-12-07,17,Thu,13,14,@,ATL,L 17-20,17,20,-3,37,2017,2017_14_NOR_ATL
NYG,2017-12-03,17,Sun,12,13,@,OAK,L 17-24,17,24,-7,41,2017,2017_13_NYG_OAK
MIA,2017-11-26,17,Sun,11,12,@,NWE,L 17-35,17,35,-18,52,2017,2017_12_MIA_NWE
DEN,2017-11-19,17,Sun,10,11,,CIN,L 17-20,17,20,-3,37,2017,2017_11_DEN_CIN
TEN,2017-11-16,17,Thu,10,11,@,PIT,L 17-40,17,40,-23,57,2017,2017_11_TEN_PIT
IND,2017-11-12,17,Sun,10,10,,PIT,L 17-20,17,20,-3,37,2017,2017_10_IND_PIT
LAC,2017-11-12,17,Sun,9,10,@,JAX,L 17-20 (OT),17,20,-3,37,2017,2017_10_LAC_JAX
GNB,2017-11-06,17,Mon,8,9,,DET,L 17-30,17,30,-13,47,2017,2017_09_GNB_DET
NYG,2017-11-05,17,Sun,8,9,,LAR,L 17-51,17,51,-34,68,2017,2017_09_NYG_LAR
WAS,2017-11-05,17,Sun,8,9,@,SEA,W 17-14,17,14,3,31,2017,2017_09_WAS_SEA
ATL,2017-11-05,17,Sun,8,9,@,CAR,L 17-20,17,20,-3,37,2017,2017_09_ATL_CAR
KAN,2017-11-05,17,Sun,9,9,@,DAL,L 17-28,17,28,-11,45,2017,2017_09_KAN_DAL
CAR,2017-10-29,17,Sun,8,8,@,TAM,W 17-3,17,3,14,20,2017,2017_08_CAR_TAM
GNB,2017-10-22,17,Sun,7,7,,NOR,L 17-26,17,26,-9,43,2017,2017_07_GNB_NOR
CHI,2017-10-22,17,Sun,7,7,,CAR,W 17-3,17,3,14,20,2017,2017_07_CHI_CAR
JAX,2017-10-15,17,Sun,6,6,,LAR,L 17-27,17,27,-10,44,2017,2017_06_JAX_LAR
NYJ,2017-10-15,17,Sun,6,6,,NWE,L 17-24,17,24,-7,41,2017,2017_06_NYJ_NWE
CLE,2017-10-15,17,Sun,6,6,@,HOU,L 17-33,17,33,-16,50,2017,2017_06_CLE_HOU
LAC,2017-10-15,17,Sun,6,6,@,OAK,W 17-16,17,16,1,33,2017,2017_06_LAC_OAK
ATL,2017-10-15,17,Sun,5,6,,MIA,L 17-20,17,20,-3,37,2017,2017_06_ATL_MIA
CHI,2017-10-09,17,Mon,5,5,,MIN,L 17-20,17,20,-3,37,2017,2017_05_CHI_MIN
NYJ,2017-10-08,17,Sun,5,5,@,CLE,W 17-14,17,14,3,31,2017,2017_05_NYJ_CLE
OAK,2017-10-08,17,Sun,5,5,,BAL,L 17-30,17,30,-13,47,2017,2017_05_OAK_BAL
ATL,2017-10-01,17,Sun,4,4,,BUF,L 17-23,17,23,-6,40,2017,2017_04_ATL_BUF
ARI,2017-09-25,17,Mon,3,3,,DAL,L 17-28,17,28,-11,45,2017,2017_03_ARI_DAL
TAM,2017-09-24,17,Sun,2,3,@,MIN,L 17-34,17,34,-17,51,2017,2017_03_TAM_MIN
PIT,2017-09-24,17,Sun,3,3,@,CHI,L 17-23 (OT),17,23,-6,40,2017,2017_03_PIT_CHI
DAL,2017-09-17,17,Sun,2,2,@,DEN,L 17-42,17,42,-25,59,2017,2017_02_DAL_DEN
LAC,2017-09-17,17,Sun,2,2,,MIA,L 17-19,17,19,-2,36,2017,2017_02_LAC_MIA
GNB,2017-09-10,17,Sun,1,1,,SEA,W 17-9,17,9,8,26,2017,2017_01_GNB_SEA
CHI,2017-09-10,17,Sun,1,1,,ATL,L 17-23,17,23,-6,40,2017,2017_01_CHI_ATL
WAS,2017-09-10,17,Sun,1,1,,PHI,L 17-30,17,30,-13,47,2017,2017_01_WAS_PHI
BAL,2023-01-08,16,Sun,17,18,@,CIN,L 16-27,16,27,-11,43,2022,2022_18_BAL_CIN
LAR,2023-01-08,16,Sun,17,18,@,SEA,L 16-19 (OT),16,19,-3,35,2022,2022_18_LAR_SEA
GNB,2023-01-08,16,Sun,17,18,,DET,L 16-20,16,20,-4,36,2022,2022_18_GNB_DET
NYG,2023-01-08,16,Sun,17,18,@,PHI,L 16-22,16,22,-6,38,2022,2022_18_NYG_PHI
TEN,2023-01-07,16,Sat,17,18,@,JAX,L 16-20,16,20,-4,36,2022,2022_18_TEN_JAX
PIT,2023-01-01,16,Sun,16,17,@,BAL,W 16-13,16,13,3,29,2022,2022_17_PIT_BAL
ARI,2022-12-25,16,Sun,15,16,,TAM,L 16-19 (OT),16,19,-3,35,2022,2022_16_ARI_TAM
CAR,2022-12-18,16,Sun,14,15,,PIT,L 16-24,16,24,-8,40,2022,2022_15_CAR_PIT
BAL,2022-12-11,16,Sun,13,14,@,PIT,W 16-14,16,14,2,30,2022,2022_14_BAL_PIT
LVR,2022-12-08,16,Thu,13,14,@,LAR,L 16-17,16,17,-1,33,2022,2022_14_LVR_LAR
NOR,2022-12-05,16,Mon,13,13,@,TAM,L 16-17,16,17,-1,33,2022,2022_13_NOR_TAM
ATL,2022-12-04,16,Sun,13,13,,PIT,L 16-19,16,19,-3,35,2022,2022_13_ATL_PIT
TEN,2022-11-27,16,Sun,11,12,,CIN,L 16-20,16,20,-4,36,2022,2022_12_TEN_CIN
DEN,2022-11-20,16,Sun,10,11,,LVR,L 16-22 (OT),16,22,-6,38,2022,2022_11_DEN_LVR
IND,2022-11-20,16,Sun,11,11,,PHI,L 16-17,16,17,-1,33,2022,2022_11_IND_PHI
SEA,2022-11-13,16,Sun,10,10,@,TAM,L 16-21,16,21,-5,37,2022,2022_10_SEA_TAM
LAC,2022-11-13,16,Sun,9,10,@,SFO,L 16-22,16,22,-6,38,2022,2022_10_LAC_SFO
HOU,2022-11-13,16,Sun,9,10,@,NYG,L 16-24,16,24,-8,40,2022,2022_10_HOU_NYG
TAM,2022-11-06,16,Sun,9,9,,LAR,W 16-13,16,13,3,29,2022,2022_09_TAM_LAR
IND,2022-10-30,16,Sun,8,8,,WAS,L 16-17,16,17,-1,33,2022,2022_08_IND_WAS
NYJ,2022-10-23,16,Sun,7,7,@,DEN,W 16-9,16,9,7,25,2022,2022_07_NYJ_DEN
MIA,2022-10-23,16,Sun,7,7,,PIT,W 16-10,16,10,6,26,2022,2022_07_MIA_PIT
DEN,2022-10-17,16,Mon,6,6,@,LAC,L 16-19 (OT),16,19,-3,35,2022,2022_06_DEN_LAC
MIA,2022-10-16,16,Sun,6,6,,MIN,L 16-24,16,24,-8,40,2022,2022_06_MIA_MIN
CAR,2022-10-02,16,Sun,4,4,,ARI,L 16-26,16,26,-10,42,2022,2022_04_CAR_ARI
NYG,2022-09-26,16,Mon,3,3,,DAL,L 16-23,16,23,-7,39,2022,2022_03_NYG_DAL
DEN,2022-09-18,16,Sun,2,2,,HOU,W 16-9,16,9,7,25,2022,2022_02_DEN_HOU
CAR,2022-09-18,16,Sun,2,2,@,NYG,L 16-19,16,19,-3,35,2022,2022_02_CAR_NYG
DEN,2022-09-12,16,Mon,1,1,@,SEA,L 16-17,16,17,-1,33,2022,2022_01_DEN_SEA
PIT,2022-01-09,16,Sun,17,18,@,BAL,W 16-13 (OT),16,13,3,29,2021,2021_18_PIT_BAL
CIN,2022-01-09,16,Sun,17,18,@,CLE,L 16-21,16,21,-5,37,2021,2021_18_CIN_CLE
WAS,2022-01-02,16,Sun,16,17,,PHI,L 16-20,16,20,-4,36,2021,2021_17_WAS_PHI
DET,2021-12-26,16,Sun,15,16,@,ATL,L 16-20,16,20,-4,36,2021,2021_16_DET_ATL
ARI,2021-12-25,16,Sat,15,16,,IND,L 16-22,16,22,-6,38,2021,2021_16_ARI_IND
LVR,2021-12-20,16,Mon,14,15,@,CLE,W 16-14,16,14,2,30,2021,2021_15_LVR_CLE
JAX,2021-12-19,16,Sun,14,15,,HOU,L 16-30,16,30,-14,46,2021,2021_15_JAX_HOU
BAL,2021-11-28,16,Sun,11,12,,CLE,W 16-10,16,10,6,26,2021,2021_12_BAL_CLE
CHI,2021-11-25,16,Thu,11,12,@,DET,W 16-14,16,14,2,30,2021,2021_12_CHI_DET
BAL,2021-11-21,16,Sun,10,11,@,CHI,W 16-13,16,13,3,29,2021,2021_11_BAL_CHI
PIT,2021-11-14,16,Sun,9,10,,DET,T 16-16 (OT),16,16,0,32,2021,2021_10_PIT_DET
DET,2021-11-14,16,Sun,9,10,@,PIT,T 16-16 (OT),16,16,0,32,2021,2021_10_DET_PIT
DAL,2021-11-07,16,Sun,8,9,,DEN,L 16-30,16,30,-14,46,2021,2021_09_DAL_DEN
LAR,2021-11-07,16,Sun,9,9,,TEN,L 16-28,16,28,-12,44,2021,2021_09_LAR_TEN
CIN,2021-11-07,16,Sun,9,9,,CLE,L 16-41,16,41,-25,57,2021,2021_09_CIN_CLE
LVR,2021-11-07,16,Sun,8,9,@,NYG,L 16-23,16,23,-7,39,2021,2021_09_LVR_NYG
MIN,2021-10-31,16,Sun,7,8,,DAL,L 16-20,16,20,-4,36,2021,2021_08_MIN_DAL
IND,2021-09-26,16,Sun,3,3,@,TEN,L 16-25,16,25,-9,41,2021,2021_03_IND_TEN
WAS,2021-09-12,16,Sun,1,1,,LAC,L 16-20,16,20,-4,36,2021,2021_01_WAS_LAC
NWE,2021-09-12,16,Sun,1,1,,MIA,L 16-17,16,17,-1,33,2021,2021_01_NWE_MIA
BUF,2021-09-12,16,Sun,1,1,,PIT,L 16-23,16,23,-7,39,2021,2021_01_BUF_PIT
IND,2021-09-12,16,Sun,1,1,,SEA,L 16-28,16,28,-12,44,2021,2021_01_IND_SEA
CHI,2021-01-03,16,Sun,16,17,,GNB,L 16-35,16,35,-19,51,2020,2020_17_CHI_GNB
DEN,2020-12-27,16,Sun,15,16,@,LAC,L 16-19,16,19,-3,35,2020,2020_16_DEN_LAC
CLE,2020-12-27,16,Sun,15,16,@,NYJ,L 16-23,16,23,-7,39,2020,2020_16_CLE_NYJ
CAR,2020-12-19,16,Sat,14,15,@,GNB,L 16-24,16,24,-8,40,2020,2020_15_CAR_GNB
DEN,2020-12-06,16,Sun,12,13,@,KAN,L 16-22,16,22,-6,38,2020,2020_13_DEN_KAN
PHI,2020-12-06,16,Sun,12,13,@,GNB,L 16-30,16,30,-14,46,2020,2020_13_PHI_GNB
ATL,2020-12-06,16,Sun,12,13,,NOR,L 16-21,16,21,-5,37,2020,2020_13_ATL_NOR
DAL,2020-11-26,16,Thu,11,12,,WAS,L 16-41,16,41,-25,57,2020,2020_12_DAL_WAS
SEA,2020-11-15,16,Sun,9,10,@,LAR,L 16-23,16,23,-7,39,2020,2020_10_SEA_LAR
LVR,2020-11-01,16,Sun,7,8,@,CLE,W 16-6,16,6,10,22,2020,2020_08_LVR_CLE
DEN,2020-10-25,16,Sun,6,7,,KAN,L 16-43,16,43,-27,59,2020,2020_07_DEN_KAN
JAX,2020-10-18,16,Sun,6,6,,DET,L 16-34,16,34,-18,50,2020,2020_06_JAX_DET
LAR,2020-10-18,16,Sun,6,6,@,SFO,L 16-24,16,24,-8,40,2020,2020_06_LAR_SFO
CAR,2020-10-18,16,Sun,6,6,,CHI,L 16-23,16,23,-7,39,2020,2020_06_CAR_CHI
BUF,2020-10-13,16,Tue,5,5,@,TEN,L 16-42,16,42,-26,58,2020,2020_05_BUF_TEN
ATL,2020-10-11,16,Sun,5,5,,CAR,L 16-23,16,23,-7,39,2020,2020_05_ATL_CAR
ATL,2020-10-05,16,Mon,4,4,@,GNB,L 16-30,16,30,-14,46,2020,2020_04_ATL_GNB
LAC,2020-09-27,16,Sun,3,3,,CAR,L 16-21,16,21,-5,37,2020,2020_03_LAC_CAR
HOU,2020-09-20,16,Sun,2,2,,BAL,L 16-33,16,33,-17,49,2020,2020_02_HOU_BAL
TEN,2020-09-14,16,Mon,1,1,@,DEN,W 16-14,16,14,2,30,2020,2020_01_TEN_DEN
NYG,2020-09-14,16,Mon,1,1,,PIT,L 16-26,16,26,-10,42,2020,2020_01_NYG_PIT
LAC,2020-09-13,16,Sun,1,1,@,CIN,W 16-13,16,13,3,29,2020,2020_01_LAC_CIN
WAS,2019-12-29,16,Sun,16,17,@,DAL,L 16-47,16,47,-31,63,2019,2019_17_WAS_DAL
DEN,2019-12-29,16,Sun,16,17,,OAK,W 16-15,16,15,1,31,2019,2019_17_DEN_OAK
NYJ,2019-12-22,16,Sun,15,16,,PIT,W 16-10,16,10,6,26,2019,2019_16_NYJ_PIT
OAK,2019-12-15,16,Sun,14,15,,JAX,L 16-20,16,20,-4,36,2019,2019_15_OAK_JAX
NWE,2019-12-08,16,Sun,13,14,,KAN,L 16-23,16,23,-7,39,2019,2019_14_NWE_KAN
PIT,2019-11-24,16,Sun,11,12,@,CIN,W 16-10,16,10,6,26,2019,2019_12_PIT_CIN
DET,2019-11-24,16,Sun,11,12,@,WAS,L 16-19,16,19,-3,35,2019,2019_12_DET_WAS
CAR,2019-11-10,16,Sun,9,10,@,GNB,L 16-24,16,24,-8,40,2019,2019_10_CAR_GNB
BUF,2019-11-10,16,Sun,9,10,@,CLE,L 16-19,16,19,-3,35,2019,2019_10_BUF_CLE
MIA,2019-11-10,16,Sun,9,10,@,IND,W 16-12,16,12,4,28,2019,2019_10_MIA_IND
CHI,2019-10-27,16,Sun,7,8,,LAC,L 16-17,16,17,-1,33,2019,2019_08_CHI_LAC
SEA,2019-10-20,16,Sun,7,7,,BAL,L 16-30,16,30,-14,46,2019,2019_07_SEA_BAL
DEN,2019-10-13,16,Sun,6,6,,TEN,W 16-0,16,0,16,16,2019,2019_06_DEN_TEN
MIA,2019-10-13,16,Sun,5,6,,WAS,L 16-17,16,17,-1,33,2019,2019_06_MIA_WAS
NWE,2019-09-29,16,Sun,4,4,@,BUF,W 16-10,16,10,6,26,2019,2019_04_NWE_BUF
CAR,2019-09-29,16,Sun,4,4,@,HOU,W 16-10,16,10,6,26,2019,2019_04_CAR_HOU
CHI,2019-09-29,16,Sun,4,4,,MIN,W 16-6,16,6,10,22,2019,2019_04_CHI_MIN
DEN,2019-09-22,16,Sun,3,3,@,GNB,L 16-27,16,27,-11,43,2019,2019_03_DEN_GNB
CHI,2019-09-15,16,Sun,2,2,@,DEN,W 16-14,16,14,2,30,2019,2019_02_CHI_DEN
MIN,2019-09-15,16,Sun,2,2,@,GNB,L 16-21,16,21,-5,37,2019,2019_02_MIN_GNB
DEN,2019-09-09,16,Mon,1,1,@,OAK,L 16-24,16,24,-8,40,2019,2019_01_DEN_OAK
NYJ,2019-09-08,16,Sun,1,1,,BUF,L 16-17,16,17,-1,33,2019,2019_01_NYJ_BUF
PIT,2018-12-30,16,Sun,16,17,,CIN,W 16-13,16,13,3,29,2018,2018_17_PIT_CIN
WAS,2018-12-22,16,Sat,15,16,@,TEN,L 16-25,16,25,-9,41,2018,2018_16_WAS_TEN
OAK,2018-12-16,16,Sun,14,15,@,CIN,L 16-30,16,30,-14,46,2018,2018_15_OAK_CIN
WAS,2018-12-16,16,Sun,14,15,@,JAX,W 16-13,16,13,3,29,2018,2018_15_WAS_JAX
DEN,2018-12-15,16,Sat,14,15,,CLE,L 16-17,16,17,-1,33,2018,2018_15_DEN_CLE
WAS,2018-12-09,16,Sun,13,14,,NYG,L 16-40,16,40,-24,56,2018,2018_14_WAS_NYG
ATL,2018-12-02,16,Sun,12,13,,BAL,L 16-26,16,26,-10,42,2018,2018_13_ATL_BAL
DET,2018-12-02,16,Sun,12,13,,LAR,L 16-30,16,30,-14,46,2018,2018_13_DET_LAR
SFO,2018-12-02,16,Sun,12,13,@,SEA,L 16-43,16,43,-27,59,2018,2018_13_SFO_SEA
DET,2018-11-22,16,Thu,11,12,,CHI,L 16-23,16,23,-7,39,2018,2018_12_DET_CHI
JAX,2018-11-18,16,Sun,10,11,,PIT,L 16-20,16,20,-4,36,2018,2018_11_JAX_PIT
WAS,2018-11-11,16,Sun,9,10,@,TAM,W 16-3,16,3,13,19,2018,2018_10_WAS_TAM
ATL,2018-11-11,16,Sun,9,10,@,CLE,L 16-28,16,28,-12,44,2018,2018_10_ATL_CLE
BAL,2018-11-04,16,Sun,9,9,,PIT,L 16-23,16,23,-7,39,2018,2018_09_BAL_PIT
DEN,2018-10-07,16,Sun,5,5,@,NYJ,L 16-34,16,34,-18,50,2018,2018_05_DEN_NYJ
DAL,2018-10-07,16,Sun,5,5,@,HOU,L 16-19 (OT),16,19,-3,35,2018,2018_05_DAL_HOU
IND,2018-09-23,16,Sun,3,3,@,PHI,L 16-20,16,20,-4,36,2018,2018_03_IND_PHI
CHI,2018-09-23,16,Sun,3,3,@,ARI,W 16-14,16,14,2,30,2018,2018_03_CHI_ARI
SFO,2018-09-09,16,Sun,1,1,@,MIN,L 16-24,16,24,-8,40,2018,2018_01_SFO_MIN
CAR,2018-09-09,16,Sun,1,1,,DAL,W 16-8,16,8,8,24,2018,2018_01_CAR_DAL
MIA,2017-12-31,16,Sun,16,17,,BUF,L 16-22,16,22,-6,38,2017,2017_17_MIA_BUF
BUF,2017-12-24,16,Sun,15,16,@,NWE,L 16-37,16,37,-21,53,2017,2017_16_BUF_NWE
IND,2017-12-23,16,Sat,15,16,@,BAL,L 16-23,16,23,-7,39,2017,2017_16_IND_BAL
MIN,2017-12-23,16,Sat,15,16,@,GNB,W 16-0,16,0,16,16,2017,2017_16_MIN_GNB
MIA,2017-12-17,16,Sun,14,15,@,BUF,L 16-24,16,24,-8,40,2017,2017_15_MIA_BUF
HOU,2017-12-10,16,Sun,13,14,,SFO,L 16-26,16,26,-10,42,2017,2017_14_HOU_SFO
ARI,2017-12-03,16,Sun,12,13,,LAR,L 16-32,16,32,-16,48,2017,2017_13_ARI_LAR
HOU,2017-11-27,16,Mon,11,12,@,BAL,L 16-23,16,23,-7,39,2017,2017_12_HOU_BAL
CLE,2017-11-26,16,Sun,11,12,@,CIN,L 16-30,16,30,-14,46,2017,2017_12_CLE_CIN
BUF,2017-11-26,16,Sun,11,12,@,KAN,W 16-10,16,10,6,26,2017,2017_12_BUF_KAN
IND,2017-11-26,16,Sun,11,12,,TEN,L 16-20,16,20,-4,36,2017,2017_12_IND_TEN
DEN,2017-11-12,16,Sun,9,10,,NWE,L 16-41,16,41,-25,57,2017,2017_10_DEN_NWE
CHI,2017-11-12,16,Sun,9,10,,GNB,L 16-23,16,23,-7,39,2017,2017_10_CHI_GNB
ARI,2017-11-09,16,Thu,9,10,,SEA,L 16-22,16,22,-6,38,2017,2017_10_ARI_SEA
CLE,2017-10-29,16,Sun,8,8,,MIN,L 16-33,16,33,-17,49,2017,2017_08_CLE_MIN
BAL,2017-10-22,16,Sun,7,7,@,MIN,L 16-24,16,24,-8,40,2017,2017_07_BAL_MIN
OAK,2017-10-15,16,Sun,6,6,,LAC,L 16-17,16,17,-1,33,2017,2017_06_OAK_LAC
BUF,2017-10-08,16,Sun,5,5,@,CIN,L 16-20,16,20,-4,36,2017,2017_05_BUF_CIN
SEA,2017-10-08,16,Sun,5,5,@,LAR,W 16-10,16,10,6,26,2017,2017_05_SEA_LAR
MIA,2017-10-08,16,Sun,4,5,,TEN,W 16-10,16,10,6,26,2017,2017_05_MIA_TEN
DEN,2017-10-01,16,Sun,4,4,,OAK,W 16-10,16,10,6,26,2017,2017_04_DEN_OAK
DEN,2017-09-24,16,Sun,3,3,@,BUF,L 16-26,16,26,-10,42,2017,2017_03_DEN_BUF
ARI,2017-09-17,16,Sun,2,2,@,IND,W 16-13 (OT),16,13,3,29,2017,2017_02_ARI_IND
JAX,2017-09-17,16,Sun,2,2,,TEN,L 16-37,16,37,-21,53,2017,2017_02_JAX_TEN
TEN,2017-09-10,16,Sun,1,1,,OAK,L 16-26,16,26,-10,42,2017,2017_01_TEN_OAK
ARI,2022-12-18,15,Sun,14,15,@,DEN,L 15-24,15,24,-9,39,2022,2022_15_ARI_DEN
HOU,2022-11-27,15,Sun,11,12,@,MIA,L 15-30,15,30,-15,45,2022,2022_12_HOU_MIA
ATL,2022-11-10,15,Thu,10,10,@,CAR,L 15-25,15,25,-10,40,2022,2022_10_ATL_CAR
DET,2022-11-06,15,Sun,8,9,,GNB,W 15-9,15,9,6,24,2022,2022_09_DET_GNB
CLE,2022-10-16,15,Sun,6,6,,NWE,L 15-38,15,38,-23,53,2022,2022_06_CLE_NWE
ATL,2022-10-09,15,Sun,5,5,@,TAM,L 15-21,15,21,-6,36,2022,2022_05_ATL_TAM
CAR,2022-10-09,15,Sun,5,5,,SFO,L 15-37,15,37,-22,52,2022,2022_05_CAR_SFO
MIA,2022-09-29,15,Thu,4,4,@,CIN,L 15-27,15,27,-12,42,2022,2022_04_MIA_CIN
ATL,2022-01-02,15,Sun,16,17,@,BUF,L 15-29,15,29,-14,44,2021,2021_17_ATL_BUF
CIN,2021-12-19,15,Sun,14,15,@,DEN,W 15-10,15,10,5,25,2021,2021_15_CIN_DEN
LVR,2021-12-05,15,Sun,12,13,,WAS,L 15-17,15,17,-2,32,2021,2021_13_LVR_WAS
SEA,2021-11-29,15,Mon,11,12,@,WAS,L 15-17,15,17,-2,32,2021,2021_12_SEA_WAS
BUF,2021-11-21,15,Sun,10,11,,IND,L 15-41,15,41,-26,56,2021,2021_11_BUF_IND
PIT,2021-10-31,15,Sun,7,8,@,CLE,W 15-10,15,10,5,25,2021,2021_08_PIT_CLE
WAS,2020-12-20,15,Sun,14,15,,SEA,L 15-20,15,20,-5,35,2020,2020_15_WAS_SEA
SFO,2020-12-13,15,Sun,13,14,,WAS,L 15-23,15,23,-8,38,2020,2020_14_SFO_WAS
PIT,2020-12-13,15,Sun,13,14,@,BUF,L 15-26,15,26,-11,41,2020,2020_14_PIT_BUF
WAS,2020-09-20,15,Sun,2,2,@,ARI,L 15-30,15,30,-15,45,2020,2020_02_WAS_ARI
OAK,2019-12-29,15,Sun,16,17,@,DEN,L 15-16,15,16,-1,31,2019,2019_17_OAK_DEN
CLE,2019-12-22,15,Sun,15,16,,BAL,L 15-31,15,31,-16,46,2019,2019_16_CLE_BAL
WAS,2019-12-08,15,Sun,13,14,@,GNB,L 15-20,15,20,-5,35,2019,2019_14_WAS_GNB
DAL,2019-11-28,15,Thu,12,13,,BUF,L 15-26,15,26,-11,41,2019,2019_13_DAL_BUF
IND,2019-10-27,15,Sun,7,8,,DEN,W 15-13,15,13,2,28,2019,2019_08_IND_DEN
NYJ,2019-10-27,15,Sun,7,8,@,JAX,L 15-29,15,29,-14,44,2019,2019_08_NYJ_JAX
WAS,2019-09-23,15,Mon,3,3,,CHI,L 15-31,15,31,-16,46,2019,2019_03_WAS_CHI
CHI,2018-12-09,15,Sun,13,14,,LAR,W 15-6,15,6,9,21,2018,2018_14_CHI_LAR
SFO,2018-10-28,15,Sun,8,8,@,ARI,L 15-18,15,18,-3,33,2018,2018_08_SFO_ARI
NYG,2018-09-09,15,Sun,1,1,,JAX,L 15-20,15,20,-5,35,2018,2018_01_NYG_JAX
TEN,2017-12-31,15,Sun,16,17,,JAX,W 15-10,15,10,5,25,2017,2017_17_TEN_JAX
ARI,2017-12-17,15,Sun,14,15,@,WAS,L 15-20,15,20,-5,35,2017,2017_15_ARI_WAS
OAK,2017-12-10,15,Sun,13,14,@,KAN,L 15-26,15,26,-11,41,2017,2017_14_OAK_KAN
SFO,2017-12-03,15,Sun,12,13,@,CHI,W 15-14,15,14,1,29,2017,2017_13_SFO_CHI
TAM,2017-11-12,15,Sun,9,10,,NYJ,W 15-10,15,10,5,25,2017,2017_10_TAM_NYJ
DET,2017-10-29,15,Sun,7,8,,PIT,L 15-20,15,20,-5,35,2017,2017_08_DET_PIT
SFO,2017-10-01,15,Sun,4,4,@,ARI,L 15-18 (OT),15,18,-3,33,2017,2017_04_SFO_ARI
CLE,2023-01-08,14,Sun,17,18,@,PIT,L 14-28,14,28,-14,42,2022,2022_18_CLE_PIT
DEN,2022-12-25,14,Sun,15,16,@,LAR,L 14-51,14,51,-37,65,2022,2022_16_DEN_LAR
TEN,2022-12-24,14,Sat,15,16,,HOU,L 14-19,14,19,-5,33,2022,2022_16_TEN_HOU
TEN,2022-12-18,14,Sun,14,15,@,LAC,L 14-17,14,17,-3,31,2022,2022_15_TEN_LAC
PIT,2022-12-11,14,Sun,13,14,,BAL,L 14-16,14,16,-2,30,2022,2022_14_PIT_BAL
HOU,2022-12-04,14,Sun,12,13,,CLE,L 14-27,14,27,-13,41,2022,2022_13_HOU_CLE
JAX,2022-12-04,14,Sun,12,13,@,DET,L 14-40,14,40,-26,54,2022,2022_13_JAX_DET
LAR,2022-10-30,14,Sun,7,8,,SFO,L 14-31,14,31,-17,45,2022,2022_08_LAR_SFO
NWE,2022-10-24,14,Mon,7,7,,CHI,L 14-33,14,33,-19,47,2022,2022_07_NWE_CHI
SFO,2022-10-16,14,Sun,6,6,@,ATL,L 14-28,14,28,-14,42,2022,2022_06_SFO_ATL
GNB,2022-09-25,14,Sun,3,3,@,TAM,W 14-12,14,12,2,26,2022,2022_03_GNB_TAM
NOR,2022-09-25,14,Sun,3,3,@,CAR,L 14-22,14,22,-8,36,2022,2022_03_NOR_CAR
PIT,2022-09-18,14,Sun,2,2,,NWE,L 14-17,14,17,-3,31,2022,2022_02_PIT_NWE
CLE,2022-01-03,14,Mon,16,17,@,PIT,L 14-26,14,26,-12,40,2021,2021_17_CLE_PIT
WAS,2021-12-26,14,Sun,15,16,@,DAL,L 14-56,14,56,-42,70,2021,2021_16_WAS_DAL
CLE,2021-12-20,14,Mon,14,15,,LVR,L 14-16,14,16,-2,30,2021,2021_15_CLE_LVR
CAR,2021-12-19,14,Sun,14,15,@,BUF,L 14-31,14,31,-17,45,2021,2021_15_CAR_BUF
NWE,2021-12-06,14,Mon,13,13,@,BUF,W 14-10,14,10,4,24,2021,2021_13_NWE_BUF
HOU,2021-11-28,14,Sun,11,12,,NYJ,L 14-21,14,21,-7,35,2021,2021_12_HOU_NYJ
JAX,2021-11-28,14,Sun,11,12,,ATL,L 14-21,14,21,-7,35,2021,2021_12_JAX_ATL
DET,2021-11-25,14,Thu,11,12,,CHI,L 14-16,14,16,-2,30,2021,2021_12_DET_CHI
LVR,2021-11-14,14,Sun,9,10,,KAN,L 14-41,14,41,-27,55,2021,2021_10_LVR_KAN
DEN,2021-10-21,14,Thu,7,7,@,CLE,L 14-17,14,17,-3,31,2021,2021_07_DEN_CLE
CHI,2021-10-17,14,Sun,6,6,,GNB,L 14-24,14,24,-10,38,2021,2021_06_CHI_GNB
CLE,2021-10-17,14,Sun,6,6,,ARI,L 14-37,14,37,-23,51,2021,2021_06_CLE_ARI
LVR,2021-10-04,14,Mon,4,4,@,LAC,L 14-28,14,28,-14,42,2021,2021_04_LVR_LAC
CLE,2021-10-03,14,Sun,4,4,@,MIN,W 14-7,14,7,7,21,2021,2021_04_CLE_MIN
DET,2021-10-03,14,Sun,4,4,@,CHI,L 14-24,14,24,-10,38,2021,2021_04_DET_CHI
NYG,2021-09-26,14,Sun,3,3,,ATL,L 14-17,14,17,-3,31,2021,2021_03_NYG_ATL
CHI,2021-09-12,14,Sun,1,1,@,LAR,L 14-34,14,34,-20,48,2021,2021_01_CHI_LAR
NYJ,2021-09-12,14,Sun,1,1,@,CAR,L 14-19,14,19,-5,33,2021,2021_01_NYJ_CAR
PHI,2021-01-03,14,Sun,16,17,,WAS,L 14-20,14,20,-6,34,2020,2020_17_PHI_WAS
JAX,2021-01-03,14,Sun,16,17,@,IND,L 14-28,14,28,-14,42,2020,2020_17_JAX_IND
NYJ,2021-01-03,14,Sun,16,17,@,NWE,L 14-28,14,28,-14,42,2020,2020_17_NYJ_NWE
ATL,2020-12-27,14,Sun,15,16,@,KAN,L 14-17,14,17,-3,31,2020,2020_16_ATL_KAN
TEN,2020-12-27,14,Sun,15,16,@,GNB,L 14-40,14,40,-26,54,2020,2020_16_TEN_GNB
JAX,2020-12-20,14,Sun,14,15,@,BAL,L 14-40,14,40,-26,54,2020,2020_15_JAX_BAL
MIN,2020-12-13,14,Sun,13,14,@,TAM,L 14-26,14,26,-12,40,2020,2020_14_MIN_TAM
BAL,2020-12-02,14,Wed,11,12,@,PIT,L 14-19,14,19,-5,33,2020,2020_12_BAL_PIT
JAX,2020-10-11,14,Sun,5,5,@,HOU,L 14-30,14,30,-16,44,2020,2020_05_JAX_HOU
DEN,2020-09-14,14,Mon,1,1,,TEN,L 14-16,14,16,-2,30,2020,2020_01_DEN_TEN
HOU,2019-12-29,14,Sun,16,17,,TEN,L 14-35,14,35,-21,49,2019,2019_17_HOU_TEN
NYG,2019-11-24,14,Sun,11,12,@,CHI,L 14-19,14,19,-5,33,2019,2019_12_NYG_CHI
CHI,2019-11-03,14,Sun,8,9,@,PHI,L 14-22,14,22,-8,36,2019,2019_09_CHI_PHI
MIA,2019-10-28,14,Mon,7,8,@,PIT,L 14-27,14,27,-13,41,2019,2019_08_MIA_PIT
NYG,2019-10-10,14,Thu,6,6,@,NWE,L 14-35,14,35,-21,49,2019,2019_06_NYG_NWE
BUF,2019-10-06,14,Sun,5,5,@,TEN,W 14-7,14,7,7,21,2019,2019_05_BUF_TEN
NYJ,2019-09-22,14,Sun,3,3,@,NWE,L 14-30,14,30,-16,44,2019,2019_03_NYJ_NWE
OAK,2019-09-22,14,Sun,3,3,@,MIN,L 14-34,14,34,-20,48,2019,2019_03_OAK_MIN
NYG,2019-09-15,14,Sun,2,2,,BUF,L 14-28,14,28,-14,42,2019,2019_02_NYG_BUF
DEN,2019-09-15,14,Sun,2,2,,CHI,L 14-16,14,16,-2,30,2019,2019_02_DEN_CHI
CAR,2019-09-12,14,Thu,2,2,,TAM,L 14-20,14,20,-6,34,2019,2019_02_CAR_TAM
NOR,2018-12-30,14,Sun,16,17,,CAR,L 14-33,14,33,-19,47,2018,2018_17_NOR_CAR
DEN,2018-12-24,14,Mon,15,16,@,OAK,L 14-27,14,27,-13,41,2018,2018_16_DEN_OAK
CHI,2018-12-23,14,Sun,15,16,@,SFO,W 14-9,14,9,5,23,2018,2018_16_CHI_SFO
BUF,2018-12-16,14,Sun,14,15,,DET,W 14-13,14,13,1,27,2018,2018_15_BUF_DET
ARI,2018-12-16,14,Sun,14,15,@,ATL,L 14-40,14,40,-26,54,2018,2018_15_ARI_ATL
DEN,2018-12-09,14,Sun,13,14,@,SFO,L 14-20,14,20,-6,34,2018,2018_14_DEN_SFO
TAM,2018-12-09,14,Sun,13,14,,NOR,L 14-28,14,28,-14,42,2018,2018_14_TAM_NOR
CIN,2018-11-11,14,Sun,9,10,,NOR,L 14-51,14,51,-37,65,2018,2018_10_CIN_NOR
ARI,2018-11-11,14,Sun,9,10,@,KAN,L 14-26,14,26,-12,40,2018,2018_10_ARI_KAN
DAL,2018-11-05,14,Mon,8,9,,TEN,L 14-28,14,28,-14,42,2018,2018_09_DAL_TEN
WAS,2018-11-04,14,Sun,8,9,,ATL,L 14-38,14,38,-24,52,2018,2018_09_WAS_ATL
DET,2018-10-28,14,Sun,7,8,,SEA,L 14-28,14,28,-14,42,2018,2018_08_DET_SEA
CLE,2018-10-14,14,Sun,6,6,,LAC,L 14-38,14,38,-24,52,2018,2018_06_CLE_LAC
JAX,2018-10-07,14,Sun,5,5,@,KAN,L 14-30,14,30,-16,44,2018,2018_05_JAX_KAN
PIT,2018-09-30,14,Sun,4,4,,BAL,L 14-26,14,26,-12,40,2018,2018_04_PIT_BAL
DEN,2018-09-23,14,Sun,3,3,@,BAL,L 14-27,14,27,-13,41,2018,2018_03_DEN_BAL
ARI,2018-09-23,14,Sun,3,3,,CHI,L 14-16,14,16,-2,30,2018,2018_03_ARI_CHI
LAC,2017-12-24,14,Sun,15,16,@,NYJ,W 14-7,14,7,7,21,2017,2017_16_LAC_NYJ
MIN,2017-12-03,14,Sun,12,13,@,ATL,W 14-9,14,9,5,23,2017,2017_13_MIN_ATL
CHI,2017-12-03,14,Sun,12,13,,SFO,L 14-15,14,15,-1,29,2017,2017_13_CHI_SFO
WAS,2017-11-30,14,Thu,12,13,@,DAL,L 14-38,14,38,-24,52,2017,2017_13_WAS_DAL
DEN,2017-11-26,14,Sun,11,12,@,OAK,L 14-21,14,21,-7,35,2017,2017_12_DEN_OAK
SEA,2017-11-05,14,Sun,8,9,,WAS,L 14-17,14,17,-3,31,2017,2017_09_SEA_WAS
HOU,2017-11-05,14,Sun,8,9,,IND,L 14-20,14,20,-6,34,2017,2017_09_HOU_IND
OAK,2017-10-29,14,Sun,8,8,@,BUF,L 14-34,14,34,-20,48,2017,2017_08_OAK_BUF
CIN,2017-10-22,14,Sun,6,7,@,PIT,L 14-29,14,29,-15,43,2017,2017_07_CIN_PIT
CLE,2017-10-08,14,Sun,5,5,,NYJ,L 14-17,14,17,-3,31,2017,2017_05_CLE_NYJ
TAM,2017-10-05,14,Thu,4,5,,NWE,L 14-19,14,19,-5,33,2017,2017_05_TAM_NWE
TEN,2017-10-01,14,Sun,4,4,@,HOU,L 14-57,14,57,-43,71,2017,2017_04_TEN_HOU
DET,2017-10-01,14,Sun,4,4,@,MIN,W 14-7,14,7,7,21,2017,2017_04_DET_MIN
CHI,2017-09-28,14,Thu,4,4,@,GNB,L 14-35,14,35,-21,49,2017,2017_04_CHI_GNB
ARI,2023-01-08,13,Sun,17,18,@,SFO,L 13-38,13,38,-25,51,2022,2022_18_ARI_SFO
CHI,2023-01-08,13,Sun,17,18,,MIN,L 13-29,13,29,-16,42,2022,2022_18_CHI_MIN
LVR,2023-01-07,13,Sat,17,18,,KAN,L 13-31,13,31,-18,44,2022,2022_18_LVR_KAN
BAL,2023-01-01,13,Sun,16,17,,PIT,L 13-16,13,16,-3,29,2022,2022_17_BAL_PIT
TEN,2022-12-29,13,Thu,16,17,,DAL,L 13-27,13,27,-14,40,2022,2022_17_TEN_DAL
CHI,2022-12-24,13,Sat,15,16,,BUF,L 13-35,13,35,-22,48,2022,2022_16_CHI_BUF
PIT,2022-12-24,13,Sat,15,16,,LVR,W 13-10,13,10,3,23,2022,2022_16_PIT_LVR
CLE,2022-12-17,13,Sat,14,15,,BAL,W 13-3,13,3,10,16,2022,2022_15_CLE_BAL
SEA,2022-12-15,13,Thu,14,15,,SFO,L 13-21,13,21,-8,34,2022,2022_15_SEA_SFO
ARI,2022-12-12,13,Mon,13,14,,NWE,L 13-27,13,27,-14,40,2022,2022_14_ARI_NWE
SFO,2022-11-27,13,Sun,11,12,,NOR,W 13-0,13,0,13,13,2022,2022_12_SFO_NOR
ATL,2022-11-27,13,Sun,12,12,@,WAS,L 13-19,13,19,-6,32,2022,2022_12_ATL_WAS
BAL,2022-11-20,13,Sun,10,11,,CAR,W 13-3,13,3,10,16,2022,2022_11_BAL_CAR
NOR,2022-11-07,13,Mon,9,9,,BAL,L 13-27,13,27,-14,40,2022,2022_09_NOR_BAL
LAR,2022-11-06,13,Sun,8,9,@,TAM,L 13-16,13,16,-3,29,2022,2022_09_LAR_TAM
CIN,2022-10-31,13,Mon,8,8,@,CLE,L 13-32,13,32,-19,45,2022,2022_08_CIN_CLE
NYG,2022-10-30,13,Sun,8,8,@,SEA,L 13-27,13,27,-14,40,2022,2022_08_NYG_SEA
PIT,2022-10-30,13,Sun,8,8,@,PHI,L 13-35,13,35,-22,48,2022,2022_08_PIT_PHI
HOU,2022-10-09,13,Sun,5,5,@,JAX,W 13-6,13,6,7,19,2022,2022_05_HOU_JAX
BAL,2022-01-09,13,Sun,17,18,,PIT,L 13-16 (OT),13,16,-3,29,2021,2021_18_BAL_PIT
DEN,2022-01-02,13,Sun,16,17,@,LAC,L 13-34,13,34,-21,47,2021,2021_17_DEN_LAC
DEN,2021-12-26,13,Sun,15,16,@,LVR,L 13-17,13,17,-4,30,2021,2021_16_DEN_LVR
ATL,2021-12-19,13,Sun,14,15,@,SFO,L 13-31,13,31,-18,44,2021,2021_15_ATL_SFO
TEN,2021-12-19,13,Sun,14,15,@,PIT,L 13-19,13,19,-6,32,2021,2021_15_TEN_PIT
HOU,2021-12-12,13,Sun,13,14,,SEA,L 13-33,13,33,-20,46,2021,2021_14_HOU_SEA
NYG,2021-11-28,13,Sun,11,12,,PHI,W 13-7,13,7,6,20,2021,2021_12_NYG_PHI
LAC,2021-11-28,13,Sun,11,12,@,DEN,L 13-28,13,28,-15,41,2021,2021_12_LAC_DEN
TEN,2021-11-28,13,Sun,12,12,@,NWE,L 13-36,13,36,-23,49,2021,2021_12_TEN_NWE
CHI,2021-11-21,13,Sun,10,11,,BAL,L 13-16,13,16,-3,29,2021,2021_11_CHI_BAL
CLE,2021-11-21,13,Sun,11,11,,DET,W 13-10,13,10,3,23,2021,2021_11_CLE_DET
SEA,2021-11-21,13,Sun,10,11,,ARI,L 13-23,13,23,-10,36,2021,2021_11_SEA_ARI
LVR,2021-11-21,13,Sun,10,11,,CIN,L 13-32,13,32,-19,45,2021,2021_11_LVR_CIN
TEN,2021-11-21,13,Sun,11,11,,HOU,L 13-22,13,22,-9,35,2021,2021_11_TEN_HOU
